Código do Municipio,Mesorregião,Nome_Mesorregião,Microrregião,Nome_Microrregião,Cidade,UF,1970,1980,1991,2000,2007,População,Homens,Mulheres,Urbana,Rural,Crescimento anual desde 2000
3500105,3508,Presidente Prudente,35035,Adamantina,Adamantina,SP,31798,32049,32091,33497,33289,33797,16375,17422,31948,1849,0.09%
3500204,3501,São José do Rio Preto,35004,São José do Rio Preto,Adolfo,SP,3969,3607,3272,3684,3609,3557,1787,1770,3200,357,-0.35%
3500303,3507,Campinas,35029,Pirassununga,Aguaí,SP,13171,17056,23363,28195,30181,32168,16224,15944,29021,3147,1.33%
3500402,3507,Campinas,35030,São João da Boa Vista,Águas da Prata,SP,5876,5717,6692,7131,7367,7580,3742,3838,6766,814,0.61%
3500501,3507,Campinas,35033,Amparo,Águas de Lindóia,SP,6732,9161,11966,16190,15867,17261,8453,8808,17108,153,0.64%
3500550,3504,Bauru,35022,Avaré,Águas de Santa Bárbara,SP,4723,4632,6049,5224,5360,5598,2777,2821,4256,1342,0.69%
3500600,3506,Piracicaba,35028,Piracicaba,Águas de São Pedro,SP,830,1091,1697,1883,2340,2703,1257,1446,2703,0,3.68%
3500709,3504,Bauru,35020,Bauru,Agudos,SP,18543,24478,31706,32484,34221,34532,17086,17446,32999,1533,0.61%
3500758,3511,Itapetininga,35042,Itapetininga,Alambari,SP,,,,3650,4070,4886,2457,2429,3672,1214,2.96%
3500808,3508,Presidente Prudente,35036,Presidente Prudente,Alfredo Marcondes,SP,6867,4309,3493,3697,3851,3891,1980,1911,3255,636,0.51%
3500907,3501,São José do Rio Preto,35004,São José do Rio Preto,Altair,SP,2527,2318,3239,3530,3272,3814,2051,1763,3022,792,0.78%
3501004,3502,Ribeirão Preto,35015,Batatais,Altinópolis,SP,10819,12743,13642,15481,15139,15609,7802,7807,13643,1966,0.08%
3501103,3503,Araçatuba,35018,Birigui,Alto Alegre,SP,7473,6080,4787,4261,4157,4105,2109,1996,3237,868,-0.37%
3501152,3512,Macro Metropolitana Paulista,35046,Sorocaba,Alumínio,SP,,,,15252,15678,16845,8502,8343,14130,2715,1.00%
3501202,3501,São José do Rio Preto,35003,Votuporanga,Álvares Florence,SP,8334,6588,5050,4316,3902,3901,2001,1900,2652,1249,-1.01%
3501301,3508,Presidente Prudente,35036,Presidente Prudente,Álvares Machado,SP,17305,14653,18865,22661,22859,23506,11633,11873,21180,2326,0.37%
3501400,3509,Marília,35038,Marília,Álvaro de Carvalho,SP,4200,3919,3133,4109,4610,4650,2959,1691,2952,1698,1.24%
3501509,3509,Marília,35038,Marília,Alvinlândia,SP,3020,3461,2541,2837,2787,3000,1482,1518,2693,307,0.56%
3501608,3507,Campinas,35032,Campinas,Americana,SP,66316,121998,153840,182593,199094,210701,103200,107501,209717,984,1.44%
3501707,3505,Araraquara,35024,Araraquara,Américo Brasiliense,SP,5368,11864,20067,28287,31005,34522,17362,17160,34261,261,2.01%
3501806,3501,São José do Rio Preto,35003,Votuporanga,Américo de Campos,SP,6148,6874,5590,5594,5379,5706,2862,2844,4788,918,0.20%
3501905,3507,Campinas,35033,Amparo,Amparo,SP,31908,41603,50797,60404,62692,65836,32444,33392,51818,14018,0.86%
3502002,3505,Araraquara,35025,São Carlos,Analândia,SP,2612,2312,3020,3582,4166,4289,2197,2092,3401,888,1.82%
3502101,3503,Araçatuba,35016,Andradina,Andradina,SP,51688,47664,52409,55161,54753,55317,27185,28132,51629,3688,0.03%
3502200,3511,Itapetininga,35042,Itapetininga,Angatuba,SP,15170,17052,21127,19297,21523,22211,11246,10965,15954,6257,1.42%
3502309,3504,Bauru,35023,Botucatu,Anhembi,SP,3517,3458,3537,4535,5271,5648,2908,2740,4263,1385,2.22%
3502408,3508,Presidente Prudente,35036,Presidente Prudente,Anhumas,SP,5609,3421,3242,3411,3695,3738,1863,1875,3059,679,0.92%
3502507,3513,Vale do Paraíba Paulista,35051,Guaratinguetá,Aparecida,SP,24669,29344,33247,34904,35903,35043,16918,18125,34534,509,0.04%
3502606,3501,São José do Rio Preto,35001,Jales,Aparecida d'Oeste,SP,7919,5148,5100,4935,4577,4444,2174,2270,3639,805,-1.04%
3502705,3511,Itapetininga,35044,Capão Bonito,Apiaí,SP,19635,26933,35185,27162,25463,25196,12579,12617,18226,6970,-0.75%
3502754,3512,Macro Metropolitana Paulista,35046,Sorocaba,Araçariguama,SP,,,,11154,12291,17085,8705,8380,11284,5801,4.36%
3502804,3503,Araçatuba,35017,Araçatuba,Araçatuba,SP,108512,129307,159557,169254,178839,181618,87337,94281,178118,3500,0.71%
3502903,3512,Macro Metropolitana Paulista,35046,Sorocaba,Araçoiaba da Serra,SP,6557,8539,14544,19816,24022,27323,13601,13722,18807,8516,3.26%
3503000,3502,Ribeirão Preto,35011,Ituverava,Aramina,SP,5042,3446,4064,4763,5019,5150,2587,2563,4811,339,0.78%
3503109,3504,Bauru,35022,Avaré,Arandu,SP,5239,4164,5620,6065,6013,6123,3088,3035,4614,1509,0.10%
3503158,3513,Vale do Paraíba Paulista,35052,Bananal,Arapeí,SP,,,,2618,2527,2492,1254,1238,1874,618,-0.49%
3503208,3505,Araraquara,35024,Araraquara,Araraquara,SP,100438,128122,166731,182471,195815,208725,100733,107992,202802,5923,1.35%
3503307,3506,Piracicaba,35027,Limeira,Araras,SP,53422,65010,87459,104196,108689,118898,58729,60169,112497,6401,1.33%
3503356,3509,Marília,35037,Tupã,Arco-Íris,SP,,,,2163,2003,1925,971,954,1097,828,-1.16%
3503406,3504,Bauru,35020,Bauru,Arealva,SP,6519,6788,6892,7244,7504,7842,3997,3845,6177,1665,0.80%
3503505,3513,Vale do Paraíba Paulista,35052,Bananal,Areias,SP,4107,3706,3284,3600,3571,3693,1829,1864,2475,1218,0.26%
3503604,3504,Bauru,35020,Bauru,Areiópolis,SP,5725,6765,9991,10296,10630,10581,5454,5127,9403,1178,0.27%
3503703,3501,São José do Rio Preto,35005,Catanduva,Ariranha,SP,5094,5538,5845,7477,8255,8547,4366,4181,8094,453,1.35%
3503802,3507,Campinas,35031,Moji Mirim,Artur Nogueira,SP,10171,15932,28053,33124,39457,44270,22123,22147,40026,4244,2.94%
3503901,3515,Metropolitana de São Paulo,35059,Guarulhos,Arujá,SP,9571,17487,37622,59185,72713,74818,36924,37894,71828,2990,2.37%
3503950,3501,São José do Rio Preto,35001,Jales,Aspásia,SP,,,,1861,1790,1809,907,902,1257,552,-0.28%
3504008,3510,Assis,35039,Assis,Assis,SP,57220,67357,85391,87251,92965,95156,46318,48838,91001,4155,0.87%
3504107,3512,Macro Metropolitana Paulista,35048,Bragança Paulista,Atibaia,SP,36838,57820,86336,111300,119166,126614,62217,64397,115266,11348,1.30%
3504206,3501,São José do Rio Preto,35006,Auriflama,Auriflama,SP,13266,12031,12765,13513,13760,14205,7104,7101,12950,1255,0.50%
3504305,3504,Bauru,35020,Bauru,Avaí,SP,5252,5367,4644,4596,4877,4959,2506,2453,3330,1629,0.76%
3504404,3503,Araçatuba,35018,Birigui,Avanhandava,SP,5974,6399,7973,8829,10875,11311,6250,5061,9563,1748,2.51%
3504503,3504,Bauru,35022,Avaré,Avaré,SP,37854,46921,61101,76472,80026,82935,41134,41801,79392,3543,0.81%
3504602,3501,São José do Rio Preto,35004,São José do Rio Preto,Bady Bassitt,SP,2669,2834,5717,11550,13039,14605,7250,7355,13661,944,2.37%
3504701,3504,Bauru,35020,Bauru,Balbinos,SP,1114,1186,1221,1313,3619,3932,3232,700,1191,2741,11.59%
3504800,3501,São José do Rio Preto,35004,São José do Rio Preto,Bálsamo,SP,5746,5720,6771,7340,7767,8160,3998,4162,7474,686,1.06%
3504909,3513,Vale do Paraíba Paulista,35052,Bananal,Bananal,SP,12889,10969,11368,9713,10233,10220,5052,5168,8157,2063,0.51%
3505005,3511,Itapetininga,35041,Itapeva,Barão de Antonina,SP,4345,3950,3028,2794,2751,3116,1591,1525,1913,1203,1.10%
3505104,3503,Araçatuba,35018,Birigui,Barbosa,SP,4871,5587,5379,5837,6454,6593,3323,3270,5575,1018,1.23%
3505203,3504,Bauru,35021,Jaú,Bariri,SP,17497,19894,24542,28224,30995,31603,15822,15781,29985,1618,1.14%
3505302,3504,Bauru,35021,Jaú,Barra Bonita,SP,17328,22594,30841,35487,35090,35256,17256,18000,34517,739,-0.07%
3505351,3511,Itapetininga,35044,Capão Bonito,Barra do Chapéu,SP,,,,4846,5077,5236,2766,2470,1544,3692,0.78%
3505401,3514,Litoral Sul Paulista,35055,Registro,Barra do Turvo,SP,3980,4882,7124,8108,7620,7729,4050,3679,3174,4555,-0.48%
3505500,3502,Ribeirão Preto,35009,Barretos,Barretos,SP,65574,72768,95414,103913,107988,112102,54169,57933,108687,3415,0.76%
3505609,3502,Ribeirão Preto,35014,Ribeirão Preto,Barrinha,SP,8430,12564,18853,24207,25642,28503,14327,14176,28187,316,1.65%
3505708,3515,Metropolitana de São Paulo,35057,Osasco,Barueri,SP,37808,75338,130799,208281,252748,240656,116977,123679,240656,0,1.46%
3505807,3509,Marília,35037,Tupã,Bastos,SP,9657,15343,19116,20588,20613,20461,10040,10421,17624,2837,-0.06%
3505906,3502,Ribeirão Preto,35015,Batatais,Batatais,SP,29262,37283,44106,51112,53525,56481,27749,28732,49954,6527,1.00%
3506003,3504,Bauru,35020,Bauru,Bauru,SP,131936,186659,261112,316064,347601,344039,166692,177347,338891,5148,0.85%
3506102,3502,Ribeirão Preto,35013,Jaboticabal,Bebedouro,SP,37816,46034,67763,74815,74865,75044,36531,38513,71512,3532,0.03%
3506201,3503,Araçatuba,35017,Araçatuba,Bento de Abreu,SP,2529,2037,2397,2394,2740,2674,1364,1310,2444,230,1.11%
3506300,3510,Assis,35040,Ourinhos,Bernardino de Campos,SP,10243,8994,10049,10720,10487,10777,5251,5526,9660,1117,0.05%
3506359,3515,Metropolitana de São Paulo,35063,Santos,Bertioga,SP,,,,30039,39091,47572,23769,23803,46818,754,4.70%
3506409,3503,Araçatuba,35018,Birigui,Bilac,SP,5976,5332,5460,6088,6905,7052,3493,3559,6485,567,1.48%
3506508,3503,Araçatuba,35018,Birigui,Birigui,SP,34976,50893,75125,94300,103394,108722,53086,55636,105481,3241,1.43%
3506607,3515,Metropolitana de São Paulo,35062,Mogi das Cruzes,Biritiba-Mirim,SP,9033,13374,17833,24653,27483,28573,14412,14161,24530,4043,1.49%
3506706,3505,Araraquara,35024,Araraquara,Boa Esperança do Sul,SP,6363,8352,11867,12573,13208,13658,6884,6774,12197,1461,0.83%
3506805,3504,Bauru,35021,Jaú,Bocaina,SP,6896,6774,7254,9442,10299,10862,5411,5451,10009,853,1.41%
3506904,3504,Bauru,35023,Botucatu,Bofete,SP,5327,4446,5666,7356,8565,9282,4731,4551,6121,3161,2.35%
3507001,3511,Itapetininga,35043,Tatuí,Boituva,SP,8976,12573,23140,34368,40783,48323,24319,24004,45457,2866,3.47%
3507100,3512,Macro Metropolitana Paulista,35048,Bragança Paulista,Bom Jesus dos Perdões,SP,3834,7096,9854,13313,16211,19703,9914,9789,17386,2317,4.00%
3507159,3511,Itapetininga,35041,Itapeva,Bom Sucesso de Itararé,SP,,,,3231,3658,3571,1815,1756,2430,1141,1.01%
3507209,3510,Assis,35039,Assis,Borá,SP,1270,866,751,795,804,805,422,383,627,178,0.13%
3507308,3504,Bauru,35021,Jaú,Boracéia,SP,2643,3561,3460,3739,4128,4268,2178,2090,3827,441,1.33%
3507407,3505,Araraquara,35024,Araraquara,Borborema,SP,9530,11635,12109,13193,13752,14532,7352,7180,13098,1434,0.97%
3507456,3504,Bauru,35020,Bauru,Borebi,SP,,,,1933,2172,2295,1144,1151,2002,293,1.73%
3507506,3504,Bauru,35023,Botucatu,Botucatu,SP,51954,64545,90761,108306,120800,127370,61789,65581,122718,4652,1.63%
3507605,3512,Macro Metropolitana Paulista,35048,Bragança Paulista,Bragança Paulista,SP,63676,84050,108980,125031,136286,146663,72034,74629,142174,4489,1.61%
3507704,3503,Araçatuba,35018,Birigui,Braúna,SP,5038,4551,4264,4383,4728,5021,2552,2469,4390,631,1.37%
3507753,3503,Araçatuba,35018,Birigui,Brejo Alegre,SP,,,,2308,2432,2573,1330,1243,2110,463,1.09%
3507803,3502,Ribeirão Preto,35014,Ribeirão Preto,Brodowski,SP,8328,11201,13788,17139,19018,21105,10466,10639,20596,509,2.10%
3507902,3506,Piracicaba,35026,Rio Claro,Brotas,SP,11962,11262,14402,18886,20996,21580,10711,10869,18599,2981,1.34%
3508009,3511,Itapetininga,35041,Itapeva,Buri,SP,8976,11622,14325,17629,17539,18566,9502,9064,14995,3571,0.52%
3508108,3503,Araçatuba,35018,Birigui,Buritama,SP,10019,11564,12766,13854,14735,15418,7732,7686,14526,892,1.08%
3508207,3502,Ribeirão Preto,35011,Ituverava,Buritizal,SP,5569,3868,3797,3674,3872,4055,2074,1981,3310,745,0.99%
3508306,3504,Bauru,35020,Bauru,Cabrália Paulista,SP,3259,3447,3862,4656,4340,4365,2220,2145,3777,588,-0.64%
3508405,3512,Macro Metropolitana Paulista,35046,Sorocaba,Cabreúva,SP,7679,11716,18814,33100,38898,41643,21114,20529,35295,6348,2.32%
3508504,3513,Vale do Paraíba Paulista,35050,São José dos Campos,Caçapava,SP,30712,51353,66058,76130,80458,84844,42040,42804,72619,12225,1.09%
3508603,3513,Vale do Paraíba Paulista,35051,Guaratinguetá,Cachoeira Paulista,SP,17336,20557,23212,27205,31674,30099,14748,15351,24580,5519,1.02%
3508702,3507,Campinas,35030,São João da Boa Vista,Caconde,SP,15248,16418,17283,18378,18552,18536,9285,9251,12633,5903,0.09%
3508801,3504,Bauru,35019,Lins,Cafelândia,SP,17592,17480,15257,15793,16073,16612,8176,8436,14423,2189,0.51%
3508900,3508,Presidente Prudente,35036,Presidente Prudente,Caiabu,SP,7012,3702,3854,4077,4011,4072,2091,1981,3315,757,-0.01%
3509007,3515,Metropolitana de São Paulo,35058,Franco da Rocha,Caieiras,SP,15563,25156,39069,71221,81163,86623,42354,44269,84476,2147,1.98%
3509106,3508,Presidente Prudente,35036,Presidente Prudente,Caiuá,SP,5271,2971,3341,4192,4953,5039,2652,2387,1930,3109,1.86%
3509205,3515,Metropolitana de São Paulo,35057,Osasco,Cajamar,SP,10355,21942,33736,50761,58403,64113,32005,32108,62822,1291,2.36%
3509254,3514,Litoral Sul Paulista,35055,Registro,Cajati,SP,,,,29227,28285,28371,14329,14042,20719,7652,-0.30%
3509304,3501,São José do Rio Preto,35005,Catanduva,Cajobi,SP,6741,8290,11154,9174,9519,9759,5014,4745,9124,635,0.62%
3509403,3502,Ribeirão Preto,35015,Batatais,Cajuru,SP,13725,16240,20246,20777,22695,23378,11700,11678,20802,2576,1.19%
3509452,3511,Itapetininga,35042,Itapetininga,Campina do Monte Alegre,SP,,,,5209,5320,5567,2853,2714,4710,857,0.67%
3509502,3507,Campinas,35032,Campinas,Campinas,SP,375864,664566,847595,969396,1039297,1080999,521209,559790,1062453,18546,1.10%
3509601,3512,Macro Metropolitana Paulista,35047,Jundiaí,Campo Limpo Paulista,SP,9156,21891,45387,63724,69810,74114,36423,37691,74114,0,1.52%
3509700,3513,Vale do Paraíba Paulista,35049,Campos do Jordão,Campos do Jordão,SP,18706,26105,37135,44252,44688,47824,23413,24411,47526,298,0.78%
3509809,3510,Assis,35039,Assis,Campos Novos Paulista,SP,4148,3792,4015,4181,4651,4539,2339,2200,3528,1011,0.82%
3509908,3514,Litoral Sul Paulista,35055,Registro,Cananéia,SP,6080,7734,10144,12298,12039,12226,6134,6092,10436,1790,-0.06%
3509957,3513,Vale do Paraíba Paulista,35051,Guaratinguetá,Canas,SP,,,,3614,4318,4387,2224,2163,4072,315,1.96%
3510005,3510,Assis,35039,Assis,Cândido Mota,SP,23583,19780,25450,29280,29572,29911,14674,15237,28122,1789,0.21%
3510104,3502,Ribeirão Preto,35013,Jaboticabal,Cândido Rodrigues,SP,2243,1991,2328,2613,2655,2668,1315,1353,2153,515,0.21%
3510153,3510,Assis,35040,Ourinhos,Canitar,SP,,,,3481,4265,4369,2216,2153,4138,231,2.30%
3510203,3511,Itapetininga,35044,Capão Bonito,Capão Bonito,SP,30326,45522,52612,46732,45275,46178,23020,23158,37824,8354,-0.12%
3510302,3512,Macro Metropolitana Paulista,35046,Sorocaba,Capela do Alto,SP,4872,7393,10771,14247,15950,17533,9037,8496,14523,3010,2.10%
3510401,3506,Piracicaba,35028,Piracicaba,Capivari,SP,18986,25175,34220,41468,43779,48573,24359,24214,45901,2672,1.59%
3510500,3513,Vale do Paraíba Paulista,35054,Caraguatatuba,Caraguatatuba,SP,15073,33802,52878,78921,88815,100899,49984,50915,97449,3450,2.49%
3510609,3515,Metropolitana de São Paulo,35057,Osasco,Carapicuíba,SP,54873,185822,283661,344596,379566,369908,179353,190555,369908,0,0.71%
3510708,3501,São José do Rio Preto,35003,Votuporanga,Cardoso,SP,17296,12013,12282,11605,11324,11798,5828,5970,10723,1075,0.17%
3510807,3507,Campinas,35030,São João da Boa Vista,Casa Branca,SP,18170,21744,25308,26800,27081,28312,14998,13314,23156,5156,0.55%
3510906,3502,Ribeirão Preto,35015,Batatais,Cássia dos Coqueiros,SP,2568,2516,2719,2871,2706,2627,1332,1295,1790,837,-0.88%
3511003,3503,Araçatuba,35016,Andradina,Castilho,SP,15329,12247,14608,14948,15410,18006,8975,9031,13592,4414,1.88%
3511102,3501,São José do Rio Preto,35005,Catanduva,Catanduva,SP,58251,72865,93317,105847,109362,112843,54777,58066,111937,906,0.64%
3511201,3501,São José do Rio Preto,35005,Catanduva,Catiguá,SP,5244,5682,6261,6555,6870,7127,3633,3494,6569,558,0.84%
3511300,3501,São José do Rio Preto,35004,São José do Rio Preto,Cedral,SP,6527,6203,5704,6700,7607,7968,3974,3994,6303,1665,1.75%
3511409,3504,Bauru,35022,Avaré,Cerqueira César,SP,9564,10726,12852,15144,16276,17532,8673,8859,15716,1816,1.48%
3511508,3511,Itapetininga,35043,Tatuí,Cerquilho,SP,6960,12341,20048,29508,34769,39649,19653,19996,37599,2050,3.00%
3511607,3511,Itapetininga,35043,Tatuí,Cesário Lange,SP,5755,7855,11153,12883,14005,15547,8059,7488,10495,5052,1.90%
3511706,3506,Piracicaba,35028,Piracicaba,Charqueada,SP,7924,8898,10735,13037,14356,15086,7684,7402,13689,1397,1.47%
3511904,3503,Araçatuba,35018,Birigui,Clementina,SP,5247,4298,4883,5404,6081,7064,3661,3403,6733,331,2.71%
3512001,3502,Ribeirão Preto,35009,Barretos,Colina,SP,11650,11607,15909,16664,16989,17373,8629,8744,16225,1148,0.42%
3512100,3502,Ribeirão Preto,35009,Barretos,Colômbia,SP,4224,3372,5282,5954,6073,5994,3066,2928,4332,1662,0.07%
3512209,3506,Piracicaba,35027,Limeira,Conchal,SP,7833,13034,19272,22676,23352,25242,12765,12477,23858,1384,1.08%
3512308,3504,Bauru,35023,Botucatu,Conchas,SP,10046,11038,11890,14904,15473,16302,8183,8119,13203,3099,0.90%
3512407,3506,Piracicaba,35027,Limeira,Cordeirópolis,SP,7970,9379,13338,17591,19309,21085,10599,10486,18936,2149,1.83%
3512506,3503,Araçatuba,35018,Birigui,Coroados,SP,6592,5648,6009,4417,4881,5238,2610,2628,4242,996,1.72%
3512605,3511,Itapetininga,35041,Itapeva,Coronel Macedo,SP,5782,6344,5750,5589,5277,5001,2565,2436,3865,1136,-1.11%
3512704,3506,Piracicaba,35026,Rio Claro,Corumbataí,SP,2842,2784,3156,3794,3935,3874,1974,1900,2093,1781,0.21%
3512803,3507,Campinas,35032,Campinas,Cosmópolis,SP,12110,23243,36684,44355,53561,58821,29411,29410,54629,4192,2.86%
3512902,3501,São José do Rio Preto,35003,Votuporanga,Cosmorama,SP,10231,8638,7830,7372,6951,7214,3652,3562,4945,2269,-0.22%
3513009,3515,Metropolitana de São Paulo,35060,Itapecerica da Serra,Cotia,SP,30924,62948,107453,148987,172823,201023,98372,102651,201023,0,3.04%
3513108,3502,Ribeirão Preto,35014,Ribeirão Preto,Cravinhos,SP,14230,16935,22561,28411,29377,31688,15887,15801,30891,797,1.10%
3513207,3502,Ribeirão Preto,35012,Franca,Cristais Paulista,SP,4974,4903,5649,6579,7005,7591,3877,3714,5531,2060,1.44%
3513306,3510,Assis,35039,Assis,Cruzália,SP,7478,4734,5251,2610,2368,2270,1106,1164,1502,768,-1.39%
3513405,3513,Vale do Paraíba Paulista,35051,Guaratinguetá,Cruzeiro,SP,45672,57993,68643,73492,76098,77070,37516,39554,75107,1963,0.48%
3513504,3515,Metropolitana de São Paulo,35063,Santos,Cubatão,SP,50906,78631,91136,108309,120271,118797,59246,59551,118797,0,0.93%
3513603,3513,Vale do Paraíba Paulista,35053,Paraibuna/Paraitinga,Cunha,SP,21952,20866,23462,23090,22951,21874,11171,10703,12171,9703,-0.54%
3513702,3505,Araraquara,35025,São Carlos,Descalvado,SP,15510,20333,25750,28921,29533,31053,15329,15724,27702,3351,0.71%
3513801,3515,Metropolitana de São Paulo,35061,São Paulo,Diadema,SP,78914,228663,305287,357064,386779,386039,186752,199287,386039,0,0.78%
3513850,3501,São José do Rio Preto,35001,Jales,Dirce Reis,SP,,,,1623,1582,1689,875,814,1279,410,0.40%
3513900,3507,Campinas,35030,São João da Boa Vista,Divinolândia,SP,12363,10266,11811,12016,11246,11209,5588,5621,7500,3709,-0.69%
3514007,3505,Araraquara,35024,Araraquara,Dobrada,SP,2773,4377,6920,7007,7664,7941,4116,3825,7764,177,1.26%
3514106,3504,Bauru,35021,Jaú,Dois Córregos,SP,13417,15482,18838,22522,24384,24768,12420,12348,23453,1315,0.96%
3514205,3501,São José do Rio Preto,35001,Jales,Dolcinópolis,SP,3265,2209,2094,2152,2181,2096,1091,1005,1949,147,-0.26%
3514304,3505,Araraquara,35025,São Carlos,Dourado,SP,5634,6558,7743,8606,8751,8607,4363,4244,7867,740,0.00%
3514403,3508,Presidente Prudente,35034,Dracena,Dracena,SP,35347,35973,39693,40500,42107,43263,21406,21857,39946,3317,0.66%
3514502,3504,Bauru,35020,Bauru,Duartina,SP,10840,12184,11897,12475,12381,12251,5970,6281,10997,1254,-0.18%
3514601,3502,Ribeirão Preto,35014,Ribeirão Preto,Dumont,SP,3054,3311,4980,6307,7557,8143,4096,4047,7854,289,2.59%
3514700,3509,Marília,35038,Marília,Echaporã,SP,7684,5685,6318,6827,6247,6318,3115,3203,5032,1286,-0.77%
3514809,3514,Litoral Sul Paulista,35055,Registro,Eldorado,SP,10845,11299,13120,14134,14038,14645,7479,7166,7209,7436,0.36%
3514908,3507,Campinas,35032,Campinas,Elias Fausto,SP,6151,8293,11632,13888,14521,15796,8169,7627,12577,3219,1.30%
3514924,3501,São José do Rio Preto,35005,Catanduva,Elisiário,SP,,,,2577,3024,3120,1650,1470,2858,262,1.93%
3514957,3501,São José do Rio Preto,35005,Catanduva,Embaúba,SP,,,,2478,2391,2423,1259,1164,2060,363,-0.22%
3515004,3515,Metropolitana de São Paulo,35060,Itapecerica da Serra,Embu,SP,18141,95800,155990,207663,237318,240007,116572,123435,240007,0,1.46%
3515103,3515,Metropolitana de São Paulo,35060,Itapecerica da Serra,Embu-Guaçu,SP,10280,21038,36277,56916,59083,62846,31178,31668,61180,1666,1.00%
3515129,3508,Presidente Prudente,35036,Presidente Prudente,Emilianópolis,SP,,,,2893,3021,3024,1519,1505,2497,527,0.44%
3515152,3507,Campinas,35031,Moji Mirim,Engenheiro Coelho,SP,,,,10033,12729,15719,8232,7487,11499,4220,4.59%
3515186,3507,Campinas,35030,São João da Boa Vista,Espírito Santo do Pinhal,SP,27299,33359,37178,40480,40684,41919,20513,21406,37254,4665,0.35%
3515194,3510,Assis,35040,Ourinhos,Espírito Santo do Turvo,SP,,,,3677,4103,4246,2146,2100,3632,614,1.45%
3515202,3501,São José do Rio Preto,35002,Fernandópolis,Estrela d'Oeste,SP,10873,9017,8493,8256,8590,8208,4133,4075,6831,1377,-0.06%
3515301,3508,Presidente Prudente,35036,Presidente Prudente,Estrela do Norte,SP,3322,3290,2777,2625,2454,2661,1369,1292,2102,559,0.14%
3515350,3508,Presidente Prudente,35036,Presidente Prudente,Euclides da Cunha Paulista,SP,,,,10214,9923,9585,4835,4750,6111,3474,-0.63%
3515400,3510,Assis,35040,Ourinhos,Fartura,SP,12477,12817,14333,15010,14601,15324,7428,7896,12242,3082,0.21%
3515509,3501,São José do Rio Preto,35002,Fernandópolis,Fernandópolis,SP,39050,46996,56144,61647,61392,64707,31517,33190,62725,1982,0.49%
3515608,3502,Ribeirão Preto,35013,Jaboticabal,Fernando Prestes,SP,4417,4423,5175,5434,5212,5534,2726,2808,4698,836,0.18%
3515657,3509,Marília,35038,Marília,Fernão,SP,,,,1432,1457,1563,794,769,850,713,0.88%
3515707,3515,Metropolitana de São Paulo,35062,Mogi das Cruzes,Ferraz de Vasconcelos,SP,25134,55046,96166,142377,168897,168290,82165,86125,160751,7539,1.69%
3515806,3508,Presidente Prudente,35035,Adamantina,Flora Rica,SP,4561,2740,2380,2177,2019,1752,880,872,1418,334,-2.15%
3515905,3501,São José do Rio Preto,35006,Auriflama,Floreal,SP,4683,3588,3547,3223,2907,3003,1496,1507,2439,564,-0.70%
3516002,3508,Presidente Prudente,35035,Adamantina,Flórida Paulista,SP,17741,15180,12510,11106,12660,12849,7056,5793,10138,2711,1.47%
3516101,3510,Assis,35039,Assis,Florínia,SP,5649,2744,3012,3127,2860,2829,1383,1446,2512,317,-1.00%
3516200,3502,Ribeirão Preto,35012,Franca,Franca,SP,93638,148990,233098,287737,319094,318785,155539,163246,313128,5657,1.03%
3516309,3515,Metropolitana de São Paulo,35058,Franco da Rocha,Francisco Morato,SP,11231,28537,83885,133738,146634,154538,76657,77881,154224,314,1.46%
3516408,3515,Metropolitana de São Paulo,35058,Franco da Rocha,Franco da Rocha,SP,36303,50794,85535,108122,121451,131603,67455,64148,121233,10370,1.98%
3516507,3503,Araçatuba,35018,Birigui,Gabriel Monteiro,SP,3344,3009,2472,2726,2638,2705,1373,1332,2254,451,-0.08%
3516606,3509,Marília,35038,Marília,Gália,SP,12628,11797,10497,7853,6812,7011,3506,3505,5225,1786,-1.13%
3516705,3509,Marília,35038,Marília,Garça,SP,37358,39926,41492,43162,42218,43124,20975,22149,39198,3926,-0.01%
3516804,3501,São José do Rio Preto,35006,Auriflama,Gastão Vidigal,SP,4423,3784,3834,3586,3863,4193,2298,1895,3756,437,1.58%
3516853,3505,Araraquara,35024,Araraquara,Gavião Peixoto,SP,,,,4126,4103,4420,2286,2134,3575,845,0.69%
3516903,3501,São José do Rio Preto,35006,Auriflama,General Salgado,SP,16591,11516,12911,10824,10626,10674,5355,5319,9089,1585,-0.14%
3517000,3504,Bauru,35019,Lins,Getulina,SP,12067,11054,10121,10370,10515,10777,5872,4905,8339,2438,0.39%
3517109,3503,Araçatuba,35018,Birigui,Glicério,SP,5153,4926,4234,4428,4398,4577,2296,2281,3366,1211,0.33%
3517208,3504,Bauru,35019,Lins,Guaiçara,SP,5174,5354,6366,9211,10357,10671,5368,5303,9698,973,1.48%
3517307,3504,Bauru,35019,Lins,Guaimbê,SP,5037,5164,5138,5207,4752,5425,2697,2728,4740,685,0.41%
3517406,3502,Ribeirão Preto,35010,São Joaquim da Barra,Guaíra,SP,26883,25673,31071,34610,36544,37412,18524,18888,36067,1345,0.78%
3517505,3501,São José do Rio Preto,35004,São José do Rio Preto,Guapiaçu,SP,5193,6758,10660,14086,16392,17885,9037,8848,15818,2067,2.42%
3517604,3511,Itapetininga,35044,Capão Bonito,Guapiara,SP,14224,16046,18281,19726,20056,17988,9150,8838,7230,10758,-0.92%
3517703,3502,Ribeirão Preto,35011,Ituverava,Guará,SP,12765,13327,16362,18916,18611,19864,9888,9976,19229,635,0.49%
3517802,3503,Araçatuba,35016,Andradina,Guaraçaí,SP,10239,8399,8294,8894,8505,8435,4191,4244,6655,1780,-0.53%
3517901,3501,São José do Rio Preto,35004,São José do Rio Preto,Guaraci,SP,7377,6467,7813,8846,9045,9976,5084,4892,8927,1049,1.21%
3518008,3501,São José do Rio Preto,35002,Fernandópolis,Guarani d'Oeste,SP,7966,8300,6779,2006,1963,1969,963,1006,1734,235,-0.19%
3518107,3504,Bauru,35020,Bauru,Guarantã,SP,5771,5716,5538,6323,6410,6400,3210,3190,5459,941,0.12%
3518206,3503,Araçatuba,35017,Araçatuba,Guararapes,SP,23324,22515,26689,28843,28662,30600,15092,15508,28326,2274,0.59%
3518305,3515,Metropolitana de São Paulo,35062,Mogi das Cruzes,Guararema,SP,12638,15105,17961,21904,24854,25861,13009,12852,22251,3610,1.67%
3518404,3513,Vale do Paraíba Paulista,35051,Guaratinguetá,Guaratinguetá,SP,68869,84864,102072,104219,107895,112091,53948,58143,106782,5309,0.73%
3518503,3511,Itapetininga,35042,Itapetininga,Guareí,SP,7509,6926,8470,10197,13202,14568,8929,5639,8413,6155,3.63%
3518602,3502,Ribeirão Preto,35013,Jaboticabal,Guariba,SP,11448,18887,28911,31085,32664,35491,17914,17577,34753,738,1.33%
3518701,3515,Metropolitana de São Paulo,35063,Santos,Guarujá,SP,94021,151120,210207,264812,296150,290607,141474,149133,290556,51,0.93%
3518800,3515,Metropolitana de São Paulo,35059,Guarulhos,Guarulhos,SP,236811,532724,787866,1072717,1236192,1222357,595403,626954,1222357,0,1.31%
3518859,3502,Ribeirão Preto,35014,Ribeirão Preto,Guatapará,SP,,,,6371,6217,6966,3579,3387,5116,1850,0.90%
3518909,3501,São José do Rio Preto,35006,Auriflama,Guzolândia,SP,7605,4306,5052,4295,4616,4754,2436,2318,4021,733,1.02%
3519006,3509,Marília,35037,Tupã,Herculândia,SP,7587,7098,7036,7992,8573,8696,4351,4345,7921,775,0.85%
3519055,3507,Campinas,35032,Campinas,Holambra,SP,,,,7211,9111,11292,5723,5569,8182,3110,4.59%
3519071,3507,Campinas,35032,Campinas,Hortolândia,SP,,,,152523,190781,192225,97241,94984,192225,0,2.34%
3519105,3504,Bauru,35020,Bauru,Iacanga,SP,7171,6624,7567,8282,9074,10010,5162,4848,8723,1287,1.91%
3519204,3509,Marília,35037,Tupã,Iacri,SP,8150,9199,7038,6783,6677,6419,3249,3170,5050,1369,-0.55%
3519253,3504,Bauru,35022,Avaré,Iaras,SP,,,,3054,4777,6377,4197,2180,2837,3540,7.64%
3519303,3505,Araraquara,35025,São Carlos,Ibaté,SP,7475,11448,18827,26462,28040,30724,15808,14916,29505,1219,1.50%
3519402,3501,São José do Rio Preto,35004,São José do Rio Preto,Ibirá,SP,7286,8260,8713,9447,10379,10868,5407,5461,10028,840,1.41%
3519501,3510,Assis,35039,Assis,Ibirarema,SP,5507,4841,5523,5701,6617,6725,3393,3332,6212,513,1.67%
3519600,3505,Araraquara,35024,Araraquara,Ibitinga,SP,23968,29141,38242,46620,49951,53166,26217,26949,51065,2101,1.32%
3519709,3512,Macro Metropolitana Paulista,35045,Piedade,Ibiúna,SP,24391,31826,49187,64384,64832,71228,36206,35022,24950,46278,1.02%
3519808,3501,São José do Rio Preto,35004,São José do Rio Preto,Icém,SP,5981,5187,6100,6772,6429,7462,3795,3667,6404,1058,0.97%
3519907,3510,Assis,35039,Assis,Iepê,SP,12586,9360,10013,7257,7487,7627,3780,3847,6775,852,0.50%
3520004,3504,Bauru,35021,Jaú,Igaraçu do Tietê,SP,8861,12730,20869,22614,23085,23370,11656,11714,23236,134,0.33%
3520103,3502,Ribeirão Preto,35011,Ituverava,Igarapava,SP,21202,20261,22324,25925,26862,27960,13844,14116,26370,1590,0.76%
3520202,3513,Vale do Paraíba Paulista,35050,São José dos Campos,Igaratá,SP,3686,4394,6292,8292,8537,8825,4524,4301,6991,1834,0.62%
3520301,3514,Litoral Sul Paulista,35055,Registro,Iguape,SP,19211,23363,27937,27427,28977,28844,14465,14379,24698,4146,0.51%
3520400,3513,Vale do Paraíba Paulista,35054,Caraguatatuba,Ilhabela,SP,5707,7800,13538,20836,23886,28176,14324,13852,27982,194,3.06%
3520426,3514,Litoral Sul Paulista,35055,Registro,Ilha Comprida,SP,,,,6704,8875,9027,4476,4551,9027,0,3.02%
3520442,3503,Araçatuba,35016,Andradina,Ilha Solteira,SP,,,,23996,24181,25071,12201,12870,23523,1548,0.44%
3520509,3507,Campinas,35032,Campinas,Indaiatuba,SP,30537,56243,100948,147050,173508,201848,100352,101496,199835,2013,3.22%
3520608,3508,Presidente Prudente,35036,Presidente Prudente,Indiana,SP,5156,4372,4622,4932,4682,4828,2422,2406,4126,702,-0.21%
3520707,3501,São José do Rio Preto,35002,Fernandópolis,Indiaporã,SP,5842,6547,4767,4058,3880,3906,1925,1981,3382,524,-0.38%
3520806,3508,Presidente Prudente,35035,Adamantina,Inúbia Paulista,SP,5238,4290,3355,3318,3595,3630,1821,1809,3177,453,0.90%
3520905,3510,Assis,35040,Ourinhos,Ipaussu,SP,12122,10227,11406,12553,12964,13746,6941,6805,12666,1080,0.91%
3521002,3512,Macro Metropolitana Paulista,35046,Sorocaba,Iperó,SP,6439,6606,10575,18384,24239,28301,15220,13081,17470,10831,4.41%
3521101,3506,Piracicaba,35026,Rio Claro,Ipeúna,SP,2097,1854,2698,4340,5164,6016,3109,2907,5178,838,3.32%
3521150,3501,São José do Rio Preto,35004,São José do Rio Preto,Ipiguá,SP,,,,3476,3925,4459,2265,2194,2690,1769,2.52%
3521200,3511,Itapetininga,35044,Capão Bonito,Iporanga,SP,3917,4724,4614,4562,4603,4302,2170,2132,2401,1901,-0.59%
3521309,3502,Ribeirão Preto,35010,São Joaquim da Barra,Ipuã,SP,9977,9137,10356,11870,14344,14146,7208,6938,13560,586,1.77%
3521408,3506,Piracicaba,35027,Limeira,Iracemápolis,SP,6907,8283,11752,15555,18026,20047,10059,9988,19632,415,2.57%
3521507,3501,São José do Rio Preto,35008,Novo Horizonte,Irapuã,SP,6081,7199,6092,6658,6710,7284,3808,3476,6489,795,0.90%
3521606,3508,Presidente Prudente,35035,Adamantina,Irapuru,SP,12058,9743,8257,7457,7556,7787,4531,3256,5505,2282,0.43%
3521705,3511,Itapetininga,35041,Itapeva,Itaberá,SP,14585,16399,17899,18911,17576,17861,9015,8846,12140,5721,-0.57%
3521804,3504,Bauru,35022,Avaré,Itaí,SP,13470,14553,17822,21039,22617,24015,12764,11251,18858,5157,1.33%
3521903,3501,São José do Rio Preto,35008,Novo Horizonte,Itajobi,SP,11579,14503,15014,14230,14182,14553,7350,7203,12143,2410,0.22%
3522000,3504,Bauru,35021,Jaú,Itaju,SP,3236,2495,2359,2638,2624,3263,1711,1552,2378,885,2.15%
3522109,3514,Litoral Sul Paulista,35056,Itanhaém,Itanhaém,SP,14515,27464,46074,71995,80778,87053,42189,44864,86238,815,1.92%
3522158,3511,Itapetininga,35044,Capão Bonito,Itaóca,SP,,,,3226,3087,3228,1687,1541,1760,1468,0.01%
3522208,3515,Metropolitana de São Paulo,35060,Itapecerica da Serra,Itapecerica da Serra,SP,25314,60473,93146,129685,148728,152380,76213,76167,151127,1253,1.63%
3522307,3511,Itapetininga,35042,Itapetininga,Itapetininga,SP,63606,84381,105132,125559,138450,144416,72202,72214,131051,13365,1.41%
3522406,3511,Itapetininga,35041,Itapeva,Itapeva,SP,49122,65546,81858,82866,85537,87765,43242,44523,73964,13801,0.58%
3522505,3515,Metropolitana de São Paulo,35057,Osasco,Itapevi,SP,27569,53442,107976,162433,193686,200874,98843,102031,200874,0,2.15%
3522604,3507,Campinas,35031,Moji Mirim,Itapira,SP,39036,47923,56586,63377,68187,68365,33862,34503,63405,4960,0.76%
3522653,3511,Itapetininga,35044,Capão Bonito,Itapirapuã Paulista,SP,,,,3577,3723,3884,2003,1881,1895,1989,0.83%
3522703,3505,Araraquara,35024,Araraquara,Itápolis,SP,20711,25981,33053,37750,38633,40064,19872,20192,36338,3726,0.60%
3522802,3511,Itapetininga,35041,Itapeva,Itaporanga,SP,14600,16456,14412,14354,14284,14546,7279,7267,11033,3513,0.13%
3522901,3504,Bauru,35021,Jaú,Itapuí,SP,6728,7613,9051,10371,11605,12181,6155,6026,11638,543,1.62%
3523008,3503,Araçatuba,35016,Andradina,Itapura,SP,4273,3179,3754,3838,3812,4360,2257,2103,3484,876,1.28%
3523107,3515,Metropolitana de São Paulo,35062,Mogi das Cruzes,Itaquaquecetuba,SP,29114,73068,164957,272942,334914,321854,158597,163257,321854,0,1.66%
3523206,3511,Itapetininga,35041,Itapeva,Itararé,SP,30507,37763,44167,46554,48732,47939,23524,24415,44275,3664,0.29%
3523305,3514,Litoral Sul Paulista,35056,Itanhaém,Itariri,SP,7315,9448,11608,13613,15115,15471,7794,7677,9879,5592,1.29%
3523404,3512,Macro Metropolitana Paulista,35048,Bragança Paulista,Itatiba,SP,28376,41630,61645,81197,91479,101450,50115,51335,85640,15810,2.25%
3523503,3504,Bauru,35022,Avaré,Itatinga,SP,9486,9218,13769,15446,17570,18052,9230,8822,16420,1632,1.57%
3523602,3506,Piracicaba,35026,Rio Claro,Itirapina,SP,6968,6929,9953,12836,13889,15528,9158,6370,14004,1524,1.92%
3523701,3502,Ribeirão Preto,35012,Franca,Itirapuã,SP,4684,4916,5043,5412,5614,5914,3013,2901,4929,985,0.89%
3523800,3507,Campinas,35030,São João da Boa Vista,Itobi,SP,5497,5762,6783,7466,7444,7545,3907,3638,6795,750,0.11%
3523909,3512,Macro Metropolitana Paulista,35046,Sorocaba,Itu,SP,49091,74203,107314,135366,147157,154200,76243,77957,144336,9864,1.31%
3524006,3512,Macro Metropolitana Paulista,35047,Jundiaí,Itupeva,SP,7095,10189,18142,26166,36766,44825,22773,22052,38941,5884,5.53%
3524105,3502,Ribeirão Preto,35011,Ituverava,Ituverava,SP,27380,27501,33003,36268,38539,38699,18875,19824,36431,2268,0.65%
3524204,3502,Ribeirão Preto,35010,São Joaquim da Barra,Jaborandi,SP,5792,5463,6336,6424,6462,6592,3338,3254,6166,426,0.26%
3524303,3502,Ribeirão Preto,35013,Jaboticabal,Jaboticabal,SP,38779,46981,59133,67408,69624,71667,34797,36870,69532,2135,0.61%
3524402,3513,Vale do Paraíba Paulista,35050,São José dos Campos,Jacareí,SP,61216,115738,163869,191291,207028,211308,103135,108173,208389,2919,1.00%
3524501,3501,São José do Rio Preto,35004,São José do Rio Preto,Jaci,SP,4000,3801,3237,4117,5008,5657,2892,2765,4871,786,3.23%
3524600,3514,Litoral Sul Paulista,35055,Registro,Jacupiranga,SP,16270,28558,38076,17041,16112,17196,8771,8425,9357,7839,0.09%
3524709,3507,Campinas,35032,Campinas,Jaguariúna,SP,10391,15213,24999,29597,36804,44331,22023,22308,43047,1284,4.12%
3524808,3501,São José do Rio Preto,35001,Jales,Jales,SP,38436,38601,45956,46186,47649,47012,22986,24026,44239,2773,0.18%
3524907,3513,Vale do Paraíba Paulista,35053,Paraibuna/Paraitinga,Jambeiro,SP,2857,2872,3285,3992,4968,5350,2768,2582,2561,2789,2.97%
3525003,3515,Metropolitana de São Paulo,35057,Osasco,Jandira,SP,12499,36043,62697,91807,103531,108436,53105,55331,108436,0,1.68%
3525102,3502,Ribeirão Preto,35014,Ribeirão Preto,Jardinópolis,SP,16992,19668,24123,30729,34611,37725,18975,18750,36201,1524,2.07%
3525201,3512,Macro Metropolitana Paulista,35048,Bragança Paulista,Jarinu,SP,5143,6238,10878,17041,20606,23827,11997,11830,18420,5407,3.41%
3525300,3504,Bauru,35021,Jaú,Jaú,SP,56301,74012,94116,112104,125469,131068,64222,66846,126971,4097,1.58%
3525409,3502,Ribeirão Preto,35012,Franca,Jeriquara,SP,1709,2564,3249,3280,3153,3168,1627,1541,2614,554,-0.35%
3525508,3512,Macro Metropolitana Paulista,35048,Bragança Paulista,Joanópolis,SP,7362,7754,8186,10409,10671,11771,5933,5838,11771,0,1.24%
3525607,3508,Presidente Prudente,35036,Presidente Prudente,João Ramalho,SP,2797,2850,3056,3842,4092,4138,2093,2045,3534,604,0.74%
3525706,3501,São José do Rio Preto,35004,São José do Rio Preto,José Bonifácio,SP,20738,22968,26488,28714,30639,32774,16365,16409,29695,3079,1.33%
3525805,3504,Bauru,35019,Lins,Júlio Mesquita,SP,4661,4590,3843,4166,4318,4430,2179,2251,4214,216,0.62%
3525854,3506,Piracicaba,35028,Piracicaba,Jumirim,SP,,,,2196,2205,2801,1445,1356,1629,1172,2.46%
3525904,3512,Macro Metropolitana Paulista,35047,Jundiaí,Jundiaí,SP,169076,258809,289269,323397,342983,370251,180102,190149,354301,15950,1.36%
3526001,3508,Presidente Prudente,35034,Dracena,Junqueirópolis,SP,22638,21373,17708,17005,18628,18726,9921,8805,15399,3327,0.97%
3526100,3514,Litoral Sul Paulista,35055,Registro,Juquiá,SP,12649,15161,16954,20516,19352,19269,9753,9516,12144,7125,-0.63%
3526209,3515,Metropolitana de São Paulo,35060,Itapecerica da Serra,Juquitiba,SP,7267,12497,19969,26459,27777,28732,14533,14199,22240,6492,0.83%
3526308,3513,Vale do Paraíba Paulista,35053,Paraibuna/Paraitinga,Lagoinha,SP,5590,4441,4635,4957,4798,4840,2479,2361,3137,1703,-0.24%
3526407,3511,Itapetininga,35043,Tatuí,Laranjal Paulista,SP,13107,15172,19144,22145,24454,25246,12461,12785,22602,2644,1.32%
3526506,3503,Araçatuba,35017,Araçatuba,Lavínia,SP,8372,6159,5437,5131,7984,8782,6188,2594,4287,4495,5.52%
3526605,3513,Vale do Paraíba Paulista,35051,Guaratinguetá,Lavrinhas,SP,3047,3674,4674,6008,6543,6586,3317,3269,6045,541,0.92%
3526704,3506,Piracicaba,35027,Limeira,Leme,SP,31229,46253,68215,80757,84406,91804,46054,45750,89902,1902,1.29%
3526803,3504,Bauru,35020,Bauru,Lençóis Paulista,SP,22423,35011,46246,55042,59366,61454,30498,30956,60077,1377,1.11%
3526902,3506,Piracicaba,35027,Limeira,Limeira,SP,90963,150561,207770,249046,272734,276010,135637,140373,267775,8235,1.03%
3527009,3507,Campinas,35033,Amparo,Lindóia,SP,2242,3213,4118,5331,5657,6708,3327,3381,6708,0,2.32%
3527108,3504,Bauru,35019,Lins,Lins,SP,45555,51038,58606,65952,69279,71493,34718,36775,70658,835,0.81%
3527207,3513,Vale do Paraíba Paulista,35051,Guaratinguetá,Lorena,SP,46463,57369,73146,77990,79317,82553,39869,42684,80182,2371,0.57%
3527256,3503,Araçatuba,35018,Birigui,Lourdes,SP,,,,2007,1974,2123,1104,1019,1744,379,0.56%
3527306,3512,Macro Metropolitana Paulista,35047,Jundiaí,Louveira,SP,6430,10322,16259,23903,29760,37153,18814,18339,35743,1410,4.51%
3527405,3508,Presidente Prudente,35035,Adamantina,Lucélia,SP,20472,18709,19286,18316,19212,19885,10560,9325,17222,2663,0.83%
3527504,3504,Bauru,35020,Bauru,Lucianópolis,SP,2213,2624,2354,2154,2299,2255,1123,1132,1789,466,0.46%
3527603,3502,Ribeirão Preto,35014,Ribeirão Preto,Luís Antônio,SP,3083,2926,5840,7160,10272,11286,5832,5454,10901,385,4.66%
3527702,3503,Araçatuba,35018,Birigui,Luiziânia,SP,4461,3865,4157,4274,4763,5030,2612,2418,4611,419,1.64%
3527801,3509,Marília,35038,Marília,Lupércio,SP,4588,3492,4082,4230,4238,4353,2121,2232,3865,488,0.29%
3527900,3510,Assis,35039,Assis,Lutécia,SP,4416,2997,2640,2897,2794,2703,1346,1357,2150,553,-0.69%
3528007,3504,Bauru,35021,Jaú,Macatuba,SP,7729,10859,13468,15752,16173,16246,8147,8099,15763,483,0.31%
3528106,3501,São José do Rio Preto,35007,Nhandeara,Macaubal,SP,6996,6387,7380,7385,7396,7663,3880,3783,6773,890,0.37%
3528205,3501,São José do Rio Preto,35002,Fernandópolis,Macedônia,SP,5475,4215,3956,3761,3411,3664,1837,1827,2777,887,-0.26%
3528304,3501,São José do Rio Preto,35006,Auriflama,Magda,SP,4217,3571,3679,3421,3154,3200,1651,1549,2655,545,-0.67%
3528403,3512,Macro Metropolitana Paulista,35046,Sorocaba,Mairinque,SP,18858,30828,43205,39975,41508,43225,21524,21701,34702,8523,0.78%
3528502,3515,Metropolitana de São Paulo,35058,Franco da Rocha,Mairiporã,SP,19584,27540,39937,60111,71754,80920,40937,39983,70659,10261,3.02%
3528601,3510,Assis,35040,Ourinhos,Manduri,SP,5083,5361,7277,8271,8651,8999,4523,4476,7785,1214,0.85%
3528700,3508,Presidente Prudente,35036,Presidente Prudente,Marabá Paulista,SP,7041,3863,3494,3699,5193,4812,3048,1764,2142,2670,2.67%
3528809,3510,Assis,35039,Assis,Maracaí,SP,11454,10054,12467,13004,13163,13344,6670,6674,12098,1246,0.26%
3528858,3501,São José do Rio Preto,35008,Novo Horizonte,Marapoama,SP,,,,2238,2556,2633,1345,1288,2203,430,1.64%
3528908,3508,Presidente Prudente,35035,Adamantina,Mariápolis,SP,7543,5326,4352,3854,3786,3916,2021,1895,3137,779,0.16%
3529005,3509,Marília,35038,Marília,Marília,SP,98176,121768,161149,197342,218113,216684,104694,111990,207737,8947,0.94%
3529104,3501,São José do Rio Preto,35001,Jales,Marinópolis,SP,2701,2072,2088,2195,2114,2113,1063,1050,1671,442,-0.38%
3529203,3508,Presidente Prudente,35036,Presidente Prudente,Martinópolis,SP,23072,19650,19673,22346,23983,24260,12618,11642,20379,3881,0.83%
3529302,3505,Araraquara,35024,Araraquara,Matão,SP,21953,38133,63613,71753,74407,76799,38038,38761,75386,1413,0.68%
3529401,3515,Metropolitana de São Paulo,35061,São Paulo,Mauá,SP,101700,205736,294998,363392,402643,417281,204180,213101,417281,0,1.39%
3529500,3501,São José do Rio Preto,35004,São José do Rio Preto,Mendonça,SP,4205,3999,3501,3759,3980,4640,2357,2283,3793,847,2.13%
3529609,3501,São José do Rio Preto,35002,Fernandópolis,Meridiano,SP,5795,3771,3784,4025,3857,3851,1890,1961,2676,1175,-0.44%
3529658,3501,São José do Rio Preto,35001,Jales,Mesópolis,SP,,,,1930,1768,1886,957,929,1468,418,-0.23%
3529708,3502,Ribeirão Preto,35010,São Joaquim da Barra,Miguelópolis,SP,18396,13537,17407,19019,19972,20442,10202,10240,19269,1173,0.72%
3529807,3504,Bauru,35021,Jaú,Mineiros do Tietê,SP,5096,6708,9467,11410,11760,12042,5993,6049,11504,538,0.54%
3529906,3514,Litoral Sul Paulista,35055,Registro,Miracatu,SP,14138,17359,18970,22383,22796,20595,10414,10181,10586,10009,-0.83%
3530003,3501,São José do Rio Preto,35002,Fernandópolis,Mira Estrela,SP,4084,2439,2667,2596,2576,2827,1406,1421,1881,946,0.86%
3530102,3503,Araçatuba,35016,Andradina,Mirandópolis,SP,23549,21522,24433,25936,25849,27475,15052,12423,24455,3020,0.58%
3530201,3508,Presidente Prudente,35036,Presidente Prudente,Mirante do Paranapanema,SP,21909,15459,15179,16213,17128,17064,8665,8399,10047,7017,0.51%
3530300,3501,São José do Rio Preto,35004,São José do Rio Preto,Mirassol,SP,20579,28309,39286,48327,51660,53809,26419,27390,52458,1351,1.08%
3530409,3501,São José do Rio Preto,35004,São José do Rio Preto,Mirassolândia,SP,2953,2701,3020,3741,4099,4295,2193,2102,3492,803,1.39%
3530508,3507,Campinas,35030,São João da Boa Vista,Mococa,SP,34819,47313,58374,65574,66086,66303,33067,33236,61159,5144,0.11%
3530607,3515,Metropolitana de São Paulo,35062,Mogi das Cruzes,Mogi das Cruzes,SP,138751,197935,273175,330241,362991,387241,188658,198583,357294,29947,1.60%
3530706,3507,Campinas,35031,Moji Mirim,Mogi Guaçu,SP,42710,73570,107454,124228,131870,137286,68115,69171,130336,6950,1.00%
3530805,3507,Campinas,35031,Moji Mirim,Moji Mirim,SP,36301,50633,64753,81467,84176,86244,42470,43774,80670,5574,0.57%
3530904,3506,Piracicaba,35028,Piracicaba,Mombuca,SP,3010,2659,2597,3107,3280,3266,1663,1603,2685,581,0.50%
3531001,3501,São José do Rio Preto,35007,Nhandeara,Monções,SP,2500,2413,2108,2055,2054,2134,1101,1033,1838,296,0.38%
3531100,3514,Litoral Sul Paulista,35056,Itanhaém,Mongaguá,SP,5213,9928,19026,35098,40423,46310,23109,23201,46108,202,2.81%
3531209,3507,Campinas,35033,Amparo,Monte Alegre do Sul,SP,4762,4850,5439,6321,6957,7148,3578,3570,4087,3061,1.24%
3531308,3502,Ribeirão Preto,35013,Jaboticabal,Monte Alto,SP,21520,31231,39742,43613,44085,46647,22980,23667,44548,2099,0.67%
3531407,3501,São José do Rio Preto,35007,Nhandeara,Monte Aprazível,SP,17005,16442,17504,18413,19745,21748,10815,10933,19805,1943,1.68%
3531506,3502,Ribeirão Preto,35013,Jaboticabal,Monte Azul Paulista,SP,10431,13021,17698,19553,19187,18931,9491,9440,17713,1218,-0.32%
3531605,3508,Presidente Prudente,35034,Dracena,Monte Castelo,SP,6376,6140,4718,4089,4014,4063,2011,2052,3211,852,-0.06%
3531704,3513,Vale do Paraíba Paulista,35049,Campos do Jordão,Monteiro Lobato,SP,3180,2687,3380,3615,3994,4123,2149,1974,1790,2333,1.32%
3531803,3507,Campinas,35032,Campinas,Monte Mor,SP,7960,14020,25559,37340,42824,48971,24496,24475,45996,2975,2.75%
3531902,3502,Ribeirão Preto,35010,São Joaquim da Barra,Morro Agudo,SP,16609,17444,21253,25428,25390,29127,14885,14242,27918,1209,1.37%
3532009,3512,Macro Metropolitana Paulista,35048,Bragança Paulista,Morungaba,SP,5032,6528,8210,9911,12007,11775,5897,5878,10057,1718,1.74%
3532058,3505,Araraquara,35024,Araraquara,Motuca,SP,,,,3871,4340,4290,2162,2128,3108,1182,1.03%
3532108,3503,Araçatuba,35016,Andradina,Murutinga do Sul,SP,5384,4580,3782,3971,4091,4186,2097,2089,2573,1613,0.53%
3532157,3510,Assis,35039,Assis,Nantes,SP,,,,2269,2483,2707,1357,1350,2431,276,1.78%
3532207,3508,Presidente Prudente,35036,Presidente Prudente,Narandiba,SP,4008,3533,3138,3743,3941,4289,2172,2117,3105,1184,1.37%
3532306,3513,Vale do Paraíba Paulista,35053,Paraibuna/Paraitinga,Natividade da Serra,SP,9957,6888,6458,6952,7275,6681,3487,3194,2788,3893,-0.40%
3532405,3512,Macro Metropolitana Paulista,35048,Bragança Paulista,Nazaré Paulista,SP,10009,8419,11671,14410,14613,16413,8453,7960,13910,2503,1.31%
3532504,3501,São José do Rio Preto,35007,Nhandeara,Neves Paulista,SP,8199,7804,8313,8907,8825,8777,4365,4412,7921,856,-0.15%
3532603,3501,São José do Rio Preto,35007,Nhandeara,Nhandeara,SP,10996,10223,10343,10194,10334,10725,5281,5444,8688,2037,0.51%
3532702,3501,São José do Rio Preto,35007,Nhandeara,Nipoã,SP,3046,2737,2796,3267,3762,4274,2262,2012,3797,477,2.72%
3532801,3501,São José do Rio Preto,35004,São José do Rio Preto,Nova Aliança,SP,4577,4287,4194,4768,4905,5891,2922,2969,4881,1010,2.14%
3532827,3511,Itapetininga,35041,Itapeva,Nova Campina,SP,,,,7295,8474,8515,4345,4170,5762,2753,1.56%
3532843,3501,São José do Rio Preto,35001,Jales,Nova Canaã Paulista,SP,,,,2483,2205,2114,1076,1038,880,1234,-1.60%
3532868,3501,São José do Rio Preto,35006,Auriflama,Nova Castilho,SP,,,,991,1057,1127,557,570,746,381,1.29%
3532900,3505,Araraquara,35024,Araraquara,Nova Europa,SP,3822,4508,5381,7307,9047,9301,4648,4653,8629,672,2.44%
3533007,3501,São José do Rio Preto,35004,São José do Rio Preto,Nova Granada,SP,12032,11440,14895,17020,17739,19178,9660,9518,17773,1405,1.20%
3533106,3508,Presidente Prudente,35034,Dracena,Nova Guataporanga,SP,2375,2708,2133,2087,2101,2178,1104,1074,1893,285,0.43%
3533205,3503,Araçatuba,35016,Andradina,Nova Independência,SP,2042,1867,1994,2063,2480,3072,1526,1546,2448,624,4.06%
3533254,3501,São José do Rio Preto,35005,Catanduva,Novais,SP,,,,3225,3661,4595,2479,2116,4184,411,3.60%
3533304,3501,São José do Rio Preto,35006,Auriflama,Nova Luzitânia,SP,2678,1970,2646,2749,3403,3441,1820,1621,3087,354,2.27%
3533403,3507,Campinas,35032,Campinas,Nova Odessa,SP,8336,21891,34063,42071,45625,51278,25365,25913,50440,838,2.00%
3533502,3501,São José do Rio Preto,35008,Novo Horizonte,Novo Horizonte,SP,23098,26816,30446,32432,34264,36612,18270,18342,34067,2545,1.22%
3533601,3502,Ribeirão Preto,35010,São Joaquim da Barra,Nuporanga,SP,5676,5062,5789,6309,6629,6817,3410,3407,6185,632,0.78%
3533700,3509,Marília,35038,Marília,Ocauçu,SP,5955,4828,4311,4164,4180,4163,2137,2026,3324,839,-0.00%
3533809,3510,Assis,35040,Ourinhos,Óleo,SP,4406,2996,2801,2994,2714,2673,1344,1329,1763,910,-1.13%
3533908,3501,São José do Rio Preto,35004,São José do Rio Preto,Olímpia,SP,29079,31787,42907,46013,48020,49792,24562,25230,47092,2700,0.79%
3534005,3501,São José do Rio Preto,35004,São José do Rio Preto,Onda Verde,SP,2180,2015,2829,3413,3736,3884,1993,1891,3043,841,1.30%
3534104,3509,Marília,35038,Marília,Oriente,SP,8781,6472,6803,5884,6079,6097,2985,3112,5695,402,0.36%
3534203,3501,São José do Rio Preto,35004,São José do Rio Preto,Orindiúva,SP,2443,2118,3046,4161,4916,5678,2900,2778,5226,452,3.16%
3534302,3502,Ribeirão Preto,35010,São Joaquim da Barra,Orlândia,SP,18275,25330,31319,36004,36149,39781,19499,20282,38756,1025,1.00%
3534401,3515,Metropolitana de São Paulo,35057,Osasco,Osasco,SP,283073,474544,568225,652593,701012,666469,320268,346201,666469,0,0.21%
3534500,3509,Marília,35038,Marília,Oscar Bressane,SP,4197,3077,2532,2552,2476,2539,1218,1321,2101,438,-0.05%
3534609,3508,Presidente Prudente,35035,Adamantina,Osvaldo Cruz,SP,23377,26113,28918,29648,30150,30917,15554,15363,27782,3135,0.42%
3534708,3510,Assis,35040,Ourinhos,Ourinhos,SP,49221,59738,76923,93868,98868,103026,49972,53054,100368,2658,0.94%
3534757,3501,São José do Rio Preto,35002,Fernandópolis,Ouroeste,SP,,,,6290,7035,8406,4191,4215,7547,859,2.94%
3534807,3508,Presidente Prudente,35034,Dracena,Ouro Verde,SP,7706,5854,7093,7148,7668,7794,3864,3930,7170,624,0.87%
3534906,3508,Presidente Prudente,35035,Adamantina,Pacaembu,SP,17211,15719,12365,12518,13072,12934,7450,5484,9745,3189,0.33%
3535002,3501,São José do Rio Preto,35004,São José do Rio Preto,Palestina,SP,12129,9018,9011,9100,10428,11052,5596,5456,9189,1863,1.96%
3535101,3501,São José do Rio Preto,35005,Catanduva,Palmares Paulista,SP,3105,4266,7321,8437,10508,10938,5863,5075,10623,315,2.63%
3535200,3501,São José do Rio Preto,35001,Jales,Palmeira d'Oeste,SP,15345,12673,10950,10322,9634,9584,4805,4779,7268,2316,-0.74%
3535309,3510,Assis,35039,Assis,Palmital,SP,20066,17129,18683,20701,21298,21257,10393,10864,19498,1759,0.27%
3535408,3508,Presidente Prudente,35034,Dracena,Panorama,SP,6568,8073,12343,13649,13944,14603,7319,7284,14168,435,0.68%
3535507,3510,Assis,35039,Assis,Paraguaçu Paulista,SP,21892,23596,33840,39618,42117,42281,21264,21017,38319,3962,0.65%
3535606,3513,Vale do Paraíba Paulista,35053,Paraibuna/Paraitinga,Paraibuna,SP,13845,14126,14891,17009,16456,17384,8823,8561,5240,12144,0.22%
3535705,3501,São José do Rio Preto,35005,Catanduva,Paraíso,SP,3422,3617,4733,5429,5559,5907,3019,2888,5194,713,0.85%
3535804,3504,Bauru,35022,Avaré,Paranapanema,SP,9984,11064,12796,15510,16667,17810,9061,8749,14481,3329,1.39%
3535903,3501,São José do Rio Preto,35001,Jales,Paranapuã,SP,9190,5789,5777,3632,3614,3815,1950,1865,3394,421,0.49%
3536000,3508,Presidente Prudente,35035,Adamantina,Parapuã,SP,11198,12273,11418,11104,11029,10844,5535,5309,8896,1948,-0.24%
3536109,3504,Bauru,35023,Botucatu,Pardinho,SP,3098,2746,3444,4732,5030,5582,2844,2738,4389,1193,1.67%
3536208,3514,Litoral Sul Paulista,35055,Registro,Pariquera-Açu,SP,7806,11319,13164,17649,18079,18453,9143,9310,12661,5792,0.45%
3536257,3501,São José do Rio Preto,35003,Votuporanga,Parisi,SP,,,,1948,2038,2032,1044,988,1643,389,0.42%
3536307,3502,Ribeirão Preto,35012,Franca,Patrocínio Paulista,SP,8635,9016,9715,11416,12183,13002,6596,6406,10501,2501,1.31%
3536406,3508,Presidente Prudente,35034,Dracena,Paulicéia,SP,3385,2378,4157,5302,5506,6342,3292,3050,5271,1071,1.81%
3536505,3507,Campinas,35032,Campinas,Paulínia,SP,10708,20753,36706,51326,73014,82150,40677,41473,82074,76,4.82%
3536570,3504,Bauru,35020,Bauru,Paulistânia,SP,,,,1779,1824,1778,919,859,1211,567,-0.01%
3536604,3501,São José do Rio Preto,35004,São José do Rio Preto,Paulo de Faria,SP,9463,6638,8319,8472,8942,8589,4299,4290,7750,839,0.14%
3536703,3504,Bauru,35021,Jaú,Pederneiras,SP,18399,26107,32021,36614,40270,41530,20879,20651,38613,2917,1.27%
3536802,3507,Campinas,35033,Amparo,Pedra Bela,SP,5230,4686,5142,5609,5835,5780,3030,2750,1440,4340,0.30%
3536901,3501,São José do Rio Preto,35002,Fernandópolis,Pedranópolis,SP,4495,3554,3105,2734,2734,2561,1309,1252,1593,968,-0.65%
3537008,3502,Ribeirão Preto,35012,Franca,Pedregulho,SP,14780,12919,13729,14994,15156,15699,7982,7717,11585,4114,0.46%
3537107,3507,Campinas,35032,Campinas,Pedreira,SP,15053,21381,27972,35219,38152,41549,20592,20957,41197,352,1.67%
3537156,3510,Assis,35039,Assis,Pedrinhas Paulista,SP,,,,2861,2834,2936,1460,1476,2479,457,0.26%
3537206,3514,Litoral Sul Paulista,35056,Itanhaém,Pedro de Toledo,SP,6095,6060,7836,9187,9692,10213,5162,5051,7042,3171,1.06%
3537305,3503,Araçatuba,35018,Birigui,Penápolis,SP,34263,40332,48285,54635,56681,58529,28579,29950,55901,2628,0.69%
3537404,3503,Araçatuba,35016,Andradina,Pereira Barreto,SP,52413,46366,49932,25028,24220,24959,12270,12689,23235,1724,-0.03%
3537503,3511,Itapetininga,35043,Tatuí,Pereiras,SP,4834,3763,4447,6226,7347,7468,3793,3675,4981,2487,1.84%
3537602,3514,Litoral Sul Paulista,35056,Itanhaém,Peruíbe,SP,6966,18411,32773,51451,54457,59793,29153,30640,59125,668,1.51%
3537701,3503,Araçatuba,35018,Birigui,Piacatu,SP,5352,4741,4539,4625,5093,5287,2662,2625,4663,624,1.35%
3537800,3512,Macro Metropolitana Paulista,35045,Piedade,Piedade,SP,27640,35897,43581,50131,48430,52214,26602,25612,23782,28432,0.41%
3537909,3512,Macro Metropolitana Paulista,35045,Piedade,Pilar do Sul,SP,10265,13857,19488,23948,26457,26411,13415,12996,20590,5821,0.98%
3538006,3513,Vale do Paraíba Paulista,35050,São José dos Campos,Pindamonhangaba,SP,48222,69568,102063,126026,135682,147034,72310,74724,141737,5297,1.55%
3538105,3501,São José do Rio Preto,35005,Catanduva,Pindorama,SP,9045,10188,12374,13109,14345,15043,7695,7348,14239,804,1.39%
3538204,3507,Campinas,35033,Amparo,Pinhalzinho,SP,4912,6432,8433,10986,11817,13104,6592,6512,6455,6649,1.78%
3538303,3508,Presidente Prudente,35036,Presidente Prudente,Piquerobi,SP,5351,3545,3268,3478,3599,3541,1755,1786,2673,868,0.18%
3538501,3513,Vale do Paraíba Paulista,35051,Guaratinguetá,Piquete,SP,14316,14364,14749,15200,14475,14107,6817,7290,13212,895,-0.74%
3538600,3512,Macro Metropolitana Paulista,35048,Bragança Paulista,Piracaia,SP,12883,13792,18999,23347,22335,25139,12532,12607,25139,0,0.74%
3538709,3506,Piracicaba,35028,Piracicaba,Piracicaba,SP,152505,214307,283833,329158,358108,364872,178538,186334,355136,9736,1.04%
3538808,3510,Assis,35040,Ourinhos,Piraju,SP,20336,21384,26076,27897,28228,28489,13833,14656,25617,2872,0.21%
3538907,3504,Bauru,35020,Bauru,Pirajuí,SP,20344,19423,18829,20095,21035,22724,12584,10140,18511,4213,1.24%
3539004,3502,Ribeirão Preto,35013,Jaboticabal,Pirangi,SP,6210,7587,9867,10038,10315,10623,5393,5230,9528,1095,0.57%
3539103,3515,Metropolitana de São Paulo,35057,Osasco,Pirapora do Bom Jesus,SP,3694,4814,7956,12395,14370,15727,7809,7918,15727,0,2.41%
3539202,3508,Presidente Prudente,35036,Presidente Prudente,Pirapozinho,SP,15922,17918,20992,22104,23709,24718,12087,12631,23477,1241,1.12%
3539301,3507,Campinas,35029,Pirassununga,Pirassununga,SP,37577,44970,56746,64864,67787,70138,34311,35827,64264,5874,0.78%
3539400,3504,Bauru,35020,Bauru,Piratininga,SP,10232,10056,9656,10584,11287,12072,5983,6089,10347,1725,1.32%
3539509,3502,Ribeirão Preto,35013,Jaboticabal,Pitangueiras,SP,15813,18602,29490,31156,33329,35314,18008,17306,33955,1359,1.26%
3539608,3501,São José do Rio Preto,35004,São José do Rio Preto,Planalto,SP,7250,6041,5458,3670,4014,4472,2320,2152,3775,697,2.00%
3539707,3510,Assis,35039,Assis,Platina,SP,2966,2279,2829,2867,3167,3192,1660,1532,2513,679,1.08%
3539806,3515,Metropolitana de São Paulo,35062,Mogi das Cruzes,Poá,SP,32373,52787,76302,95801,104904,106033,51330,54703,104355,1678,1.02%
3539905,3501,São José do Rio Preto,35007,Nhandeara,Poloni,SP,5105,4775,4526,4774,4878,5395,2671,2724,4802,593,1.23%
3540002,3509,Marília,35038,Marília,Pompéia,SP,17877,16261,17236,18171,19091,19963,9792,10171,18573,1390,0.94%
3540101,3504,Bauru,35020,Bauru,Pongaí,SP,3283,3540,3581,3693,3473,3479,1793,1686,2923,556,-0.60%
3540200,3502,Ribeirão Preto,35014,Ribeirão Preto,Pontal,SP,13728,16751,22805,29681,35560,40245,21175,19070,39493,752,3.09%
3540259,3501,São José do Rio Preto,35001,Jales,Pontalinda,SP,,,,3539,3906,4074,2160,1914,3381,693,1.42%
3540309,3501,São José do Rio Preto,35003,Votuporanga,Pontes Gestal,SP,3447,2859,2965,2539,2487,2523,1258,1265,2128,395,-0.06%
3540408,3501,São José do Rio Preto,35001,Jales,Populina,SP,8066,4714,4673,4450,4201,4223,2139,2084,3412,811,-0.52%
3540507,3511,Itapetininga,35043,Tatuí,Porangaba,SP,7577,6406,6841,6652,8069,8333,4295,4038,4028,4305,2.28%
3540606,3512,Macro Metropolitana Paulista,35046,Sorocaba,Porto Feliz,SP,22152,27127,36936,45514,46054,48914,24545,24369,41111,7803,0.72%
3540705,3507,Campinas,35029,Pirassununga,Porto Ferreira,SP,19216,27991,38492,47437,48760,51407,25506,25901,50485,922,0.81%
3540754,3513,Vale do Paraíba Paulista,35051,Guaratinguetá,Potim,SP,,,,13605,18143,19413,10986,8427,14710,4703,3.62%
3540804,3501,São José do Rio Preto,35004,São José do Rio Preto,Potirendaba,SP,9880,10705,11201,13656,14327,15453,7857,7596,13886,1567,1.24%
3540853,3508,Presidente Prudente,35035,Adamantina,Pracinha,SP,,,,1431,2667,2863,2085,778,1369,1494,7.18%
3540903,3502,Ribeirão Preto,35014,Ribeirão Preto,Pradópolis,SP,5796,7827,9870,12912,15148,17404,8901,8503,16127,1277,3.03%
3541000,3515,Metropolitana de São Paulo,35063,Santos,Praia Grande,SP,19694,66004,123492,193582,233806,260769,125280,135489,260769,0,3.02%
3541059,3504,Bauru,35023,Botucatu,Pratânia,SP,,,,3950,4309,4599,2379,2220,3485,1114,1.53%
3541109,3504,Bauru,35020,Bauru,Presidente Alves,SP,5117,4866,4504,4317,4346,4123,2038,2085,3431,692,-0.46%
3541208,3508,Presidente Prudente,35036,Presidente Prudente,Presidente Bernardes,SP,25590,15784,16311,14662,14788,13544,6673,6871,10473,3071,-0.79%
3541307,3508,Presidente Prudente,35036,Presidente Prudente,Presidente Epitácio,SP,26428,29608,34851,39298,39403,41324,20219,21105,38551,2773,0.50%
3541406,3508,Presidente Prudente,35036,Presidente Prudente,Presidente Prudente,SP,105707,136849,165484,189186,202789,207625,99913,107712,203370,4255,0.93%
3541505,3508,Presidente Prudente,35036,Presidente Prudente,Presidente Venceslau,SP,25976,30160,36120,37347,37155,37915,18918,18997,36275,1640,0.15%
3541604,3504,Bauru,35019,Lins,Promissão,SP,20544,20222,27981,31105,34786,35688,17760,17928,30084,5604,1.38%
3541653,3511,Itapetininga,35043,Tatuí,Quadra,SP,,,,2651,2679,3236,1707,1529,828,2408,2.01%
3541703,3510,Assis,35039,Assis,Quatá,SP,11581,8744,11358,11655,11971,12828,6412,6416,12040,788,0.96%
3541802,3509,Marília,35037,Tupã,Queiroz,SP,3372,2299,1936,2171,2603,2808,1424,1384,2385,423,2.61%
3541901,3513,Vale do Paraíba Paulista,35051,Guaratinguetá,Queluz,SP,5919,7002,7710,9112,10323,11325,5767,5558,9282,2043,2.20%
3542008,3509,Marília,35037,Tupã,Quintana,SP,6488,4905,5188,5443,5654,6008,2971,3037,5498,510,0.99%
3542107,3506,Piracicaba,35028,Piracicaba,Rafard,SP,5118,5940,8588,8360,8151,8624,4267,4357,7603,1021,0.31%
3542206,3508,Presidente Prudente,35036,Presidente Prudente,Rancharia,SP,22041,23341,26913,28772,28303,28773,14130,14643,25801,2972,0.00%
3542305,3513,Vale do Paraíba Paulista,35053,Paraibuna/Paraitinga,Redenção da Serra,SP,5135,4001,4008,4047,4081,3879,2016,1863,2214,1665,-0.42%
3542404,3508,Presidente Prudente,35036,Presidente Prudente,Regente Feijó,SP,10366,11083,14963,16998,17070,18496,9196,9300,17048,1448,0.85%
3542503,3504,Bauru,35020,Bauru,Reginópolis,SP,4472,4619,4774,4742,6993,7325,4683,2642,4362,2963,4.44%
3542602,3514,Litoral Sul Paulista,35055,Registro,Registro,SP,24281,39109,48953,53752,53369,54279,26667,27612,48187,6092,0.10%
3542701,3502,Ribeirão Preto,35012,Franca,Restinga,SP,5456,3541,4407,5584,6350,6587,3296,3291,5179,1408,1.67%
3542800,3511,Itapetininga,35044,Capão Bonito,Ribeira,SP,7174,7463,7336,3507,3444,3358,1742,1616,1236,2122,-0.43%
3542909,3505,Araraquara,35025,São Carlos,Ribeirão Bonito,SP,6856,8360,10329,11246,11383,12129,6100,6029,11214,915,0.76%
3543006,3511,Itapetininga,35044,Capão Bonito,Ribeirão Branco,SP,10113,13903,19278,21231,18879,18272,9398,8874,9296,8976,-1.49%
3543105,3502,Ribeirão Preto,35012,Franca,Ribeirão Corrente,SP,2193,2741,3229,3881,4014,4273,2218,2055,3397,876,0.97%
3543204,3510,Assis,35040,Ourinhos,Ribeirão do Sul,SP,3619,3129,3606,4497,4497,4464,2244,2220,3309,1155,-0.07%
3543238,3508,Presidente Prudente,35036,Presidente Prudente,Ribeirão dos Índios,SP,,,,2222,2231,2187,1088,1099,1850,337,-0.16%
3543253,3511,Itapetininga,35044,Capão Bonito,Ribeirão Grande,SP,,,,7390,6928,7419,3793,3626,2342,5077,0.04%
3543303,3515,Metropolitana de São Paulo,35061,São Paulo,Ribeirão Pires,SP,29048,56530,85085,104508,107046,113043,55275,57768,113043,0,0.79%
3543402,3502,Ribeirão Preto,35014,Ribeirão Preto,Ribeirão Preto,SP,212879,318544,436682,504923,547417,605114,290286,314828,603401,1713,1.83%
3543501,3511,Itapetininga,35041,Itapeva,Riversul,SP,9143,11335,9399,7192,6545,6165,3046,3119,4494,1671,-1.53%
3543600,3502,Ribeirão Preto,35012,Franca,Rifaina,SP,6180,3367,2897,3325,3587,3436,1725,1711,3009,427,0.33%
3543709,3505,Araraquara,35024,Araraquara,Rincão,SP,6538,7301,10356,10330,10425,10414,5244,5170,8460,1954,0.08%
3543808,3508,Presidente Prudente,35035,Adamantina,Rinópolis,SP,14420,15161,11169,10255,9393,9935,5051,4884,8636,1299,-0.32%
3543907,3506,Piracicaba,35026,Rio Claro,Rio Claro,SP,78040,110202,138243,168218,185421,186299,90708,95591,181766,4533,1.03%
3544004,3506,Piracicaba,35028,Piracicaba,Rio das Pedras,SP,8917,13472,19104,23494,26344,29508,14922,14586,28569,939,2.31%
3544103,3515,Metropolitana de São Paulo,35061,São Paulo,Rio Grande da Serra,SP,8397,20091,29901,37091,39270,44084,21877,22207,44084,0,1.74%
3544202,3501,São José do Rio Preto,35003,Votuporanga,Riolândia,SP,9640,6836,7760,8560,9713,10574,6021,4553,8365,2209,2.14%
3544251,3508,Presidente Prudente,35036,Presidente Prudente,Rosana,SP,,,,24229,19943,19691,9780,9911,15858,3833,-2.05%
3544301,3513,Vale do Paraíba Paulista,35051,Guaratinguetá,Roseira,SP,3492,4856,6217,8577,9016,9606,4846,4760,9123,483,1.14%
3544400,3503,Araçatuba,35017,Araçatuba,Rubiácea,SP,3376,2201,2639,2337,2501,2729,1392,1337,1563,1166,1.56%
3544509,3501,São José do Rio Preto,35001,Jales,Rubinéia,SP,4849,2413,2236,2615,2546,2862,1415,1447,2355,507,0.91%
3544608,3504,Bauru,35019,Lins,Sabino,SP,5044,4829,4571,4951,5150,5226,2629,2597,4584,642,0.54%
3544707,3508,Presidente Prudente,35035,Adamantina,Sagres,SP,4083,3016,2653,2439,2307,2395,1191,1204,1819,576,-0.18%
3544806,3501,São José do Rio Preto,35008,Novo Horizonte,Sales,SP,4053,4791,3758,4563,5025,5450,2786,2664,4903,547,1.79%
3544905,3502,Ribeirão Preto,35010,São Joaquim da Barra,Sales Oliveira,SP,7108,6417,7632,9325,8187,10568,5241,5327,9569,999,1.26%
3545001,3515,Metropolitana de São Paulo,35062,Mogi das Cruzes,Salesópolis,SP,9557,10657,11359,14357,15157,15639,7908,7731,9956,5683,0.86%
3545100,3508,Presidente Prudente,35035,Adamantina,Salmourão,SP,4954,4778,4462,4401,4551,4818,2477,2341,4321,497,0.91%
3545159,3506,Piracicaba,35028,Piracicaba,Saltinho,SP,,,,5799,6586,7059,3519,3540,5891,1168,1.99%
3545209,3512,Macro Metropolitana Paulista,35046,Sorocaba,Salto,SP,21772,42379,72333,93159,102405,105569,52146,53423,104827,742,1.26%
3545308,3512,Macro Metropolitana Paulista,35046,Sorocaba,Salto de Pirapora,SP,9001,14688,25344,35072,37324,40141,19959,20182,31463,8678,1.36%
3545407,3510,Assis,35040,Ourinhos,Salto Grande,SP,7123,7011,7678,8444,8592,8787,4354,4433,7934,853,0.40%
3545506,3508,Presidente Prudente,35036,Presidente Prudente,Sandovalina,SP,3090,2735,2403,3089,3217,3699,1884,1815,2581,1118,1.82%
3545605,3501,São José do Rio Preto,35005,Catanduva,Santa Adélia,SP,8857,10280,12615,13449,13861,14333,7164,7169,13560,773,0.64%
3545704,3501,São José do Rio Preto,35001,Jales,Santa Albertina,SP,9734,6181,5870,5586,5034,5723,2905,2818,4891,832,0.24%
3545803,3507,Campinas,35032,Campinas,Santa Bárbara d'Oeste,SP,31018,76628,145266,170078,184318,180148,89311,90837,178728,1420,0.58%
3546009,3513,Vale do Paraíba Paulista,35050,São José dos Campos,Santa Branca,SP,6831,8501,10306,13010,13282,13770,6878,6892,12145,1625,0.57%
3546108,3501,São José do Rio Preto,35001,Jales,Santa Clara d'Oeste,SP,3913,2653,2497,2123,2081,2084,1073,1011,1571,513,-0.19%
3546207,3506,Piracicaba,35027,Limeira,Santa Cruz da Conceição,SP,2184,2687,2937,3531,3872,3998,1979,2019,2708,1290,1.25%
3546256,3502,Ribeirão Preto,35015,Batatais,Santa Cruz da Esperança,SP,,,,1796,1707,1953,966,987,1323,630,0.84%
3546306,3507,Campinas,35029,Pirassununga,Santa Cruz das Palmeiras,SP,13000,16085,21819,25556,30458,29974,15245,14729,29042,932,1.61%
3546405,3510,Assis,35040,Ourinhos,Santa Cruz do Rio Pardo,SP,34412,33616,39544,40919,41655,43929,21513,22416,40161,3768,0.71%
3546504,3502,Ribeirão Preto,35013,Jaboticabal,Santa Ernestina,SP,2903,3498,5613,5741,5510,5568,2852,2716,5145,423,-0.31%
3546603,3501,São José do Rio Preto,35001,Jales,Santa Fé do Sul,SP,16939,20370,23110,26512,27693,29235,14073,15162,28084,1151,0.98%
3546702,3506,Piracicaba,35027,Limeira,Santa Gertrudes,SP,6010,7987,10485,15906,19044,21644,10957,10687,21414,230,3.13%
3546801,3515,Metropolitana de São Paulo,35059,Guarulhos,Santa Isabel,SP,17161,29013,37975,43740,44817,50464,25260,25204,39596,10868,1.44%
3546900,3505,Araraquara,35024,Araraquara,Santa Lúcia,SP,4347,5038,6284,7853,7862,8246,4129,4117,7752,494,0.49%
3547007,3506,Piracicaba,35028,Piracicaba,Santa Maria da Serra,SP,2144,2852,4303,4673,5417,5418,2750,2668,4777,641,1.49%
3547106,3508,Presidente Prudente,35034,Dracena,Santa Mercedes,SP,4903,4114,2982,2803,2589,2831,1423,1408,2458,373,0.10%
3547205,3501,São José do Rio Preto,35001,Jales,Santana da Ponte Pensa,SP,3906,2794,2365,1894,1654,1641,841,800,1097,544,-1.42%
3547304,3515,Metropolitana de São Paulo,35057,Osasco,Santana de Parnaíba,SP,5390,10098,37762,74828,100236,108875,53652,55223,108875,0,3.82%
3547403,3501,São José do Rio Preto,35001,Jales,Santa Rita d'Oeste,SP,6561,4238,3487,2695,2493,2543,1264,1279,1773,770,-0.58%
3547502,3502,Ribeirão Preto,35014,Ribeirão Preto,Santa Rita do Passa Quatro,SP,19064,20876,24124,26138,26456,26420,12785,13635,23643,2777,0.11%
3547601,3502,Ribeirão Preto,35014,Ribeirão Preto,Santa Rosa de Viterbo,SP,11840,14431,19195,21435,22699,23871,11780,12091,22756,1115,1.08%
3547650,3501,São José do Rio Preto,35001,Jales,Santa Salete,SP,,,,1379,1390,1447,743,704,819,628,0.48%
3547700,3508,Presidente Prudente,35036,Presidente Prudente,Santo Anastácio,SP,25332,21652,22079,20749,20550,20498,9994,10504,19100,1398,-0.12%
3547809,3515,Metropolitana de São Paulo,35061,São Paulo,Santo André,SP,418826,553077,616991,649331,667891,673914,323208,350706,673914,0,0.37%
3547908,3502,Ribeirão Preto,35015,Batatais,Santo Antônio da Alegria,SP,4462,5291,5155,5764,6020,6304,3260,3044,4669,1635,0.90%
3548005,3507,Campinas,35031,Moji Mirim,Santo Antônio de Posse,SP,7799,10877,14327,18124,19824,20635,10398,10237,18813,1822,1.31%
3548054,3503,Araçatuba,35017,Araçatuba,Santo Antônio do Aracanguá,SP,,,,6929,7034,7627,3881,3746,5977,1650,0.96%
3548104,3507,Campinas,35030,São João da Boa Vista,Santo Antônio do Jardim,SP,4833,5535,5687,6154,5743,5943,3045,2898,3532,2411,-0.35%
3548203,3513,Vale do Paraíba Paulista,35049,Campos do Jordão,Santo Antônio do Pinhal,SP,5479,5359,5355,6328,6560,6516,3285,3231,3868,2648,0.29%
3548302,3508,Presidente Prudente,35036,Presidente Prudente,Santo Expedito,SP,4148,2263,2222,2526,2759,2806,1407,1399,2484,322,1.06%
3548401,3503,Araçatuba,35018,Birigui,Santópolis do Aguapeí,SP,3596,3462,3845,3816,4008,4281,2170,2111,4134,147,1.16%
3548500,3515,Metropolitana de São Paulo,35063,Santos,Santos,SP,345630,416677,428923,417983,418288,419757,192056,227701,419443,314,0.04%
3548609,3513,Vale do Paraíba Paulista,35049,Campos do Jordão,São Bento do Sapucaí,SP,9365,9316,8695,10355,10515,10462,5268,5194,5032,5430,0.10%
3548708,3515,Metropolitana de São Paulo,35061,São Paulo,São Bernardo do Campo,SP,201662,425611,566893,703177,781390,765203,369489,395714,752414,12789,0.85%
3548807,3515,Metropolitana de São Paulo,35061,São Paulo,São Caetano do Sul,SP,150130,163086,149519,140159,144857,149571,69024,80547,149571,0,0.65%
3548906,3505,Araraquara,35025,São Carlos,São Carlos,SP,85425,119535,158221,192998,212956,221936,108875,113061,213070,8866,1.41%
3549003,3501,São José do Rio Preto,35001,Jales,São Francisco,SP,6595,4613,4445,2863,2812,2793,1400,1393,2167,626,-0.25%
3549102,3507,Campinas,35030,São João da Boa Vista,São João da Boa Vista,SP,44471,55938,69148,77387,79935,83661,40558,43103,80324,3337,0.78%
3549201,3501,São José do Rio Preto,35002,Fernandópolis,São João das Duas Pontes,SP,4026,2963,2791,2660,2571,2566,1290,1276,1961,605,-0.36%
3549250,3501,São José do Rio Preto,35006,Auriflama,São João de Iracema,SP,,,,1671,1725,1780,898,882,1452,328,0.63%
3549300,3508,Presidente Prudente,35034,Dracena,São João do Pau d'Alho,SP,3733,3600,2814,2180,2132,2103,1057,1046,1705,398,-0.36%
3549409,3502,Ribeirão Preto,35010,São Joaquim da Barra,São Joaquim da Barra,SP,24359,29305,35964,41587,43703,46524,22801,23723,45690,834,1.13%
3549508,3502,Ribeirão Preto,35012,Franca,São José da Bela Vista,SP,6781,6648,7119,8075,8173,8407,4312,4095,7486,921,0.40%
3549607,3513,Vale do Paraíba Paulista,35052,Bananal,São José do Barreiro,SP,5438,4034,3933,4143,4278,4097,2061,2036,2872,1225,-0.11%
3549706,3507,Campinas,35030,São João da Boa Vista,São José do Rio Pardo,SP,31662,36164,44579,50077,51023,51910,25550,26360,45974,5936,0.36%
3549805,3501,São José do Rio Preto,35004,São José do Rio Preto,São José do Rio Preto,SP,122134,188599,283761,358523,402770,408435,196114,212321,383558,24877,1.31%
3549904,3513,Vale do Paraíba Paulista,35050,São José dos Campos,São José dos Campos,SP,148332,287513,442370,539313,594948,627544,307394,320150,615610,11934,1.53%
3549953,3515,Metropolitana de São Paulo,35060,Itapecerica da Serra,São Lourenço da Serra,SP,,,,12199,16121,13985,7100,6885,12725,1260,1.38%
3550001,3513,Vale do Paraíba Paulista,35053,Paraibuna/Paraitinga,São Luís do Paraitinga,SP,11655,9750,9922,10429,10496,10404,5321,5083,6185,4219,-0.02%
3550100,3504,Bauru,35023,Botucatu,São Manuel,SP,27402,27549,35438,36545,37797,38390,18792,19598,37461,929,0.49%
3550209,3512,Macro Metropolitana Paulista,35045,Piedade,São Miguel Arcanjo,SP,13864,17145,25382,30798,30384,31452,15996,15456,21504,9948,0.21%
3550308,3515,Metropolitana de São Paulo,35061,São Paulo,São Paulo,SP,5924612,8493217,9646185,10434252,10886518,11244369,5323385,5920984,11125243,119126,0.75%
3550407,3506,Piracicaba,35028,Piracicaba,São Pedro,SP,10141,13175,20176,27897,29733,31688,15439,16249,26635,5053,1.28%
3550506,3510,Assis,35040,Ourinhos,São Pedro do Turvo,SP,9455,7574,7038,6888,7094,7208,3676,3532,5158,2050,0.46%
3550605,3512,Macro Metropolitana Paulista,35046,Sorocaba,São Roque,SP,37049,49548,63900,66637,65693,78873,38793,40080,71536,7337,1.70%
3550704,3513,Vale do Paraíba Paulista,35054,Caraguatatuba,São Sebastião,SP,12016,18997,33890,58038,67348,73833,36827,37006,73000,833,2.44%
3550803,3507,Campinas,35030,São João da Boa Vista,São Sebastião da Grama,SP,11772,11323,11810,12454,12509,12100,6166,5934,7970,4130,-0.29%
3550902,3502,Ribeirão Preto,35014,Ribeirão Preto,São Simão,SP,12728,10676,11987,13675,13781,14350,7062,7288,12930,1420,0.48%
3551009,3515,Metropolitana de São Paulo,35063,Santos,São Vicente,SP,116485,193008,268618,303551,323599,332424,159571,172853,331792,632,0.91%
3551108,3512,Macro Metropolitana Paulista,35046,Sorocaba,Sarapuí,SP,5013,5179,6477,7805,8158,9027,4594,4433,6646,2381,1.47%
3551207,3510,Assis,35040,Ourinhos,Sarutaiá,SP,3047,2974,3023,3739,3680,3622,1819,1803,2957,665,-0.32%
3551306,3501,São José do Rio Preto,35007,Nhandeara,Sebastianópolis do Sul,SP,3002,2379,2516,2546,2871,3031,1525,1506,2347,684,1.76%
3551405,3502,Ribeirão Preto,35014,Ribeirão Preto,Serra Azul,SP,4735,4820,6172,7446,9107,11259,6872,4387,8021,3238,4.22%
3551504,3502,Ribeirão Preto,35014,Ribeirão Preto,Serrana,SP,8995,14379,23219,32603,36596,38891,19492,19399,38479,412,1.78%
3551603,3507,Campinas,35033,Amparo,Serra Negra,SP,13650,17310,21704,23851,24671,26362,12860,13502,22865,3497,1.01%
3551702,3502,Ribeirão Preto,35014,Ribeirão Preto,Sertãozinho,SP,31066,51543,78776,94664,103558,110094,54714,55380,108792,1302,1.52%
3551801,3514,Litoral Sul Paulista,35055,Registro,Sete Barras,SP,9223,11274,12527,13714,12975,13006,6682,6324,7035,5971,-0.53%
3551900,3501,São José do Rio Preto,35005,Catanduva,Severínia,SP,6787,7879,10280,13605,14713,15504,8046,7458,14777,727,1.32%
3552007,3513,Vale do Paraíba Paulista,35052,Bananal,Silveiras,SP,5442,3916,4914,5378,5562,5792,2936,2856,2879,2913,0.74%
3552106,3507,Campinas,35033,Amparo,Socorro,SP,20688,23657,30763,32704,33080,36695,18211,18484,24947,11748,1.16%
3552205,3512,Macro Metropolitana Paulista,35046,Sorocaba,Sorocaba,SP,175677,269888,379006,493468,559157,586311,286798,299513,580340,5971,1.74%
3552304,3503,Araçatuba,35016,Andradina,Sud Mennucci,SP,8766,5361,7205,7365,7714,7440,3745,3695,6394,1046,0.10%
3552403,3507,Campinas,35032,Campinas,Sumaré,SP,23074,101851,226870,196723,228696,241437,119984,121453,238599,2838,2.07%
3552502,3515,Metropolitana de São Paulo,35062,Mogi das Cruzes,Suzano,SP,55460,101056,158839,228690,268777,262568,128797,133771,253328,9240,1.39%
3552551,3503,Araçatuba,35016,Andradina,Suzanápolis,SP,,,,2790,3421,3383,1748,1635,2258,1125,1.95%
3552601,3501,São José do Rio Preto,35005,Catanduva,Tabapuã,SP,11230,12313,13051,10493,11255,11366,5744,5622,10522,844,0.80%
3552700,3505,Araraquara,35024,Araraquara,Tabatinga,SP,6875,7999,10793,12990,13965,14686,7565,7121,12578,2108,1.23%
3552809,3515,Metropolitana de São Paulo,35060,Itapecerica da Serra,Taboão da Serra,SP,40945,97656,160084,197644,219200,244719,116920,127799,244719,0,2.16%
3552908,3508,Presidente Prudente,35036,Presidente Prudente,Taciba,SP,7101,4524,4750,5221,5402,5714,2862,2852,4852,862,0.91%
3553005,3510,Assis,35040,Ourinhos,Taguaí,SP,5618,5744,6428,7468,9616,10825,5382,5443,7754,3071,3.78%
3553104,3502,Ribeirão Preto,35013,Jaboticabal,Taiaçu,SP,2935,3508,5015,5619,5804,5894,2972,2922,5339,555,0.48%
3553203,3502,Ribeirão Preto,35013,Jaboticabal,Taiúva,SP,4065,4425,5218,5506,5366,5447,2696,2751,4967,480,-0.11%
3553302,3507,Campinas,35030,São João da Boa Vista,Tambaú,SP,12201,15447,19857,22258,21913,22410,11179,11231,19912,2498,0.07%
3553401,3501,São José do Rio Preto,35004,São José do Rio Preto,Tanabi,SP,20437,20294,21513,22587,23400,24055,12042,12013,21735,2320,0.63%
3553500,3512,Macro Metropolitana Paulista,35045,Piedade,Tapiraí,SP,5265,5093,5734,8570,7953,8015,4037,3978,5728,2287,-0.67%
3553609,3507,Campinas,35030,São João da Boa Vista,Tapiratiba,SP,9283,9867,11799,12942,12246,12743,6336,6407,10497,2246,-0.15%
3553658,3502,Ribeirão Preto,35013,Jaboticabal,Taquaral,SP,,,,2722,2827,2726,1373,1353,2613,113,0.01%
3553708,3502,Ribeirão Preto,35013,Jaboticabal,Taquaritinga,SP,27518,35929,46922,52065,53232,53985,26659,27326,51165,2820,0.36%
3553807,3511,Itapetininga,35041,Itapeva,Taquarituba,SP,13964,16174,18537,21982,22170,22294,11091,11203,19582,2712,0.14%
3553856,3511,Itapetininga,35041,Itapeva,Taquarivaí,SP,,,,4473,5098,5149,2577,2572,2809,2340,1.42%
3553906,3508,Presidente Prudente,35036,Presidente Prudente,Tarabai,SP,3599,3565,4714,5786,6108,6605,3294,3311,6106,499,1.33%
3553955,3510,Assis,35039,Assis,Tarumã,SP,,,,10743,12298,12883,6583,6300,12124,759,1.83%
3554003,3511,Itapetininga,35043,Tatuí,Tatuí,SP,39760,55467,76816,93430,101838,107975,53358,54617,102456,5519,1.46%
3554102,3513,Vale do Paraíba Paulista,35050,São José dos Campos,Taubaté,SP,110585,169259,206965,244165,265514,278724,136785,141939,272712,6012,1.33%
3554201,3510,Assis,35040,Ourinhos,Tejupá,SP,5093,4861,4732,5336,5015,4809,2467,2342,3120,1689,-1.03%
3554300,3508,Presidente Prudente,35036,Presidente Prudente,Teodoro Sampaio,SP,26114,26329,49236,20003,20325,21389,10667,10722,17368,4021,0.67%
3554409,3502,Ribeirão Preto,35013,Jaboticabal,Terra Roxa,SP,5818,5767,6635,7752,8155,8505,4306,4199,8107,398,0.93%
3554508,3506,Piracicaba,35028,Piracicaba,Tietê,SP,17283,20042,26446,31710,34018,36827,18259,18568,33470,3357,1.51%
3554607,3510,Assis,35040,Ourinhos,Timburi,SP,4281,3338,2850,2731,2535,2646,1364,1282,1924,722,-0.32%
3554656,3511,Itapetininga,35043,Tatuí,Torre de Pedra,SP,,,,2144,2784,2257,1192,1065,1472,785,0.51%
3554706,3506,Piracicaba,35026,Rio Claro,Torrinha,SP,6501,6558,7503,8837,8918,9330,4707,4623,7939,1391,0.54%
3554755,3505,Araraquara,35024,Araraquara,Trabiju,SP,,,,1380,1441,1544,770,774,1418,126,1.13%
3554805,3513,Vale do Paraíba Paulista,35050,São José dos Campos,Tremembé,SP,11689,18098,27572,34823,38321,40985,21670,19315,36929,4056,1.64%
3554904,3501,São José do Rio Preto,35001,Jales,Três Fronteiras,SP,12039,8713,7859,5159,5031,5428,2716,2712,4599,829,0.51%
3554953,3512,Macro Metropolitana Paulista,35048,Bragança Paulista,Tuiuti,SP,,,,4956,5749,5935,3025,2910,2973,2962,1.82%
3555000,3509,Marília,35037,Tupã,Tupã,SP,52537,56587,61302,63333,62256,63492,30740,32752,60946,2546,0.03%
3555109,3508,Presidente Prudente,35034,Dracena,Tupi Paulista,SP,15720,16348,14045,13286,13712,14262,7574,6688,11203,3059,0.71%
3555208,3503,Araçatuba,35018,Birigui,Turiúba,SP,4993,4004,3752,1895,1947,1927,997,930,1577,350,0.17%
3555307,3501,São José do Rio Preto,35002,Fernandópolis,Turmalina,SP,3713,3015,2750,2366,2024,1978,982,996,1407,571,-1.78%
3555356,3501,São José do Rio Preto,35004,São José do Rio Preto,Ubarana,SP,,,,4220,4552,5286,2710,2576,4841,445,2.28%
3555406,3513,Vale do Paraíba Paulista,35054,Caraguatatuba,Ubatuba,SP,15203,27139,47398,66861,75008,78870,39223,39647,76958,1912,1.67%
3555505,3504,Bauru,35020,Bauru,Ubirajara,SP,4883,4225,4191,4156,4269,4429,2286,2143,3229,1200,0.64%
3555604,3501,São José do Rio Preto,35004,São José do Rio Preto,Uchoa,SP,7403,7811,8335,9035,9348,9475,4709,4766,8798,677,0.48%
3555703,3501,São José do Rio Preto,35007,Nhandeara,União Paulista,SP,1725,1239,1320,1354,1436,1599,829,770,1224,375,1.68%
3555802,3501,São José do Rio Preto,35001,Jales,Urânia,SP,16829,13493,12090,8825,8727,8836,4395,4441,7436,1400,0.01%
3555901,3504,Bauru,35020,Bauru,Uru,SP,1474,1591,1349,1404,1362,1251,641,610,1081,170,-1.15%
3556008,3501,São José do Rio Preto,35008,Novo Horizonte,Urupês,SP,10417,11991,11011,11833,11917,12720,6323,6397,11320,1400,0.73%
3556107,3501,São José do Rio Preto,35003,Votuporanga,Valentim Gentil,SP,5744,5395,5905,8605,9408,11031,5542,5489,10074,957,2.51%
3556206,3507,Campinas,35032,Campinas,Valinhos,SP,30775,48928,67886,82973,97814,106968,52757,54211,101820,5148,2.57%
3556305,3503,Araçatuba,35017,Araçatuba,Valparaíso,SP,14608,13297,16550,18574,20827,22617,12434,10183,21512,1105,1.99%
3556354,3512,Macro Metropolitana Paulista,35048,Bragança Paulista,Vargem,SP,,,,6975,6883,8801,4519,4282,4421,4380,2.35%
3556404,3507,Campinas,35030,São João da Boa Vista,Vargem Grande do Sul,SP,13369,20363,30952,36302,37357,39266,19484,19782,37274,1992,0.79%
3556453,3515,Metropolitana de São Paulo,35060,Itapecerica da Serra,Vargem Grande Paulista,SP,,,15870,32683,40200,42946,21310,21636,42946,0,2.77%
3556503,3512,Macro Metropolitana Paulista,35047,Jundiaí,Várzea Paulista,SP,9894,33818,68921,92800,100411,107146,53459,53687,107146,0,1.45%
3556602,3509,Marília,35038,Marília,Vera Cruz,SP,11699,11433,11042,11085,10020,10769,5298,5471,9363,1406,-0.29%
3556701,3507,Campinas,35032,Campinas,Vinhedo,SP,12338,21647,33612,47215,57435,63685,31520,32165,61688,1997,3.04%
3556800,3502,Ribeirão Preto,35013,Jaboticabal,Viradouro,SP,8743,10214,13091,15962,17043,17307,8720,8587,16801,506,0.81%
3556909,3502,Ribeirão Preto,35013,Jaboticabal,Vista Alegre do Alto,SP,2375,2736,3614,4754,6100,6889,3545,3344,6355,534,3.78%
3556958,3501,São José do Rio Preto,35001,Jales,Vitória Brasil,SP,,,,1675,1624,1737,891,846,1435,302,0.36%
3557006,3512,Macro Metropolitana Paulista,35046,Sorocaba,Votorantim,SP,26932,53158,80728,95925,99901,108872,54047,54825,104699,4173,1.27%
3557105,3501,São José do Rio Preto,35003,Votuporanga,Votuporanga,SP,39443,52279,66166,75641,77622,84728,41336,43392,82355,2373,1.14%
3557154,3501,São José do Rio Preto,35004,São José do Rio Preto,Zacarias,SP,,,,1947,2229,2334,1174,1160,1836,498,1.83%
3557204,3510,Assis,35040,Ourinhos,Chavantes,SP,14091,12968,14160,12194,12226,12114,6028,6086,11139,975,-0.07%
3557303,3507,Campinas,35031,Moji Mirim,Estiva Gerbi,SP,,,,8856,9185,10044,5074,4970,8011,2033,1.27%