Código do Municipio,Mesorregião,Nome_Mesorregião,Microrregião,Nome_Microrregião,Cidade,UF,1970,1980,1991,2000,2007,População,Homens,Mulheres,Urbana,Rural,Crescimento anual desde 2000
1200013,1202,Vale do Acre,12004,Rio Branco,Acrelândia,AC,,,,7935,11520,12538,6597,5941,5916,6622,4.68%
1200054,1202,Vale do Acre,12005,Brasiléia,Assis Brasil,AC,,1367,2917,3490,5351,6075,3091,2984,3703,2372,5.70%
1200104,1202,Vale do Acre,12005,Brasiléia,Brasiléia,AC,12311,13907,20263,17013,19065,21438,11060,10378,14299,7139,2.34%
1200138,1202,Vale do Acre,12004,Rio Branco,Bujari,AC,,,,5826,6543,8474,4560,3914,3681,4793,3.82%
1200179,1202,Vale do Acre,12004,Rio Branco,Capixaba,AC,,,,5206,8446,8810,4658,4152,3928,4882,5.40%
1200203,1201,Vale do Juruá,12001,Cruzeiro do Sul,Cruzeiro do Sul,AC,43584,50472,66603,67441,73948,78444,39185,39259,55259,23185,1.52%
1200252,1202,Vale do Acre,12005,Brasiléia,Epitaciolândia,AC,,,,11028,13434,15126,7636,7490,10622,4504,3.21%
1200302,1201,Vale do Juruá,12002,Tarauacá,Feijó,AC,15768,19569,17769,26722,31288,32311,16660,15651,16635,15676,1.92%
1200328,1201,Vale do Juruá,12002,Tarauacá,Jordão,AC,,,,4454,6059,6531,3396,3135,2265,4266,3.90%
1200336,1201,Vale do Juruá,12001,Cruzeiro do Sul,Mâncio Lima,AC,,7374,10217,11095,13785,15246,7856,7390,8782,6464,3.23%
1200344,1202,Vale do Acre,12003,Sena Madureira,Manoel Urbano,AC,,5936,5327,6374,7148,7989,4256,3733,5285,2704,2.28%
1200351,1201,Vale do Juruá,12001,Cruzeiro do Sul,Marechal Thaumaturgo,AC,,,,8295,13061,14200,7437,6763,3971,10229,5.52%
1200385,1202,Vale do Acre,12004,Rio Branco,Plácido de Castro,AC,,9253,15535,15172,17258,17203,8997,8206,10390,6813,1.26%
1200393,1201,Vale do Juruá,12001,Cruzeiro do Sul,Porto Walter,AC,,,,5485,8170,9172,4791,4381,3317,5855,5.28%
1200401,1202,Vale do Acre,12004,Rio Branco,Rio Branco,AC,83977,117101,197376,253059,290639,335796,163396,172400,308418,27378,2.87%
1200427,1201,Vale do Juruá,12001,Cruzeiro do Sul,Rodrigues Alves,AC,,,,8093,12428,14334,7450,6884,4325,10009,5.88%
1200435,1202,Vale do Acre,12003,Sena Madureira,Santa Rosa do Purus,AC,,,,2246,3948,4612,2373,2239,1894,2718,7.46%
1200450,1202,Vale do Acre,12004,Rio Branco,Senador Guiomard,AC,,9707,17489,19761,18863,20153,10328,9825,12670,7483,0.20%
1200500,1202,Vale do Acre,12003,Sena Madureira,Sena Madureira,AC,22470,23541,24197,29420,34230,37993,19704,18289,25132,12861,2.59%
1200609,1201,Vale do Juruá,12002,Tarauacá,Tarauacá,AC,23862,28362,27659,26037,32171,35526,18317,17209,19363,16163,3.16%
1200708,1202,Vale do Acre,12005,Brasiléia,Xapuri,AC,13327,14687,12366,11956,14314,16016,8310,7706,10270,5746,2.97%
1200807,1202,Vale do Acre,12004,Rio Branco,Porto Acre,AC,,,,11418,13716,14806,7806,7000,1955,12851,2.63%
2700102,2701,Sertão Alagoano,27001,Serrana do Sertão Alagoano,Água Branca,AL,22620,25159,26560,18660,19316,19376,9650,9726,5100,14276,0.38%
2700201,2703,Leste Alagoano,27012,São Miguel dos Campos,Anadia,AL,12586,14833,16337,17849,17274,17423,8563,8860,8950,8473,-0.24%
2700300,2702,Agreste Alagoano,27006,Arapiraca,Arapiraca,AL,94287,136178,164921,186466,202398,214067,101901,112166,181562,32505,1.39%
2700409,2703,Leste Alagoano,27009,Mata Alagoana,Atalaia,AL,40075,41766,38563,40552,50323,44379,22230,22149,22451,21928,0.91%
2700508,2703,Leste Alagoano,27011,Maceió,Barra de Santo Antônio,AL,6028,9696,14334,11351,13731,14228,7076,7152,13240,988,2.28%
2700607,2703,Leste Alagoano,27011,Maceió,Barra de São Miguel,AL,1418,2328,4950,6379,7247,7573,3765,3808,6521,1052,1.73%
2700706,2701,Sertão Alagoano,27004,Batalha,Batalha,AL,9015,10384,13033,14799,16247,17076,8386,8690,12042,5034,1.44%
2700805,2702,Agreste Alagoano,27005,Palmeira dos Índios,Belém,AL,5761,6234,5919,5919,5031,4551,2222,2329,1872,2679,-2.59%
2700904,2701,Sertão Alagoano,27004,Batalha,Belo Monte,AL,4698,5712,7067,6822,7238,7032,3551,3481,1171,5861,0.30%
2701001,2703,Leste Alagoano,27012,São Miguel dos Campos,Boca da Mata,AL,15362,18164,22188,24227,25145,25780,12772,13008,17455,8325,0.62%
2701100,2703,Leste Alagoano,27009,Mata Alagoana,Branquinha,AL,9983,9543,8305,11325,11796,10586,5379,5207,6673,3913,-0.67%
2701209,2702,Agreste Alagoano,27005,Palmeira dos Índios,Cacimbinhas,AL,9305,10588,13721,9552,9843,10197,5049,5148,5404,4793,0.66%
2701308,2703,Leste Alagoano,27009,Mata Alagoana,Cajueiro,AL,11910,13445,18597,18975,20076,20410,10078,10332,16485,3925,0.73%
2701357,2703,Leste Alagoano,27009,Mata Alagoana,Campestre,AL,,,,6223,6016,6599,3291,3308,5541,1058,0.59%
2701407,2703,Leste Alagoano,27012,São Miguel dos Campos,Campo Alegre,AL,6950,17581,36770,41028,45307,50831,25031,25800,22170,28661,2.17%
2701506,2702,Agreste Alagoano,27006,Arapiraca,Campo Grande,AL,7420,9293,10041,9134,9563,9032,4436,4596,4185,4847,-0.11%
2701605,2701,Sertão Alagoano,27001,Serrana do Sertão Alagoano,Canapi,AL,13824,18356,18630,17334,17793,17248,8661,8587,5538,11710,-0.05%
2701704,2703,Leste Alagoano,27009,Mata Alagoana,Capela,AL,19601,18615,18777,18693,17034,17077,8430,8647,12650,4427,-0.90%
2701803,2701,Sertão Alagoano,27003,Santana do Ipanema,Carneiros,AL,5012,5447,5687,6585,8044,8290,4058,4232,4702,3588,2.33%
2701902,2703,Leste Alagoano,27008,Serrana dos Quilombos,Chã Preta,AL,10587,9866,8196,7760,6953,7146,3644,3502,4488,2658,-0.82%
2702009,2702,Agreste Alagoano,27006,Arapiraca,Coité do Nóia,AL,7047,8963,9799,11993,10916,10926,5421,5505,3737,7189,-0.93%
2702108,2703,Leste Alagoano,27009,Mata Alagoana,Colônia Leopoldina,AL,12701,14913,16739,17493,19363,20022,10073,9949,15319,4703,1.36%
2702207,2703,Leste Alagoano,27011,Maceió,Coqueiro Seco,AL,2857,3799,4784,5134,5336,5523,2758,2765,4970,553,0.73%
2702306,2703,Leste Alagoano,27012,São Miguel dos Campos,Coruripe,AL,27225,41650,49240,48846,51027,52160,25761,26399,46073,6087,0.66%
2702355,2702,Agreste Alagoano,27006,Arapiraca,Craíbas,AL,,,17816,20789,22411,22643,11155,11488,7331,15312,0.86%
2702405,2701,Sertão Alagoano,27002,Alagoana do Sertão do São Francisco,Delmiro Gouveia,AL,14680,26768,41214,42995,46599,48090,23053,25037,34849,13241,1.13%
2702504,2701,Sertão Alagoano,27003,Santana do Ipanema,Dois Riachos,AL,6222,7952,10011,11066,10885,10879,5454,5425,5084,5795,-0.17%
2702553,2702,Agreste Alagoano,27005,Palmeira dos Índios,Estrela de Alagoas,AL,,,,16341,16694,17254,8398,8856,4031,13223,0.55%
2702603,2702,Agreste Alagoano,27006,Arapiraca,Feira Grande,AL,13310,17542,19052,21270,21180,21325,10562,10763,3425,17900,0.03%
2702702,2703,Leste Alagoano,27013,Penedo,Feliz Deserto,AL,1723,2690,3438,3836,4370,4332,2125,2207,3468,864,1.22%
2702801,2703,Leste Alagoano,27009,Mata Alagoana,Flexeiras,AL,12042,14008,12097,11979,11928,12339,6247,6092,8023,4316,0.30%
2702900,2702,Agreste Alagoano,27006,Arapiraca,Girau do Ponciano,AL,18347,22459,27801,29574,35162,36625,18176,18449,11298,25327,2.16%
2703007,2703,Leste Alagoano,27008,Serrana dos Quilombos,Ibateguara,AL,11567,12086,15620,15105,15359,15133,7555,7578,9336,5797,0.02%
2703106,2702,Agreste Alagoano,27005,Palmeira dos Índios,Igaci,AL,23331,24579,26127,25584,25140,25197,12275,12922,6193,19004,-0.15%
2703205,2703,Leste Alagoano,27013,Penedo,Igreja Nova,AL,19343,19142,19849,21451,22925,23298,11750,11548,4776,18522,0.83%
2703304,2701,Sertão Alagoano,27001,Serrana do Sertão Alagoano,Inhapi,AL,9453,12861,14791,17768,17637,17902,8813,9089,6699,11203,0.08%
2703403,2701,Sertão Alagoano,27004,Batalha,Jacaré dos Homens,AL,3708,3873,4746,5720,5724,5413,2671,2742,3032,2381,-0.55%
2703502,2703,Leste Alagoano,27009,Mata Alagoana,Jacuípe,AL,7694,7532,7481,7313,6883,6986,3580,3406,4344,2642,-0.46%
2703601,2703,Leste Alagoano,27010,Litoral Norte Alagoano,Japaratinga,AL,2802,4227,7093,6868,7463,7752,3871,3881,3305,4447,1.22%
2703700,2701,Sertão Alagoano,27004,Batalha,Jaramataia,AL,2320,3161,4372,5788,5939,5562,2807,2755,2917,2645,-0.40%
2703759,2703,Leste Alagoano,27012,São Miguel dos Campos,Jequiá da Praia,AL,,,,,11430,12035,6131,5904,2879,9156,-
2703809,2703,Leste Alagoano,27009,Mata Alagoana,Joaquim Gomes,AL,15430,17969,24201,21488,21735,22581,11535,11046,14483,8098,0.50%
2703908,2703,Leste Alagoano,27009,Mata Alagoana,Jundiá,AL,9957,10566,15074,4680,4569,4202,2126,2076,2827,1375,-1.07%
2704005,2703,Leste Alagoano,27012,São Miguel dos Campos,Junqueiro,AL,14998,31200,22221,23832,24460,23854,11754,12100,7819,16035,0.01%
2704104,2702,Agreste Alagoano,27006,Arapiraca,Lagoa da Canoa,AL,11562,12594,15900,19988,17889,18253,8973,9280,9165,9088,-0.90%
2704203,2702,Agreste Alagoano,27006,Arapiraca,Limoeiro de Anadia,AL,16725,18173,19447,24263,25484,26992,13424,13568,2246,24746,1.07%
2704302,2703,Leste Alagoano,27011,Maceió,Maceió,AL,263670,399300,629041,797759,896965,932608,436405,496203,931984,624,1.57%
2704401,2701,Sertão Alagoano,27004,Batalha,Major Isidoro,AL,14230,16020,17257,17639,18811,18901,9269,9632,9310,9591,0.69%
2704500,2703,Leste Alagoano,27010,Litoral Norte Alagoano,Maragogi,AL,12764,14953,16403,21832,25726,28746,14515,14231,18622,10124,2.79%
2704609,2701,Sertão Alagoano,27003,Santana do Ipanema,Maravilha,AL,8222,11832,11380,13687,10203,10276,5195,5081,5129,5147,-2.83%
2704708,2703,Leste Alagoano,27011,Maceió,Marechal Deodoro,AL,14724,22695,24810,35866,45141,45994,22705,23289,43406,2588,2.52%
2704807,2702,Agreste Alagoano,27005,Palmeira dos Índios,Maribondo,AL,13961,15041,14966,15145,13865,13614,6534,7080,9977,3637,-1.06%
2704906,2702,Agreste Alagoano,27005,Palmeira dos Índios,Mar Vermelho,AL,4857,4163,3965,4078,4014,3652,1821,1831,1638,2014,-1.10%
2705002,2701,Sertão Alagoano,27001,Serrana do Sertão Alagoano,Mata Grande,AL,20858,23478,26475,25032,24599,24702,12338,12364,5676,19026,-0.13%
2705101,2703,Leste Alagoano,27009,Mata Alagoana,Matriz de Camaragibe,AL,12720,17131,21146,24017,24656,23780,11589,12191,22095,1685,-0.10%
2705200,2703,Leste Alagoano,27009,Mata Alagoana,Messias,AL,6216,7467,10564,11990,15072,15682,7703,7979,14263,1419,2.72%
2705309,2702,Agreste Alagoano,27005,Palmeira dos Índios,Minador do Negrão,AL,7365,8246,9355,5399,5160,5280,2618,2662,2252,3028,-0.22%
2705408,2701,Sertão Alagoano,27004,Batalha,Monteirópolis,AL,4721,5420,6140,7240,7090,6944,3359,3585,2518,4426,-0.42%
2705507,2703,Leste Alagoano,27009,Mata Alagoana,Murici,AL,26599,25855,28724,24671,25964,26706,13276,13430,22104,4602,0.80%
2705606,2703,Leste Alagoano,27009,Mata Alagoana,Novo Lino,AL,13269,14660,14553,10375,11903,12069,6122,5947,7337,4732,1.52%
2705705,2701,Sertão Alagoano,27004,Batalha,Olho d'Água das Flores,AL,10707,13922,15653,19417,19885,20367,9723,10644,13992,6375,0.48%
2705804,2701,Sertão Alagoano,27002,Alagoana do Sertão do São Francisco,Olho d'Água do Casado,AL,2614,4079,6414,7059,8139,8491,4276,4215,4027,4464,1.86%
2705903,2702,Agreste Alagoano,27007,Traipu,Olho d'Água Grande,AL,4333,4620,4413,4847,4817,4957,2463,2494,1203,3754,0.22%
2706000,2701,Sertão Alagoano,27004,Batalha,Olivença,AL,8657,9523,10130,10369,10522,11057,5566,5491,3147,7910,0.64%
2706109,2701,Sertão Alagoano,27003,Santana do Ipanema,Ouro Branco,AL,6171,8768,9346,10077,11049,10911,5438,5473,6873,4038,0.80%
2706208,2701,Sertão Alagoano,27003,Santana do Ipanema,Palestina,AL,2274,2490,3628,4523,4878,5112,2474,2638,3237,1875,1.23%
2706307,2702,Agreste Alagoano,27005,Palmeira dos Índios,Palmeira dos Índios,AL,61860,66930,77204,68060,70151,70434,33621,36813,51655,18779,0.34%
2706406,2701,Sertão Alagoano,27003,Santana do Ipanema,Pão de Açúcar,AL,16721,18936,21506,24351,23855,23809,11754,12055,10772,13037,-0.22%
2706422,2701,Sertão Alagoano,27001,Serrana do Sertão Alagoano,Pariconha,AL,,,,10086,10209,10246,5107,5139,2796,7450,0.16%
2706448,2703,Leste Alagoano,27011,Maceió,Paripueira,AL,,,,8049,9725,11349,5592,5757,10051,1298,3.50%
2706505,2703,Leste Alagoano,27010,Litoral Norte Alagoano,Passo de Camaragibe,AL,7598,11326,14091,13755,13826,14772,7510,7262,7239,7533,0.72%
2706604,2702,Agreste Alagoano,27005,Palmeira dos Índios,Paulo Jacinto,AL,9311,8173,7117,7485,7534,7426,3631,3795,4908,2518,-0.08%
2706703,2703,Leste Alagoano,27013,Penedo,Penedo,AL,33142,36658,52245,56993,59020,60389,29310,31079,45011,15378,0.58%
2706802,2703,Leste Alagoano,27013,Penedo,Piaçabuçu,AL,10752,11543,16914,16775,17466,17219,8626,8593,10452,6767,0.26%
2706901,2703,Leste Alagoano,27011,Maceió,Pilar,AL,17801,23896,29254,31201,31627,33312,16172,17140,31808,1504,0.66%
2707008,2703,Leste Alagoano,27008,Serrana dos Quilombos,Pindoba,AL,7772,5215,3748,2926,3126,2866,1420,1446,1637,1229,-0.21%
2707107,2701,Sertão Alagoano,27002,Alagoana do Sertão do São Francisco,Piranhas,AL,4567,5949,14458,20007,23910,23052,11301,11751,13191,9861,1.43%
2707206,2701,Sertão Alagoano,27003,Santana do Ipanema,Poço das Trincheiras,AL,10172,10671,11489,13222,12205,13873,7003,6870,2043,11830,0.48%
2707305,2703,Leste Alagoano,27009,Mata Alagoana,Porto Calvo,AL,17654,20496,22658,23951,25129,25718,12761,12957,20220,5498,0.71%
2707404,2703,Leste Alagoano,27010,Litoral Norte Alagoano,Porto de Pedras,AL,8565,9841,9615,10238,10321,8419,4264,4155,4796,3623,-1.94%
2707503,2703,Leste Alagoano,27013,Penedo,Porto Real do Colégio,AL,12737,14389,17557,18355,17947,19314,9590,9724,6582,12732,0.51%
2707602,2702,Agreste Alagoano,27005,Palmeira dos Índios,Quebrangulo,AL,15168,12645,11402,11902,11289,11486,5673,5813,6474,5012,-0.36%
2707701,2703,Leste Alagoano,27011,Maceió,Rio Largo,AL,37415,43445,53924,62510,65432,68512,33337,35175,55968,12544,0.92%
2707800,2703,Leste Alagoano,27012,São Miguel dos Campos,Roteiro,AL,1635,5171,7445,6985,6692,6656,3369,3287,5830,826,-0.48%
2707909,2703,Leste Alagoano,27011,Maceió,Santa Luzia do Norte,AL,2377,3319,5796,6388,7248,6893,3371,3522,6174,719,0.76%
2708006,2701,Sertão Alagoano,27003,Santana do Ipanema,Santana do Ipanema,AL,34225,40372,36088,41485,42296,44949,21822,23127,27201,17748,0.81%
2708105,2703,Leste Alagoano,27008,Serrana dos Quilombos,Santana do Mundaú,AL,15096,13580,12012,11534,11663,10961,5490,5471,5658,5303,-0.51%
2708204,2702,Agreste Alagoano,27007,Traipu,São Brás,AL,6231,7380,6313,6551,6820,6720,3340,3380,3183,3537,0.26%
2708303,2703,Leste Alagoano,27008,Serrana dos Quilombos,São José da Laje,AL,26946,21959,21996,21071,22282,22689,11174,11515,15390,7299,0.74%
2708402,2701,Sertão Alagoano,27003,Santana do Ipanema,São José da Tapera,AL,19757,24790,27413,27562,30129,30140,14870,15270,11661,18479,0.90%
2708501,2703,Leste Alagoano,27009,Mata Alagoana,São Luís do Quitunde,AL,16121,25860,31238,29543,31647,32416,16327,16089,20597,11819,0.93%
2708600,2703,Leste Alagoano,27012,São Miguel dos Campos,São Miguel dos Campos,AL,29721,40708,50689,51456,51473,54591,26577,28014,52571,2020,0.59%
2708709,2703,Leste Alagoano,27010,Litoral Norte Alagoano,São Miguel dos Milagres,AL,3995,4809,4897,5860,7219,7170,3566,3604,2256,4914,2.04%
2708808,2702,Agreste Alagoano,27006,Arapiraca,São Sebastião,AL,11723,19764,24696,29124,31002,32007,15852,16155,12306,19701,0.95%
2708907,2703,Leste Alagoano,27011,Maceió,Satuba,AL,5008,6228,9186,12555,14154,14604,7111,7493,12793,1811,1.52%
2708956,2701,Sertão Alagoano,27003,Santana do Ipanema,Senador Rui Palmeira,AL,,,9413,11979,12641,13047,6405,6642,3944,9103,0.86%
2709004,2702,Agreste Alagoano,27005,Palmeira dos Índios,Tanque d'Arca,AL,6056,7483,7715,6594,5695,6122,3020,3102,2140,3982,-0.74%
2709103,2702,Agreste Alagoano,27006,Arapiraca,Taquarana,AL,11761,13189,16809,17046,18157,19020,9237,9783,7314,11706,1.10%
2709152,2703,Leste Alagoano,27012,São Miguel dos Campos,Teotônio Vilela,AL,,,29664,36881,40291,41158,20168,20990,34789,6369,1.10%
2709202,2702,Agreste Alagoano,27007,Traipu,Traipu,AL,15497,19272,22680,23439,24911,25710,12953,12757,8035,17675,0.93%
2709301,2703,Leste Alagoano,27008,Serrana dos Quilombos,União dos Palmares,AL,51532,52702,57425,58620,60619,62401,30193,32208,47691,14710,0.63%
2709400,2703,Leste Alagoano,27008,Serrana dos Quilombos,Viçosa,AL,28734,24658,23571,26263,26050,25444,12420,13024,18336,7108,-0.32%
1300029,1303,Centro Amazonense,13005,Tefé,Alvarães,AM,,,8487,12150,13010,14080,7408,6672,7878,6202,1.49%
1300060,1302,Sudoeste Amazonense,13003,Alto Solimões,Amaturá,AM,,,4738,7308,8384,9657,4986,4671,4945,4712,2.83%
1300086,1303,Centro Amazonense,13006,Coari,Anamã,AM,,,6024,6563,8152,10193,5434,4759,4174,6019,4.50%
1300102,1303,Centro Amazonense,13006,Coari,Anori,AM,12212,15011,8990,11320,13834,16289,8497,7792,9989,6300,3.71%
1300144,1304,Sul Amazonense,13013,Madeira,Apuí,AM,,,5732,13864,17451,18059,9571,8488,10606,7453,2.68%
1300201,1302,Sudoeste Amazonense,13003,Alto Solimões,Atalaia do Norte,AM,6014,6670,7993,10049,13682,15149,7851,7298,6891,8258,4.19%
1300300,1303,Centro Amazonense,13007,Manaus,Autazes,AM,17725,16061,17107,24345,29907,31876,16829,15047,13885,17991,2.73%
1300409,1301,Norte Amazonense,13001,Rio Negro,Barcelos,AM,9628,9088,11035,24197,24567,25715,13814,11901,11160,14555,0.61%
1300508,1303,Centro Amazonense,13010,Parintins,Barreirinha,AM,13998,15394,16316,22579,26645,27361,14316,13045,12422,14939,1.94%
1300607,1302,Sudoeste Amazonense,13003,Alto Solimões,Benjamin Constant,AM,15127,24645,18312,23219,29268,33391,17246,16145,20132,13259,3.70%
1300631,1303,Centro Amazonense,13006,Coari,Beruri,AM,,,7436,11038,13809,15500,8153,7347,7795,7705,3.45%
1300680,1303,Centro Amazonense,13010,Parintins,Boa Vista do Ramos,AM,,,7504,10482,13138,14921,7948,6973,7521,7400,3.59%
1300706,1304,Sul Amazonense,13011,Boca do Acre,Boca do Acre,AM,19989,21829,25005,26959,29818,29880,15545,14335,19273,10607,1.03%
1300805,1304,Sul Amazonense,13013,Madeira,Borba,AM,16514,23568,17217,28619,31098,34452,17953,16499,14409,20043,1.87%
1300839,1303,Centro Amazonense,13006,Coari,Caapiranga,AM,,,6833,8803,10547,10909,5776,5133,5140,5769,2.17%
1300904,1304,Sul Amazonense,13012,Purus,Canutama,AM,5759,6390,12152,10737,11463,12727,6868,5859,6682,6045,1.71%
1301001,1302,Sudoeste Amazonense,13004,Juruá,Carauari,AM,16984,20028,19298,23421,25110,25700,13195,12505,19754,5946,0.93%
1301100,1303,Centro Amazonense,13007,Manaus,Careiro,AM,40767,34973,31816,27554,31070,32631,16922,15709,9440,23191,1.71%
1301159,1303,Centro Amazonense,13007,Manaus,Careiro da Várzea,AM,,,18161,17267,23023,23963,12707,11256,1000,22963,3.33%
1301209,1303,Centro Amazonense,13006,Coari,Coari,AM,27636,42609,38678,67096,65222,75909,39429,36480,49638,26271,1.24%
1301308,1303,Centro Amazonense,13006,Coari,Codajás,AM,12110,10820,13462,17507,16025,23119,12029,11090,15808,7311,2.82%
1301407,1302,Sudoeste Amazonense,13004,Juruá,Eirunepé,AM,10882,14770,20372,26074,29411,30666,15791,14875,22178,8488,1.64%
1301506,1302,Sudoeste Amazonense,13004,Juruá,Envira,AM,11705,14702,16339,19060,16438,16328,8395,7933,10553,5775,-1.54%
1301605,1302,Sudoeste Amazonense,13003,Alto Solimões,Fonte Boa,AM,11744,13515,16445,31509,19726,22659,11744,10915,15039,7620,-3.24%
1301654,1302,Sudoeste Amazonense,13004,Juruá,Guajará,AM,,,11495,13220,14102,14074,7340,6734,7457,6617,0.63%
1301704,1304,Sul Amazonense,13013,Madeira,Humaitá,AM,14877,24318,38792,32796,38559,44116,23115,21001,30475,13641,3.01%
1301803,1302,Sudoeste Amazonense,13004,Juruá,Ipixuna,AM,12846,18744,9653,14759,17177,22199,11331,10868,9452,12747,4.17%
1301852,1303,Centro Amazonense,13007,Manaus,Iranduba,AM,,,18876,32303,32869,40735,20976,19759,28928,11807,2.35%
1301902,1303,Centro Amazonense,13009,Itacoatiara,Itacoatiara,AM,37346,52882,58757,72105,84676,86840,44419,42421,58175,28665,1.88%
1301951,1302,Sudoeste Amazonense,13004,Juruá,Itamarati,AM,,,9085,8406,8078,8040,4238,3802,4474,3566,-0.44%
1302009,1303,Centro Amazonense,13009,Itacoatiara,Itapiranga,AM,2646,5608,5137,7309,9141,8200,4297,3903,6447,1753,1.16%
1302108,1301,Norte Amazonense,13002,Japurá,Japurá,AM,2415,2096,10777,10285,5281,7289,3804,3485,3319,3970,-3.38%
1302207,1302,Sudoeste Amazonense,13004,Juruá,Juruá,AM,6785,6952,5045,6584,8658,10822,5564,5258,5686,5136,5.09%
1302306,1302,Sudoeste Amazonense,13003,Alto Solimões,Jutaí,AM,3955,9336,14890,22500,17129,17964,9416,8548,10559,7405,-2.23%
1302405,1304,Sul Amazonense,13012,Purus,Lábrea,AM,16737,22026,33052,28956,36909,37574,19586,17988,24223,13351,2.64%
1302504,1303,Centro Amazonense,13007,Manaus,Manacapuru,AM,49469,61018,57173,73695,82309,85144,43429,41715,60178,24966,1.45%
1302553,1303,Centro Amazonense,13007,Manaus,Manaquiri,AM,,,10718,12711,19164,22807,11747,11060,7068,15739,6.02%
1302603,1303,Centro Amazonense,13007,Manaus,Manaus,AM,311622,633383,1011501,1405835,1646602,1802525,879893,922632,1793416,9109,2.52%
1302702,1304,Sul Amazonense,13013,Madeira,Manicoré,AM,21100,30062,37857,38038,44327,47011,24681,22330,20347,26664,2.14%
1302801,1301,Norte Amazonense,13002,Japurá,Maraã,AM,8293,9988,11838,17079,17507,17364,9339,8025,8759,8605,0.17%
1302900,1303,Centro Amazonense,13010,Parintins,Maués,AM,24095,30022,30499,40036,47020,51847,27084,24763,25836,26011,2.62%
1303007,1303,Centro Amazonense,13010,Parintins,Nhamundá,AM,15539,13596,13250,15355,17553,18278,9496,8782,7010,11268,1.76%
1303106,1303,Centro Amazonense,13009,Itacoatiara,Nova Olinda do Norte,AM,11903,13210,12949,23725,29184,30761,15782,14979,13648,17113,2.63%
1303205,1301,Norte Amazonense,13001,Rio Negro,Novo Airão,AM,6077,3672,14024,9651,14630,14780,7655,7125,9490,5290,4.35%
1303304,1304,Sul Amazonense,13013,Madeira,Novo Aripuanã,AM,16585,10160,11634,17119,18196,21389,11405,9984,14079,7310,2.25%
1303403,1303,Centro Amazonense,13010,Parintins,Parintins,AM,38086,51381,58783,90150,102044,102066,52318,49748,69905,32161,1.25%
1303502,1304,Sul Amazonense,13011,Boca do Acre,Pauini,AM,9693,9448,17037,17092,18325,18153,9485,8668,9264,8889,0.60%
1303536,1303,Centro Amazonense,13008,Rio Preto da Eva,Presidente Figueiredo,AM,,,7089,17394,24360,27121,14321,12800,12999,14122,4.54%
1303569,1303,Centro Amazonense,13008,Rio Preto da Eva,Rio Preto da Eva,AM,,,6519,17582,24858,25758,13416,12342,12244,13514,3.89%
1303601,1301,Norte Amazonense,13001,Rio Negro,Santa Isabel do Rio Negro,AM,3646,4981,15421,10561,16921,18133,9315,8818,6858,11275,5.55%
1303700,1302,Sudoeste Amazonense,13003,Alto Solimões,Santo Antônio do Içá,AM,9437,15061,17214,28213,29249,24487,12591,11896,12954,11533,-1.41%
1303809,1301,Norte Amazonense,13001,Rio Negro,São Gabriel da Cachoeira,AM,13420,19578,23140,29947,39129,37300,19144,18156,19001,18299,2.22%
1303908,1302,Sudoeste Amazonense,13003,Alto Solimões,São Paulo de Olivença,AM,18814,19388,13623,23113,30727,31426,16268,15158,14267,17159,3.12%
1303957,1303,Centro Amazonense,13010,Parintins,São Sebastião do Uatumã,AM,,,4539,7160,8731,10688,5670,5018,5907,4781,4.09%
1304005,1303,Centro Amazonense,13009,Itacoatiara,Silves,AM,4437,6490,5703,7785,8211,8445,4500,3945,4033,4412,0.82%
1304062,1302,Sudoeste Amazonense,13003,Alto Solimões,Tabatinga,AM,,,27923,37919,45293,52279,26347,25932,36371,15908,3.26%
1304104,1304,Sul Amazonense,13012,Purus,Tapauá,AM,10571,16710,25386,20595,19453,19077,10075,9002,10618,8459,-0.76%
1304203,1303,Centro Amazonense,13005,Tefé,Tefé,AM,19173,30736,53970,64457,62920,61399,31492,29907,50072,11327,-0.48%
1304237,1302,Sudoeste Amazonense,13003,Alto Solimões,Tonantins,AM,,,10034,15512,19090,17056,8767,8289,8903,8153,0.95%
1304260,1303,Centro Amazonense,13005,Tefé,Uarini,AM,,,5407,10254,9859,11906,6319,5587,6799,5107,1.50%
1304302,1303,Centro Amazonense,13010,Parintins,Urucará,AM,6550,8761,11328,18372,15716,17019,8829,8190,9868,7151,-0.76%
1304401,1303,Centro Amazonense,13009,Itacoatiara,Urucurituba,AM,10292,10848,17673,12264,17184,17731,9467,8264,10355,7376,3.76%
1600055,1602,Sul do Amapá,16003,Macapá,Serra do Navio,AP,,,,3293,3772,4409,2335,2074,2575,1834,2.96%
1600105,1601,Norte do Amapá,16002,Amapá,Amapá,AP,10377,9499,8075,7121,7492,8005,4186,3819,6926,1079,1.18%
1600154,1602,Sul do Amapá,16003,Macapá,Pedra Branca do Amapari,AP,,,,4009,7332,10773,5833,4940,5970,4803,10.39%
1600204,1601,Norte do Amapá,16001,Oiapoque,Calçoene,AP,2834,2846,5177,6730,8656,8964,4795,4169,7301,1663,2.91%
1600212,1602,Sul do Amapá,16003,Macapá,Cutias,AP,,,,3280,4320,4634,2393,2241,2409,2225,3.52%
1600238,1602,Sul do Amapá,16003,Macapá,Ferreira Gomes,AP,,,2386,3562,5040,5772,3033,2739,4161,1611,4.95%
1600253,1602,Sul do Amapá,16003,Macapá,Itaubal,AP,,,,2894,3439,4267,2317,1950,1766,2501,3.96%
1600279,1602,Sul do Amapá,16004,Mazagão,Laranjal do Jari,AP,,,21372,28515,37491,39805,20350,19455,37824,1981,3.39%
1600303,1602,Sul do Amapá,16003,Macapá,Macapá,AP,86097,137452,179777,283308,344153,397913,195497,202416,380937,16976,3.46%
1600402,1602,Sul do Amapá,16004,Mazagão,Mazagão,AP,10497,20433,8911,11986,13862,17030,8977,8053,8280,8750,3.57%
1600501,1601,Norte do Amapá,16001,Oiapoque,Oiapoque,AP,4425,5028,7555,12886,19181,20426,10666,9760,13873,6553,4.71%
1600535,1602,Sul do Amapá,16003,Macapá,Porto Grande,AP,,,,11042,13962,16825,8903,7922,10759,6066,4.30%
1600550,1601,Norte do Amapá,16002,Amapá,Pracuúba,AP,,,,2286,3353,3783,1990,1793,1867,1916,5.17%
1600600,1602,Sul do Amapá,16003,Macapá,Santana,AP,,,51451,80439,92098,101203,50361,50842,99094,2109,2.32%
1600709,1601,Norte do Amapá,16002,Amapá,Tartarugalzinho,AP,,,4693,7121,12395,12435,6599,5836,6501,5934,5.73%
1600808,1602,Sul do Amapá,16004,Mazagão,Vitória do Jari,AP,,,,8560,10765,12445,6439,6006,10318,2127,3.81%
2900108,2906,Centro Sul Baiano,29023,Seabra,Abaíra,BA,8475,8977,8754,9067,8638,8324,4088,4236,3744,4580,-0.85%
2900207,2902,Vale São-Franciscano da Bahia,29005,Paulo Afonso,Abaré,BA,6873,8963,11449,13648,17342,17072,8566,8506,9035,8037,2.26%
2900306,2904,Nordeste Baiano,29017,Alagoinhas,Acajutiba,BA,9870,11535,12894,14322,14628,14830,7300,7530,12786,2044,0.35%
2900355,2904,Nordeste Baiano,29015,Ribeira do Pombal,Adustina,BA,,,13714,14302,14824,15706,7908,7798,5574,10132,0.94%
2900405,2903,Centro Norte Baiano,29012,Feira de Santana,Água Fria,BA,11529,13126,14145,14718,14810,15726,7903,7823,5777,9949,0.66%
2900504,2906,Centro Sul Baiano,29025,Livramento do Brumado,Érico Cardoso,BA,5504,5737,7307,12160,10609,10855,5421,5434,2016,8839,-1.13%
2900603,2906,Centro Sul Baiano,29024,Jequié,Aiquara,BA,6978,7290,6612,5315,5212,4602,2351,2251,2680,1922,-1.43%
2900702,2904,Nordeste Baiano,29017,Alagoinhas,Alagoinhas,BA,77963,102166,116894,130095,132725,142160,67381,74779,124245,17915,0.89%
2900801,2907,Sul Baiano,29032,Porto Seguro,Alcobaça,BA,32323,40212,15410,20900,19840,21319,10842,10477,11112,10207,0.20%
2900900,2907,Sul Baiano,29031,Ilhéus-Itabuna,Almadina,BA,7720,9146,10004,7862,6687,6360,3202,3158,5080,1280,-2.10%
2901007,2906,Centro Sul Baiano,29024,Jequié,Amargosa,BA,24443,25218,28026,31108,33554,34340,16634,17706,24895,9445,0.99%
2901106,2905,Metropolitana de Salvador,29019,Catu,Amélia Rodrigues,BA,14981,18191,22779,24134,22096,25190,12283,12907,19957,5233,0.43%
2901155,2903,Centro Norte Baiano,29009,Irecê,América Dourada,BA,,,15965,15959,16189,15952,8071,7881,10845,5107,-0.00%
2901205,2906,Centro Sul Baiano,29028,Vitória da Conquista,Anagé,BA,21528,31291,41544,31060,25716,25500,12878,12622,4927,20573,-1.95%
2901304,2906,Centro Sul Baiano,29023,Seabra,Andaraí,BA,20047,22010,14285,13884,14088,13948,7170,6778,7770,6178,0.05%
2901353,2903,Centro Norte Baiano,29008,Senhor do Bonfim,Andorinha,BA,,,17170,15774,14132,14417,7331,7086,6213,8204,-0.90%
2901403,2901,Extremo Oeste Baiano,29002,Cotegipe,Angical,BA,11310,11865,16052,14701,14700,14073,7460,6613,6531,7542,-0.44%
2901502,2903,Centro Norte Baiano,29012,Feira de Santana,Anguera,BA,7299,7748,7859,8834,9523,10248,5086,5162,4326,5922,1.50%
2901601,2904,Nordeste Baiano,29015,Ribeira do Pombal,Antas,BA,15978,21468,17104,14059,16446,17078,8587,8491,6359,10719,1.96%
2901700,2903,Centro Norte Baiano,29012,Feira de Santana,Antônio Cardoso,BA,12289,11505,11328,11620,12074,11548,5729,5819,3225,8323,-0.06%
2901809,2903,Centro Norte Baiano,29008,Senhor do Bonfim,Antônio Gonçalves,BA,6838,8169,14082,9716,10653,11019,5576,5443,5783,5236,1.27%
2901908,2904,Nordeste Baiano,29017,Alagoinhas,Aporá,BA,12163,13156,15742,16769,17870,17720,8951,8769,8487,9233,0.55%
2901957,2906,Centro Sul Baiano,29024,Jequié,Apuarema,BA,,,7647,7443,7379,7463,3796,3667,5121,2342,0.03%
2902005,2906,Centro Sul Baiano,29027,Brumado,Aracatu,BA,13637,13475,15464,15491,14168,13732,7045,6687,3928,9804,-1.20%
2902054,2904,Nordeste Baiano,29017,Alagoinhas,Araças,BA,,,8940,11003,11662,11569,5832,5737,5808,5761,0.50%
2902104,2904,Nordeste Baiano,29016,Serrinha,Araci,BA,23661,32225,45341,47584,51912,51636,25929,25707,19637,31999,0.82%
2902203,2904,Nordeste Baiano,29017,Alagoinhas,Aramari,BA,7543,7774,7636,9258,9527,10039,5001,5038,5125,4914,0.81%
2902252,2907,Sul Baiano,29031,Ilhéus-Itabuna,Arataca,BA,,,13594,11218,10717,10403,5502,4901,5604,4799,-0.75%
2902302,2905,Metropolitana de Salvador,29020,Santo Antônio de Jesus,Aratuípe,BA,8167,7471,7811,8381,8507,8590,4373,4217,5508,3082,0.25%
2902401,2907,Sul Baiano,29031,Ilhéus-Itabuna,Aurelino Leal,BA,12300,16378,15737,17149,14458,13599,6836,6763,11430,2169,-2.29%
2902500,2901,Extremo Oeste Baiano,29001,Barreiras,Baianópolis,BA,8698,9606,13823,12179,13437,13863,7167,6696,3495,10368,1.30%
2902609,2903,Centro Norte Baiano,29011,Itaberaba,Baixa Grande,BA,16918,19579,21634,20441,20980,20069,9969,10100,8333,11736,-0.18%
2902658,2904,Nordeste Baiano,29015,Ribeira do Pombal,Banzaê,BA,,,11489,11156,10865,11811,5992,5819,4039,7772,0.57%
2902708,2902,Vale São-Franciscano da Bahia,29006,Barra,Barra,BA,46330,51563,39806,44203,47755,49342,25172,24170,22461,26881,1.11%
2902807,2906,Centro Sul Baiano,29023,Seabra,Barra da Estiva,BA,10153,12106,17246,24440,20750,21190,10655,10535,10406,10784,-1.42%
2902906,2906,Centro Sul Baiano,29028,Vitória da Conquista,Barra do Choça,BA,8904,20524,24844,40818,32489,34788,17553,17235,22407,12381,-1.59%
2903003,2903,Centro Norte Baiano,29009,Irecê,Barra do Mendes,BA,9531,11055,14469,13610,14054,13997,7016,6981,6255,7742,0.28%
2903102,2907,Sul Baiano,29031,Ilhéus-Itabuna,Barra do Rocha,BA,8132,9593,9690,8074,6133,6336,3350,2986,3814,2522,-2.39%
2903201,2901,Extremo Oeste Baiano,29001,Barreiras,Barreiras,BA,20864,41454,92640,131849,129501,137428,67892,69536,123734,13694,0.42%
2903235,2903,Centro Norte Baiano,29009,Irecê,Barro Alto,BA,,,12059,12098,13403,13626,6917,6709,6726,6900,1.20%
2903276,2904,Nordeste Baiano,29016,Serrinha,Barrocas,BA,,,,,13182,14189,7214,6975,5693,8496,-
2903300,2907,Sul Baiano,29031,Ilhéus-Itabuna,Barro Preto,BA,5978,8200,10601,8602,6669,6453,3306,3147,5295,1158,-2.83%
2903409,2907,Sul Baiano,29031,Ilhéus-Itabuna,Belmonte,BA,21070,22556,22070,20032,21479,21838,11174,10664,11426,10412,0.87%
2903508,2906,Centro Sul Baiano,29028,Vitória da Conquista,Belo Campo,BA,9969,12692,14301,17655,15262,16026,8125,7901,9036,6990,-0.96%
2903607,2904,Nordeste Baiano,29016,Serrinha,Biritinga,BA,10047,10478,14620,14641,13961,14833,7558,7275,3517,11316,0.13%
2903706,2906,Centro Sul Baiano,29028,Vitória da Conquista,Boa Nova,BA,22837,24890,13505,20544,16007,15409,7821,7588,5808,9601,-2.84%
2903805,2903,Centro Norte Baiano,29011,Itaberaba,Boa Vista do Tupim,BA,17881,16812,17160,18408,17841,18000,9142,8858,6593,11407,-0.22%
2903904,2902,Vale São-Franciscano da Bahia,29007,Bom Jesus da Lapa,Bom Jesus da Lapa,BA,40776,69192,48910,54421,62199,63508,31686,31822,43111,20397,1.56%
2903953,2906,Centro Sul Baiano,29028,Vitória da Conquista,Bom Jesus da Serra,BA,,,10226,10502,10295,10123,5194,4929,2770,7353,-0.37%
2904001,2906,Centro Sul Baiano,29023,Seabra,Boninal,BA,9125,9946,13643,12461,13227,13695,6702,6993,4607,9088,0.95%
2904050,2906,Centro Sul Baiano,29023,Seabra,Bonito,BA,,,11085,12902,13678,14851,7535,7316,6246,8605,1.42%
2904100,2906,Centro Sul Baiano,29022,Boquira,Boquira,BA,16130,19070,19444,22121,21856,22042,10861,11181,7361,14681,-0.04%
2904209,2906,Centro Sul Baiano,29022,Boquira,Botuporã,BA,17274,21032,10254,11522,11026,11162,5614,5548,4076,7086,-0.32%
2904308,2906,Centro Sul Baiano,29024,Jequié,Brejões,BA,9920,10634,13041,15344,12677,14282,7114,7168,4937,9345,-0.71%
2904407,2901,Extremo Oeste Baiano,29002,Cotegipe,Brejolândia,BA,8127,9073,11268,8762,9337,11127,5811,5316,1984,9143,2.42%
2904506,2906,Centro Sul Baiano,29022,Boquira,Brotas de Macaúbas,BA,12484,12512,14263,13003,10922,10718,5473,5245,3118,7600,-1.91%
2904605,2906,Centro Sul Baiano,29027,Brumado,Brumado,BA,38304,46747,57176,61670,62381,64550,31733,32817,45119,19431,0.46%
2904704,2907,Sul Baiano,29031,Ilhéus-Itabuna,Buerarema,BA,18889,24875,20839,19118,19956,18622,9310,9312,15299,3323,-0.26%
2904753,2902,Vale São-Franciscano da Bahia,29006,Barra,Buritirama,BA,,,12539,17797,18656,19589,10202,9387,7892,11697,0.96%
2904803,2906,Centro Sul Baiano,29028,Vitória da Conquista,Caatiba,BA,13292,10663,9707,15508,10367,11448,6010,5438,5405,6043,-2.99%
2904852,2905,Metropolitana de Salvador,29020,Santo Antônio de Jesus,Cabaceiras do Paraguaçu,BA,,,14523,15547,17502,17327,8549,8778,4644,12683,1.09%
2904902,2905,Metropolitana de Salvador,29020,Santo Antônio de Jesus,Cachoeira,BA,27382,27946,28290,30416,32252,32035,15460,16575,16392,15643,0.52%
2905008,2906,Centro Sul Baiano,29026,Guanambi,Caculé,BA,12608,15481,17812,20339,21847,22231,11147,11084,13313,8918,0.89%
2905107,2903,Centro Norte Baiano,29010,Jacobina,Caém,BA,8900,9683,17116,12563,10377,10376,5150,5226,3658,6718,-1.89%
2905156,2906,Centro Sul Baiano,29028,Vitória da Conquista,Caetanos,BA,,,10655,13076,12133,13666,7067,6599,3300,10366,0.44%
2905206,2906,Centro Sul Baiano,29026,Guanambi,Caetité,BA,40200,45318,40380,45090,46192,47524,23422,24102,28456,19068,0.53%
2905305,2903,Centro Norte Baiano,29009,Irecê,Cafarnaum,BA,16270,20025,13704,16059,17402,17212,8771,8441,10559,6653,0.70%
2905404,2907,Sul Baiano,29030,Valença,Cairu,BA,9144,11048,15217,11410,13712,15366,7838,7528,8144,7222,3.02%
2905503,2903,Centro Norte Baiano,29010,Jacobina,Caldeirão Grande,BA,11234,17077,15815,11395,13072,12485,6152,6333,4558,7927,0.92%
2905602,2907,Sul Baiano,29031,Ilhéus-Itabuna,Camacan,BA,22644,40500,37023,31055,30289,31468,15726,15742,24682,6786,0.13%
2905701,2905,Metropolitana de Salvador,29021,Salvador,Camaçari,BA,33273,89164,113639,161727,220495,242984,120626,122358,232045,10939,4.15%
2905800,2907,Sul Baiano,29030,Valença,Camamu,BA,25502,36160,32850,33661,32172,35160,17897,17263,15616,19544,0.44%
2905909,2902,Vale São-Franciscano da Bahia,29004,Juazeiro,Campo Alegre de Lourdes,BA,16767,21574,26125,27607,26935,28091,14142,13949,8126,19965,0.17%
2906006,2903,Centro Norte Baiano,29008,Senhor do Bonfim,Campo Formoso,BA,37263,56692,62104,61942,65137,66638,33475,33163,24872,41766,0.73%
2906105,2901,Extremo Oeste Baiano,29003,Santa Maria da Vitória,Canápolis,BA,8198,9439,9475,9743,10577,9382,4794,4588,3225,6157,-0.38%
2906204,2903,Centro Norte Baiano,29009,Irecê,Canarana,BA,21278,25739,22589,21665,24436,24055,12109,11946,11463,12592,1.05%
2906303,2907,Sul Baiano,29031,Ilhéus-Itabuna,Canavieiras,BA,33460,42122,33019,35322,35743,32331,16080,16251,25901,6430,-0.88%
2906402,2904,Nordeste Baiano,29016,Serrinha,Candeal,BA,9718,10772,10728,10121,9019,8895,4499,4396,3476,5419,-1.28%
2906501,2905,Metropolitana de Salvador,29021,Salvador,Candeias,BA,34195,54081,67941,76783,78618,83077,40269,42808,75917,7160,0.79%
2906600,2906,Centro Sul Baiano,29026,Guanambi,Candiba,BA,11436,11491,12610,12124,12352,13205,6813,6392,7725,5480,0.86%
2906709,2906,Centro Sul Baiano,29028,Vitória da Conquista,Cândido Sales,BA,15110,18289,23568,28516,26727,27916,14025,13891,19293,8623,-0.21%
2906808,2904,Nordeste Baiano,29014,Euclides da Cunha,Cansanção,BA,18790,24421,30903,31947,32789,32923,16568,16355,11025,21898,0.30%
2906824,2904,Nordeste Baiano,29014,Euclides da Cunha,Canudos,BA,,,13762,13761,14656,15755,8012,7743,8716,7039,1.36%
2906857,2904,Nordeste Baiano,29016,Serrinha,Capela do Alto Alegre,BA,,,17142,11898,12311,11527,5808,5719,5595,5932,-0.32%
2906873,2903,Centro Norte Baiano,29010,Jacobina,Capim Grosso,BA,,,19659,23908,25823,26529,12984,13545,21725,4804,1.05%
2906899,2906,Centro Sul Baiano,29027,Brumado,Caraíbas,BA,,,17088,17164,10541,10225,5216,5009,2512,7713,-5.05%
2906907,2907,Sul Baiano,29032,Porto Seguro,Caravelas,BA,26027,41170,19763,20103,21150,21437,10878,10559,11317,10120,0.64%
2907004,2904,Nordeste Baiano,29018,Entre Rios,Cardeal da Silva,BA,2961,4094,6400,8034,8280,8271,4166,4105,2902,5369,0.29%
2907103,2902,Vale São-Franciscano da Bahia,29007,Bom Jesus da Lapa,Carinhanha,BA,19390,22275,25565,27272,28879,28378,14518,13860,12580,15798,0.40%
2907202,2902,Vale São-Franciscano da Bahia,29004,Juazeiro,Casa Nova,BA,37036,39321,46838,55730,62862,64944,33094,31850,37555,27389,1.54%
2907301,2905,Metropolitana de Salvador,29020,Santo Antônio de Jesus,Castro Alves,BA,46716,50547,26773,25561,24437,25419,12272,13147,15700,9719,-0.06%
2907400,2901,Extremo Oeste Baiano,29001,Barreiras,Catolândia,BA,1940,3170,3274,3092,3767,2609,1353,1256,966,1643,-1.68%
2907509,2905,Metropolitana de Salvador,29019,Catu,Catu,BA,27893,37429,43430,46731,48697,51075,24820,26255,42747,8328,0.89%
2907558,2906,Centro Sul Baiano,29022,Boquira,Caturama,BA,,,9714,8640,8545,8847,4545,4302,2373,6474,0.24%
2907608,2903,Centro Norte Baiano,29009,Irecê,Central,BA,13864,13858,14696,16792,17320,17027,8699,8328,8165,8862,0.14%
2907707,2902,Vale São-Franciscano da Bahia,29005,Paulo Afonso,Chorrochó,BA,10242,10263,9603,10171,10571,10734,5442,5292,2631,8103,0.54%
2907806,2904,Nordeste Baiano,29015,Ribeira do Pombal,Cícero Dantas,BA,34529,37593,27201,30934,30827,32304,15862,16442,17726,14578,0.43%
2907905,2904,Nordeste Baiano,29015,Ribeira do Pombal,Cipó,BA,6402,9032,12273,14285,15063,15764,7675,8089,11291,4473,0.99%
2908002,2907,Sul Baiano,29031,Ilhéus-Itabuna,Coaraci,BA,21759,27412,31064,27852,22764,20964,10275,10689,19134,1830,-2.80%
2908101,2901,Extremo Oeste Baiano,29003,Santa Maria da Vitória,Cocos,BA,13239,15730,15983,17611,17394,18182,9316,8866,8572,9610,0.32%
2908200,2903,Centro Norte Baiano,29012,Feira de Santana,Conceição da Feira,BA,12417,14422,16067,17514,19091,20408,9925,10483,13154,7254,1.54%
2908309,2905,Metropolitana de Salvador,29020,Santo Antônio de Jesus,Conceição do Almeida,BA,21854,18407,18542,18912,17684,17895,8706,9189,7926,9969,-0.55%
2908408,2904,Nordeste Baiano,29016,Serrinha,Conceição do Coité,BA,35111,41436,52338,56317,60835,62042,30704,31338,36279,25763,0.97%
2908507,2903,Centro Norte Baiano,29012,Feira de Santana,Conceição do Jacuípe,BA,15163,18739,22905,26194,27522,30123,14564,15559,23542,6581,1.41%
2908606,2904,Nordeste Baiano,29018,Entre Rios,Conde,BA,17216,15228,16149,20426,22034,23594,11831,11763,12110,11484,1.45%
2908705,2906,Centro Sul Baiano,29027,Brumado,Condeúba,BA,22458,25329,17898,18047,17004,16888,8265,8623,7453,9435,-0.66%
2908804,2906,Centro Sul Baiano,29023,Seabra,Contendas do Sincorá,BA,6535,5919,4763,4264,3857,4663,2383,2280,2297,2366,0.90%
2908903,2903,Centro Norte Baiano,29012,Feira de Santana,Coração de Maria,BA,18933,20943,21937,23818,23161,22431,10858,11573,9405,13026,-0.60%
2909000,2906,Centro Sul Baiano,29027,Brumado,Cordeiros,BA,8207,7744,10664,8193,8518,8169,4048,4121,2551,5618,-0.03%
2909109,2901,Extremo Oeste Baiano,29003,Santa Maria da Vitória,Coribe,BA,18575,18849,14167,15148,14555,14301,7196,7105,6141,8160,-0.57%
2909208,2904,Nordeste Baiano,29013,Jeremoabo,Coronel João Sá,BA,12742,12773,17133,19665,18168,17066,8796,8270,7043,10023,-1.41%
2909307,2901,Extremo Oeste Baiano,29003,Santa Maria da Vitória,Correntina,BA,30365,34783,28005,30583,31658,31259,15763,15496,12611,18648,0.22%
2909406,2901,Extremo Oeste Baiano,29002,Cotegipe,Cotegipe,BA,20085,22556,12480,13374,13663,13638,7116,6522,6651,6987,0.20%
2909505,2906,Centro Sul Baiano,29024,Jequié,Cravolândia,BA,4714,4805,4720,5001,5427,5042,2554,2488,3180,1862,0.08%
2909604,2904,Nordeste Baiano,29017,Alagoinhas,Crisópolis,BA,11638,14116,16778,19037,19510,20056,10235,9821,8625,11431,0.52%
2909703,2901,Extremo Oeste Baiano,29002,Cotegipe,Cristópolis,BA,7606,9972,12651,12662,13595,13280,6869,6411,3133,10147,0.48%
2909802,2905,Metropolitana de Salvador,29020,Santo Antônio de Jesus,Cruz das Almas,BA,28814,37352,45858,53049,54827,58584,27664,30920,49879,8705,1.00%
2909901,2902,Vale São-Franciscano da Bahia,29004,Juazeiro,Curaçá,BA,17791,20638,24895,28841,32449,32165,16453,15712,13720,18445,1.10%
2910008,2906,Centro Sul Baiano,29028,Vitória da Conquista,Dário Meira,BA,11137,12935,13507,15222,12565,12841,6729,6112,5090,7751,-1.69%
2910057,2905,Metropolitana de Salvador,29021,Salvador,Dias d'Ávila,BA,,,31260,45333,53821,66373,32802,33571,62417,3956,3.89%
2910107,2906,Centro Sul Baiano,29025,Livramento do Brumado,Dom Basílio,BA,7744,8696,9730,10427,11087,11355,5867,5488,2241,9114,0.86%
2910206,2905,Metropolitana de Salvador,29020,Santo Antônio de Jesus,Dom Macedo Costa,BA,5140,5473,3904,3748,3809,3873,1896,1977,1760,2113,0.33%
2910305,2903,Centro Norte Baiano,29012,Feira de Santana,Elísio Medrado,BA,8628,7722,7839,7860,7907,7952,3953,3999,3253,4699,0.12%
2910404,2906,Centro Sul Baiano,29029,Itapetinga,Encruzilhada,BA,24512,24748,21362,32924,22525,23786,12387,11399,5135,18651,-3.20%
2910503,2904,Nordeste Baiano,29018,Entre Rios,Entre Rios,BA,19188,22545,27718,37513,38886,39883,19642,20241,23844,16039,0.61%
2910602,2904,Nordeste Baiano,29018,Entre Rios,Esplanada,BA,16671,19016,23205,27230,31118,33278,16574,16704,20826,12452,2.03%
2910701,2904,Nordeste Baiano,29014,Euclides da Cunha,Euclides da Cunha,BA,41588,50400,51812,53885,56625,56312,28329,27983,27420,28892,0.44%
2910727,2907,Sul Baiano,29032,Porto Seguro,Eunápolis,BA,,,70545,84120,93984,100246,49423,50823,93442,6804,1.77%
2910750,2904,Nordeste Baiano,29015,Ribeira do Pombal,Fátima,BA,,,17683,18298,18918,17652,8950,8702,6911,10741,-0.36%
2910776,2902,Vale São-Franciscano da Bahia,29007,Bom Jesus da Lapa,Feira da Mata,BA,,,6343,6235,6328,6179,3186,2993,3243,2936,-0.09%
2910800,2903,Centro Norte Baiano,29012,Feira de Santana,Feira de Santana,BA,187290,291506,406447,480949,571997,556756,264031,292725,510736,46020,1.47%
2910859,2903,Centro Norte Baiano,29008,Senhor do Bonfim,Filadélfia,BA,,,16994,17194,15979,16749,8442,8307,9031,7718,-0.26%
2910909,2907,Sul Baiano,29031,Ilhéus-Itabuna,Firmino Alves,BA,5961,6034,5523,5170,5577,5385,2733,2652,4338,1047,0.41%
2911006,2907,Sul Baiano,29031,Ilhéus-Itabuna,Floresta Azul,BA,15428,18436,13940,11614,10333,10660,5438,5222,7343,3317,-0.85%
2911105,2901,Extremo Oeste Baiano,29001,Barreiras,Formosa do Rio Preto,BA,8979,11883,15418,18288,20845,22534,11669,10865,13647,8887,2.11%
2911204,2907,Sul Baiano,29031,Ilhéus-Itabuna,Gandu,BA,18038,29270,26461,27160,30091,30329,15100,15229,24840,5489,1.11%
2911253,2904,Nordeste Baiano,29016,Serrinha,Gavião,BA,,,7118,4792,4444,4561,2356,2205,2538,2023,-0.49%
2911303,2903,Centro Norte Baiano,29009,Irecê,Gentio do Ouro,BA,9328,9192,11093,10173,11326,10720,5499,5221,5404,5316,0.53%
2911402,2902,Vale São-Franciscano da Bahia,29005,Paulo Afonso,Glória,BA,8396,9877,12815,14559,13879,15073,7531,7542,2827,12246,0.35%
2911501,2907,Sul Baiano,29031,Ilhéus-Itabuna,Gongogi,BA,9643,8343,8951,10522,6845,8344,4227,4117,5359,2985,-2.29%
2911600,2905,Metropolitana de Salvador,29020,Santo Antônio de Jesus,Governador Mangabeira,BA,12941,17002,17859,17165,19828,19826,9504,10322,7417,12409,1.45%
2911659,2906,Centro Sul Baiano,29027,Brumado,Guajeru,BA,,,8534,12836,7062,10383,5233,5150,2079,8304,-2.10%
2911709,2906,Centro Sul Baiano,29026,Guanambi,Guanambi,BA,31174,45526,65592,71728,76230,78801,38462,40339,62534,16267,0.94%
2911808,2907,Sul Baiano,29032,Porto Seguro,Guaratinga,BA,33118,30443,25441,24319,22621,22195,11633,10562,10453,11742,-0.91%
2911857,2904,Nordeste Baiano,29015,Ribeira do Pombal,Heliópolis,BA,,,11376,13108,14020,12444,6285,6159,5429,7015,-0.52%
2911907,2903,Centro Norte Baiano,29011,Itaberaba,Iaçu,BA,19261,25179,26065,28501,27835,25735,12628,13107,20166,5569,-1.02%
2912004,2906,Centro Sul Baiano,29026,Guanambi,Ibiassucê,BA,9857,10754,11898,12828,9507,10077,5109,4968,4698,5379,-2.38%
2912103,2907,Sul Baiano,29031,Ilhéus-Itabuna,Ibicaraí,BA,26152,30978,30560,28861,24752,24241,11865,12376,17853,6388,-1.73%
2912202,2906,Centro Sul Baiano,29023,Seabra,Ibicoara,BA,5401,6025,8726,14453,15856,17301,8763,8538,10980,6321,1.81%
2912301,2906,Centro Sul Baiano,29028,Vitória da Conquista,Ibicuí,BA,16297,15615,15636,15129,15777,15786,8064,7722,11965,3821,0.43%
2912400,2903,Centro Norte Baiano,29009,Irecê,Ibipeba,BA,9036,11476,17449,15362,16762,17021,8776,8245,10055,6966,1.03%
2912509,2906,Centro Sul Baiano,29022,Boquira,Ibipitanga,BA,10635,12085,13245,13419,13841,14171,7048,7123,5155,9016,0.55%
2912608,2903,Centro Norte Baiano,29011,Itaberaba,Ibiquera,BA,6499,6708,5838,4495,5007,4865,2530,2335,2461,2404,0.79%
2912707,2907,Sul Baiano,29031,Ilhéus-Itabuna,Ibirapitanga,BA,13323,20310,26784,22177,23197,22610,11535,11075,6163,16447,0.19%
2912806,2907,Sul Baiano,29032,Porto Seguro,Ibirapuã,BA,18458,9801,8290,7096,7534,7960,4105,3855,4534,3426,1.16%
2912905,2907,Sul Baiano,29031,Ilhéus-Itabuna,Ibirataia,BA,14428,19977,22694,24741,23940,18946,9445,9501,15751,3195,-2.63%
2913002,2906,Centro Sul Baiano,29022,Boquira,Ibitiara,BA,19179,21171,17008,14443,15802,15519,7701,7818,3437,12082,0.72%
2913101,2903,Centro Norte Baiano,29009,Irecê,Ibititá,BA,11737,15602,17285,17905,18614,17832,9050,8782,8341,9491,-0.04%
2913200,2902,Vale São-Franciscano da Bahia,29006,Barra,Ibotirama,BA,10630,17166,23270,24149,25292,25422,12803,12619,19499,5923,0.52%
2913309,2904,Nordeste Baiano,29016,Serrinha,Ichu,BA,4771,5283,8596,5593,5881,5255,2588,2667,3365,1890,-0.62%
2913408,2906,Centro Sul Baiano,29026,Guanambi,Igaporã,BA,10310,11688,13952,14557,14499,15194,7640,7554,7860,7334,0.43%
2913457,2907,Sul Baiano,29030,Valença,Igrapiúna,BA,,,12695,14960,13246,13347,7049,6298,4277,9070,-1.13%
2913507,2906,Centro Sul Baiano,29028,Vitória da Conquista,Iguaí,BA,23696,23555,22984,25134,27849,25724,13122,12602,14608,11116,0.23%
2913606,2907,Sul Baiano,29031,Ilhéus-Itabuna,Ilhéus,BA,107971,131456,223750,222127,220144,184231,89363,94868,155300,28931,-1.85%
2913705,2904,Nordeste Baiano,29017,Alagoinhas,Inhambupe,BA,19417,22848,25777,29589,34388,36290,18021,18269,15647,20643,2.06%
2913804,2903,Centro Norte Baiano,29012,Feira de Santana,Ipecaetá,BA,17333,17058,16376,18383,16055,15334,7587,7747,2637,12697,-1.80%
2913903,2907,Sul Baiano,29031,Ilhéus-Itabuna,Ipiaú,BA,27622,39075,45245,43621,42561,44430,21842,22588,40424,4006,0.18%
2914000,2903,Centro Norte Baiano,29012,Feira de Santana,Ipirá,BA,56860,69756,62672,61746,60043,59352,29089,30263,29027,30325,-0.39%
2914109,2906,Centro Sul Baiano,29022,Boquira,Ipupiara,BA,6621,6853,8034,8541,8931,9290,4743,4547,5984,3306,0.84%
2914208,2906,Centro Sul Baiano,29024,Jequié,Irajuba,BA,8323,7865,6354,6362,7215,7002,3506,3496,3273,3729,0.96%
2914307,2906,Centro Sul Baiano,29024,Jequié,Iramaia,BA,9419,12777,17199,17553,15134,11988,6165,5823,5402,6586,-3.74%
2914406,2903,Centro Norte Baiano,29009,Irecê,Iraquara,BA,11972,14359,17006,18334,22607,22607,11249,11358,6758,15849,2.12%
2914505,2903,Centro Norte Baiano,29012,Feira de Santana,Irará,BA,16575,20454,23869,25163,25012,27492,13315,14177,11252,16240,0.89%
2914604,2903,Centro Norte Baiano,29009,Irecê,Irecê,BA,62313,87922,50908,57436,62676,66404,32142,34262,61248,5156,1.46%
2914653,2907,Sul Baiano,29032,Porto Seguro,Itabela,BA,,,20848,25746,25821,28399,14481,13918,21387,7012,0.99%
2914703,2903,Centro Norte Baiano,29011,Itaberaba,Itaberaba,BA,33629,45237,53742,58943,59393,61623,29925,31698,48470,13153,0.45%
2914802,2907,Sul Baiano,29031,Ilhéus-Itabuna,Itabuna,BA,112721,153339,185277,196675,210604,204710,96936,107774,199668,5042,0.40%
2914901,2907,Sul Baiano,29031,Ilhéus-Itabuna,Itacaré,BA,14104,13207,18431,18120,24720,24340,12705,11635,13670,10670,3.00%
2915007,2906,Centro Sul Baiano,29023,Seabra,Itaeté,BA,16924,15440,14296,14006,14154,14932,7518,7414,6213,8719,0.64%
2915106,2906,Centro Sul Baiano,29024,Jequié,Itagi,BA,11468,13428,14554,14629,13882,13053,6589,6464,10210,2843,-1.13%
2915205,2907,Sul Baiano,29031,Ilhéus-Itabuna,Itagibá,BA,15970,19006,19916,17191,16272,15210,7812,7398,9583,5627,-1.22%
2915304,2907,Sul Baiano,29032,Porto Seguro,Itagimirim,BA,10811,7870,7887,7728,7049,7110,3560,3550,5649,1461,-0.83%
2915353,2902,Vale São-Franciscano da Bahia,29006,Barra,Itaguaçu da Bahia,BA,,,17341,11309,12545,13209,6959,6250,2598,10611,1.57%
2915403,2907,Sul Baiano,29031,Ilhéus-Itabuna,Itaju do Colônia,BA,9915,10834,9773,8580,7673,7278,3683,3595,5845,1433,-1.63%
2915502,2907,Sul Baiano,29031,Ilhéus-Itabuna,Itajuípe,BA,19828,24986,24931,22511,20343,21094,10464,10630,16847,4247,-0.65%
2915601,2907,Sul Baiano,29032,Porto Seguro,Itamaraju,BA,63938,77678,64308,64144,65327,63355,31610,31745,50176,13179,-0.12%
2915700,2907,Sul Baiano,29031,Ilhéus-Itabuna,Itamari,BA,5325,8097,8831,8347,8468,7904,4037,3867,5839,2065,-0.54%
2915809,2906,Centro Sul Baiano,29029,Itapetinga,Itambé,BA,27814,25535,23901,30850,33687,23106,11591,11515,19714,3392,-2.85%
2915908,2905,Metropolitana de Salvador,29019,Catu,Itanagra,BA,3608,4524,5553,6370,6605,7591,3881,3710,2327,5264,1.77%
2916005,2907,Sul Baiano,29032,Porto Seguro,Itanhém,BA,34745,27675,23225,21334,20636,20199,10292,9907,14204,5995,-0.55%
2916104,2905,Metropolitana de Salvador,29021,Salvador,Itaparica,BA,8391,10877,15055,18945,19897,20760,10175,10585,20760,0,0.92%
2916203,2907,Sul Baiano,29031,Ilhéus-Itabuna,Itapé,BA,12690,11403,15644,14639,11123,10986,5603,5383,7188,3798,-2.83%
2916302,2907,Sul Baiano,29031,Ilhéus-Itabuna,Itapebi,BA,13786,11063,11078,11126,11520,10497,5257,5240,8271,2226,-0.58%
2916401,2906,Centro Sul Baiano,29029,Itapetinga,Itapetinga,BA,46112,47418,53476,57931,63243,68314,33480,34834,66329,1985,1.66%
2916500,2904,Nordeste Baiano,29015,Ribeira do Pombal,Itapicuru,BA,16942,19689,24851,27315,30703,32278,16473,15805,6675,25603,1.68%
2916609,2907,Sul Baiano,29031,Ilhéus-Itabuna,Itapitanga,BA,9550,10387,10474,10382,10106,10207,5178,5029,7591,2616,-0.17%
2916708,2906,Centro Sul Baiano,29024,Jequié,Itaquara,BA,6882,7755,7180,7861,7564,7678,3842,3836,4608,3070,-0.24%
2916807,2906,Centro Sul Baiano,29029,Itapetinga,Itarantim,BA,20841,17126,17216,16923,17615,18548,9527,9021,15311,3237,0.92%
2916856,2903,Centro Norte Baiano,29012,Feira de Santana,Itatim,BA,,,10039,12700,14569,14539,7259,7280,10113,4426,1.36%
2916906,2906,Centro Sul Baiano,29024,Jequié,Itiruçu,BA,8698,9614,12622,13585,15764,12693,6241,6452,9526,3167,-0.68%
2917003,2903,Centro Norte Baiano,29008,Senhor do Bonfim,Itiúba,BA,26033,30549,34403,35543,35749,36112,18318,17794,9698,26414,0.16%
2917102,2906,Centro Sul Baiano,29029,Itapetinga,Itororó,BA,19347,21860,20510,19799,20165,19911,9998,9913,18099,1812,0.06%
2917201,2906,Centro Sul Baiano,29027,Brumado,Ituaçu,BA,13310,13697,16095,17268,17939,18127,9031,9096,6569,11558,0.49%
2917300,2907,Sul Baiano,29030,Valença,Ituberá,BA,15933,27594,20553,24133,23530,26592,13393,13199,19243,7349,0.98%
2917334,2906,Centro Sul Baiano,29026,Guanambi,Iuiú,BA,,,10841,10489,11469,10905,5652,5253,5284,5621,0.39%
2917359,2901,Extremo Oeste Baiano,29003,Santa Maria da Vitória,Jaborandi,BA,,,11692,10288,8931,8976,4660,4316,3041,5935,-1.35%
2917409,2906,Centro Sul Baiano,29026,Guanambi,Jacaraci,BA,13809,14278,13939,13520,14346,13656,6931,6725,4927,8729,0.10%
2917508,2903,Centro Norte Baiano,29010,Jacobina,Jacobina,BA,76519,103967,76518,76492,76463,79285,38352,40933,55887,23398,0.36%
2917607,2906,Centro Sul Baiano,29024,Jequié,Jaguaquara,BA,25973,32775,39372,46621,46641,51019,25043,25976,38858,12161,0.91%
2917706,2903,Centro Norte Baiano,29008,Senhor do Bonfim,Jaguarari,BA,17538,23004,31141,27412,29097,30342,15423,14919,16624,13718,1.02%
2917805,2905,Metropolitana de Salvador,29020,Santo Antônio de Jesus,Jaguaripe,BA,10147,10874,13840,13422,16207,16467,8450,8017,5300,11167,2.07%
2917904,2904,Nordeste Baiano,29018,Entre Rios,Jandaíra,BA,6714,6603,8225,10027,9758,10322,5303,5019,6139,4183,0.29%
2918001,2906,Centro Sul Baiano,29024,Jequié,Jequié,BA,100174,116867,144772,147202,145964,151921,73628,78293,139452,12469,0.32%
2918100,2904,Nordeste Baiano,29013,Jeremoabo,Jeremoabo,BA,28625,33436,38449,34916,37431,37661,18998,18663,17443,20218,0.76%
2918209,2906,Centro Sul Baiano,29024,Jequié,Jiquiriçá,BA,8604,9356,11763,13638,13386,14087,7135,6952,5581,8506,0.32%
2918308,2906,Centro Sul Baiano,29024,Jequié,Jitaúna,BA,13167,16765,20831,21056,16839,14115,7124,6991,9260,4855,-3.92%
2918357,2903,Centro Norte Baiano,29009,Irecê,João Dourado,BA,,,19211,18967,20834,22359,11275,11084,13566,8793,1.66%
2918407,2902,Vale São-Franciscano da Bahia,29004,Juazeiro,Juazeiro,BA,61648,118175,128767,174567,230538,197984,97097,100887,160786,37198,1.27%
2918456,2907,Sul Baiano,29032,Porto Seguro,Jucuruçu,BA,,,16012,12377,10599,9960,5246,4714,2292,7668,-2.15%
2918506,2903,Centro Norte Baiano,29009,Irecê,Jussara,BA,8468,12810,14002,15339,14833,15053,7814,7239,10052,5001,-0.19%
2918555,2907,Sul Baiano,29031,Ilhéus-Itabuna,Jussari,BA,,,8470,7556,6857,6467,3274,3193,4876,1591,-1.54%
2918605,2906,Centro Sul Baiano,29023,Seabra,Jussiape,BA,8159,8771,10229,10051,8465,7972,3885,4087,3063,4909,-2.29%
2918704,2906,Centro Sul Baiano,29024,Jequié,Lafaiete Coutinho,BA,4950,4590,5125,4102,3526,3901,2030,1871,2104,1797,-0.50%
2918753,2906,Centro Sul Baiano,29026,Guanambi,Lagoa Real,BA,,,10978,12765,13795,13934,7180,6754,2800,11134,0.88%
2918803,2906,Centro Sul Baiano,29024,Jequié,Laje,BA,14635,15743,18319,19601,21104,22206,11288,10918,6082,16124,1.26%
2918902,2907,Sul Baiano,29032,Porto Seguro,Lajedão,BA,7092,4685,3818,3409,3469,3733,1837,1896,2076,1657,0.91%
2919009,2903,Centro Norte Baiano,29011,Itaberaba,Lajedinho,BA,6628,6897,6225,4352,4329,3930,2043,1887,1245,2685,-1.01%
2919058,2906,Centro Sul Baiano,29024,Jequié,Lajedo do Tabocal,BA,,,6476,8100,8591,8305,4187,4118,5149,3156,0.25%
2919108,2904,Nordeste Baiano,29016,Serrinha,Lamarão,BA,6251,9358,10275,9523,11988,9027,4483,4544,2087,6940,-0.53%
2919157,2903,Centro Norte Baiano,29009,Irecê,Lapão,BA,,,20913,24727,25557,25651,13084,12567,10053,15598,0.37%
2919207,2905,Metropolitana de Salvador,29021,Salvador,Lauro de Freitas,BA,10007,35431,69270,113543,144492,163414,79234,84180,163414,0,3.71%
2919306,2906,Centro Sul Baiano,29023,Seabra,Lençóis,BA,5131,5639,7584,8910,9617,10368,5210,5158,8037,2331,1.53%
2919405,2906,Centro Sul Baiano,29026,Guanambi,Licínio de Almeida,BA,11876,12162,14089,12349,12695,12320,6277,6043,6264,6056,-0.02%
2919504,2906,Centro Sul Baiano,29025,Livramento do Brumado,Livramento de Nossa Senhora,BA,25263,29283,34345,38025,42146,42705,21490,21215,20546,22159,1.17%
2919553,2901,Extremo Oeste Baiano,29001,Barreiras,Luís Eduardo Magalhães,BA,,,,,44265,60179,31090,29089,54955,5224,-
2919603,2903,Centro Norte Baiano,29011,Itaberaba,Macajuba,BA,8727,9428,10479,11474,11207,11229,5520,5709,6871,4358,-0.22%
2919702,2906,Centro Sul Baiano,29029,Itapetinga,Macarani,BA,14381,14099,14057,14594,16046,17088,8581,8507,13631,3457,1.59%
2919801,2906,Centro Sul Baiano,29022,Boquira,Macaúbas,BA,26639,31098,34558,41806,45958,47067,23541,23526,15410,31657,1.19%
2919900,2902,Vale São-Franciscano da Bahia,29005,Paulo Afonso,Macururé,BA,7192,8296,6770,8612,7779,8067,4001,4066,2859,5208,-0.65%
2919926,2905,Metropolitana de Salvador,29021,Salvador,Madre de Deus,BA,,,9183,12036,15432,17384,8381,9003,16861,523,3.74%
2919959,2906,Centro Sul Baiano,29027,Brumado,Maetinga,BA,,,10399,13686,8793,7031,3579,3452,2817,4214,-6.44%
2920007,2906,Centro Sul Baiano,29029,Itapetinga,Maiquinique,BA,7944,7345,7833,7326,8324,8782,4544,4238,6916,1866,1.83%
2920106,2903,Centro Norte Baiano,29011,Itaberaba,Mairi,BA,30301,34481,20769,20085,19259,19335,9549,9786,11121,8214,-0.38%
2920205,2906,Centro Sul Baiano,29026,Guanambi,Malhada,BA,16522,19676,15210,15614,16085,16008,8285,7723,6559,9449,0.25%
2920304,2906,Centro Sul Baiano,29027,Brumado,Malhada de Pedras,BA,6809,6233,7279,8426,7620,8452,4316,4136,3233,5219,0.03%
2920403,2906,Centro Sul Baiano,29028,Vitória da Conquista,Manoel Vitorino,BA,14566,16633,17025,16704,14262,14390,7338,7052,7359,7031,-1.48%
2920452,2901,Extremo Oeste Baiano,29002,Cotegipe,Mansidão,BA,,,10290,11046,11694,12594,6587,6007,4784,7810,1.32%
2920502,2906,Centro Sul Baiano,29024,Jequié,Maracás,BA,21831,25712,27154,31683,34221,24615,12203,12412,17709,6906,-2.49%
2920601,2905,Metropolitana de Salvador,29020,Santo Antônio de Jesus,Maragogipe,BA,41038,41248,38811,40314,42079,42815,21519,21296,25092,17723,0.60%
2920700,2907,Sul Baiano,29030,Valença,Maraú,BA,11875,14298,17496,18366,17029,19097,10078,9019,3561,15536,0.39%
2920809,2906,Centro Sul Baiano,29024,Jequié,Marcionílio Souza,BA,7502,10142,13661,10775,10716,10508,5310,5198,5317,5191,-0.25%
2920908,2907,Sul Baiano,29031,Ilhéus-Itabuna,Mascote,BA,10567,19227,20178,16093,16061,14640,7548,7092,11669,2971,-0.94%
2921005,2905,Metropolitana de Salvador,29019,Catu,Mata de São João,BA,27188,32661,30535,32568,37201,40210,19891,20319,29852,10358,2.13%
2921054,2906,Centro Sul Baiano,29026,Guanambi,Matina,BA,,,8999,10242,12322,11134,5686,5448,3485,7649,0.84%
2921104,2907,Sul Baiano,29032,Porto Seguro,Medeiros Neto,BA,29336,27460,23059,21235,21866,21541,11043,10498,17057,4484,0.14%
2921203,2903,Centro Norte Baiano,29010,Jacobina,Miguel Calmon,BA,23009,23395,25260,28267,27213,26466,13191,13275,16060,10406,-0.66%
2921302,2906,Centro Sul Baiano,29024,Jequié,Milagres,BA,8864,9020,9298,12067,11771,10306,5003,5303,7789,2517,-1.57%
2921401,2903,Centro Norte Baiano,29010,Jacobina,Mirangaba,BA,10678,13416,14651,14261,17474,16323,8200,8123,7494,8829,1.36%
2921450,2906,Centro Sul Baiano,29028,Vitória da Conquista,Mirante,BA,,,8189,13666,9174,10512,5394,5118,1809,8703,-2.59%
2921500,2904,Nordeste Baiano,29014,Euclides da Cunha,Monte Santo,BA,36130,42178,51280,54552,52249,52360,26601,25759,8845,43515,-0.41%
2921609,2902,Vale São-Franciscano da Bahia,29006,Barra,Morpará,BA,6468,7194,7411,8597,8586,8285,4243,4042,5539,2746,-0.37%
2921708,2903,Centro Norte Baiano,29010,Jacobina,Morro do Chapéu,BA,23433,31824,31766,34494,34012,35207,17711,17496,20281,14926,0.20%
2921807,2906,Centro Sul Baiano,29026,Guanambi,Mortugaba,BA,8595,10714,12907,12598,13905,12482,6219,6263,5889,6593,-0.09%
2921906,2906,Centro Sul Baiano,29023,Seabra,Mucugê,BA,6759,6545,10334,13682,14131,10548,5231,5317,4183,6365,-2.57%
2922003,2907,Sul Baiano,29032,Porto Seguro,Mucuri,BA,16766,15144,17606,28062,33143,36043,18171,17872,27484,8559,2.53%
2922052,2903,Centro Norte Baiano,29009,Irecê,Mulungu do Morro,BA,,,13741,15119,13755,12270,6181,6089,5934,6336,-2.07%
2922102,2903,Centro Norte Baiano,29011,Itaberaba,Mundo Novo,BA,20708,19594,30854,21273,23822,24419,12390,12029,13588,10831,1.39%
2922201,2905,Metropolitana de Salvador,29020,Santo Antônio de Jesus,Muniz Ferreira,BA,6007,6049,6280,6941,6990,7310,3678,3632,3394,3916,0.52%
2922250,2902,Vale São-Franciscano da Bahia,29006,Barra,Muquém de São Francisco,BA,,,8257,9052,10096,10272,5449,4823,1283,8989,1.27%
2922300,2905,Metropolitana de Salvador,29020,Santo Antônio de Jesus,Muritiba,BA,28133,31118,24534,30644,27212,28897,13717,15180,18038,10859,-0.59%
2922409,2906,Centro Sul Baiano,29024,Jequié,Mutuípe,BA,15009,17324,20491,20462,21181,21466,10617,10849,9669,11797,0.48%
2922508,2905,Metropolitana de Salvador,29020,Santo Antônio de Jesus,Nazaré,BA,21780,23596,25954,26365,26506,27269,13233,14036,22861,4408,0.34%
2922607,2907,Sul Baiano,29030,Valença,Nilo Peçanha,BA,6878,7627,12290,11213,12531,12530,6463,6067,3104,9426,1.12%
2922656,2904,Nordeste Baiano,29014,Euclides da Cunha,Nordestina,BA,,,9315,11800,12172,12398,6418,5980,3932,8466,0.50%
2922706,2906,Centro Sul Baiano,29028,Vitória da Conquista,Nova Canaã,BA,15925,13670,13815,15366,18829,16727,8573,8154,6836,9891,0.85%
2922730,2904,Nordeste Baiano,29016,Serrinha,Nova Fátima,BA,,,10445,7536,7674,7602,3793,3809,5074,2528,0.09%
2922755,2907,Sul Baiano,29031,Ilhéus-Itabuna,Nova Ibiá,BA,,,10502,7166,6871,6648,3488,3160,2801,3847,-0.75%
2922805,2906,Centro Sul Baiano,29024,Jequié,Nova Itarana,BA,5841,7018,6636,6592,7423,7438,3770,3668,2715,4723,1.21%
2922854,2906,Centro Sul Baiano,29023,Seabra,Nova Redenção,BA,,,10318,8636,8943,8034,4069,3965,5237,2797,-0.72%
2922904,2904,Nordeste Baiano,29015,Ribeira do Pombal,Nova Soure,BA,18234,22839,24674,24405,25697,24132,12128,12004,11730,12402,-0.11%
2923001,2907,Sul Baiano,29032,Porto Seguro,Nova Viçosa,BA,17073,18591,25570,32076,34623,38537,19385,19152,33518,5019,1.85%
2923035,2906,Centro Sul Baiano,29022,Boquira,Novo Horizonte,BA,,,10184,8502,10304,10673,5502,5171,3505,7168,2.30%
2923050,2904,Nordeste Baiano,29015,Ribeira do Pombal,Novo Triunfo,BA,,,11080,13599,14153,15057,7529,7528,7505,7552,1.02%
2923100,2904,Nordeste Baiano,29015,Ribeira do Pombal,Olindina,BA,12813,16572,21462,23909,23791,24943,12291,12652,12777,12166,0.42%
2923209,2906,Centro Sul Baiano,29022,Boquira,Oliveira dos Brejinhos,BA,16331,18343,21105,21670,22609,21839,11128,10711,6583,15256,0.08%
2923308,2903,Centro Norte Baiano,29012,Feira de Santana,Ouriçangas,BA,6885,6343,7043,7525,7802,8287,4206,4081,2755,5532,0.97%
2923357,2903,Centro Norte Baiano,29010,Jacobina,Ourolândia,BA,,,12235,15356,16302,16477,8387,8090,6361,10116,0.71%
2923407,2906,Centro Sul Baiano,29026,Guanambi,Palmas de Monte Alto,BA,13574,15724,20477,20099,21107,20779,10598,10181,9830,10949,0.33%
2923506,2906,Centro Sul Baiano,29023,Seabra,Palmeiras,BA,6387,6621,7142,7518,8040,8408,4174,4234,5237,3171,1.13%
2923605,2906,Centro Sul Baiano,29025,Livramento do Brumado,Paramirim,BA,20599,21997,22577,18921,20055,20998,10565,10433,10029,10969,1.05%
2923704,2902,Vale São-Franciscano da Bahia,29007,Bom Jesus da Lapa,Paratinga,BA,18409,20635,24181,27679,28671,29475,14917,14558,10915,18560,0.63%
2923803,2904,Nordeste Baiano,29015,Ribeira do Pombal,Paripiranga,BA,32208,35442,26027,26591,28347,27782,13670,14112,9534,18248,0.44%
2923902,2907,Sul Baiano,29031,Ilhéus-Itabuna,Pau Brasil,BA,15135,18776,16179,13048,12155,10853,5495,5358,7383,3470,-1.83%
2924009,2902,Vale São-Franciscano da Bahia,29005,Paulo Afonso,Paulo Afonso,BA,46126,71137,86619,96499,101952,108419,51957,56462,93457,14962,1.17%
2924058,2904,Nordeste Baiano,29016,Serrinha,Pé de Serra,BA,,,17048,13531,14160,13752,6817,6935,5174,8578,0.16%
2924108,2903,Centro Norte Baiano,29012,Feira de Santana,Pedrão,BA,7589,7617,6813,6764,7238,6896,3411,3485,1711,5185,0.19%
2924207,2904,Nordeste Baiano,29013,Jeremoabo,Pedro Alexandre,BA,9073,10097,14801,16953,17092,16995,8683,8312,2786,14209,0.02%
2924306,2906,Centro Sul Baiano,29023,Seabra,Piatã,BA,15169,16764,18308,18977,18085,17985,8738,9247,7611,10374,-0.54%
2924405,2902,Vale São-Franciscano da Bahia,29004,Juazeiro,Pilão Arcado,BA,24803,27912,31949,30713,32844,32815,16674,16141,11006,21809,0.66%
2924504,2906,Centro Sul Baiano,29026,Guanambi,Pindaí,BA,12839,13126,16575,15494,15306,15629,8014,7615,4319,11310,0.09%
2924603,2903,Centro Norte Baiano,29008,Senhor do Bonfim,Pindobaçu,BA,26100,28332,24047,20869,20312,20119,10324,9795,11235,8884,-0.37%
2924652,2903,Centro Norte Baiano,29012,Feira de Santana,Pintadas,BA,,,10405,10927,10551,10345,5199,5146,5842,4503,-0.55%
2924678,2907,Sul Baiano,29030,Valença,Piraí do Norte,BA,,,13759,10425,8897,9835,5177,4658,3696,6139,-0.58%
2924702,2906,Centro Sul Baiano,29027,Brumado,Piripá,BA,8011,10031,10416,16128,13515,12789,6445,6344,6196,6593,-2.29%
2924801,2903,Centro Norte Baiano,29010,Jacobina,Piritiba,BA,15144,16301,24176,19037,24189,22411,11287,11124,15156,7255,1.65%
2924900,2906,Centro Sul Baiano,29024,Jequié,Planaltino,BA,8791,9124,10332,7963,8472,8822,4572,4250,3640,5182,1.03%
2925006,2906,Centro Sul Baiano,29028,Vitória da Conquista,Planalto,BA,19719,22359,23526,21707,21486,24497,12104,12393,14878,9619,1.22%
2925105,2906,Centro Sul Baiano,29028,Vitória da Conquista,Poções,BA,39448,45521,37834,44213,44759,44760,21804,22956,34698,10062,0.12%
2925204,2905,Metropolitana de Salvador,29019,Catu,Pojuca,BA,12070,16112,22485,26203,30221,33064,16082,16982,28373,4691,2.35%
2925253,2903,Centro Norte Baiano,29010,Jacobina,Ponto Novo,BA,,,17171,17187,14820,15741,7924,7817,8405,7336,-0.87%
2925303,2907,Sul Baiano,29032,Porto Seguro,Porto Seguro,BA,33108,46300,34661,95721,114459,126770,63393,63377,104090,22680,2.85%
2925402,2906,Centro Sul Baiano,29029,Itapetinga,Potiraguá,BA,13622,11023,10389,14579,10350,9829,5077,4752,6604,3225,-3.87%
2925501,2907,Sul Baiano,29032,Porto Seguro,Prado,BA,31210,26433,22632,26498,25429,27612,13975,13637,15454,12158,0.41%
2925600,2903,Centro Norte Baiano,29009,Irecê,Presidente Dutra,BA,11286,13144,13833,13730,13822,13756,7002,6754,9057,4699,0.02%
2925709,2906,Centro Sul Baiano,29027,Brumado,Presidente Jânio Quadros,BA,15311,19621,14125,17045,14803,13657,6985,6672,4198,9459,-2.19%
2925758,2907,Sul Baiano,29030,Valença,Presidente Tancredo Neves,BA,,,18535,19404,22684,23857,12222,11635,9576,14281,2.09%
2925808,2904,Nordeste Baiano,29014,Euclides da Cunha,Queimadas,BA,22830,27259,23162,24613,27186,24583,12277,12306,12492,12091,-0.01%
2925907,2904,Nordeste Baiano,29014,Euclides da Cunha,Quijingue,BA,16001,19621,23958,26376,27068,27243,14019,13224,6384,20859,0.32%
2925931,2903,Centro Norte Baiano,29010,Jacobina,Quixabeira,BA,,,13927,9466,9348,9548,4877,4671,3663,5885,0.09%
2925956,2903,Centro Norte Baiano,29012,Feira de Santana,Rafael Jambeiro,BA,,,22572,22600,23107,25555,12515,13040,7238,18317,1.24%
2926004,2902,Vale São-Franciscano da Bahia,29004,Juazeiro,Remanso,BA,23588,28934,34381,36257,38004,39149,19545,19604,23607,15542,0.77%
2926103,2904,Nordeste Baiano,29016,Serrinha,Retirolândia,BA,9019,10402,11300,10891,11938,12059,6027,6032,6726,5333,1.02%
2926202,2901,Extremo Oeste Baiano,29001,Barreiras,Riachão das Neves,BA,14693,18292,20282,21917,22528,21941,11443,10498,10746,11195,0.01%
2926301,2904,Nordeste Baiano,29016,Serrinha,Riachão do Jacuípe,BA,49864,62887,37610,31633,32522,33081,16124,16957,19860,13221,0.45%
2926400,2906,Centro Sul Baiano,29026,Guanambi,Riacho de Santana,BA,29387,33116,27259,28643,29425,30651,15596,15055,13096,17555,0.68%
2926509,2904,Nordeste Baiano,29015,Ribeira do Pombal,Ribeira do Amparo,BA,19276,24100,13942,13903,14101,14267,7234,7033,1921,12346,0.26%
2926608,2904,Nordeste Baiano,29015,Ribeira do Pombal,Ribeira do Pombal,BA,38968,45679,42509,46270,47400,48271,23749,24522,29775,18496,0.42%
2926657,2906,Centro Sul Baiano,29029,Itapetinga,Ribeirão do Largo,BA,,,10930,15303,14297,8573,4474,4099,4624,3949,-5.63%
2926707,2906,Centro Sul Baiano,29023,Seabra,Rio de Contas,BA,12749,13628,14068,13935,13447,12979,6221,6758,6300,6679,-0.71%
2926806,2906,Centro Sul Baiano,29027,Brumado,Rio do Antônio,BA,8838,11821,13322,14637,15096,14786,7424,7362,5976,8810,0.10%
2926905,2906,Centro Sul Baiano,29025,Livramento do Brumado,Rio do Pires,BA,10801,10637,12101,12010,11385,11923,5935,5988,5267,6656,-0.07%
2927002,2904,Nordeste Baiano,29017,Alagoinhas,Rio Real,BA,15873,19061,27783,33260,36169,37127,18628,18499,23302,13825,1.11%
2927101,2902,Vale São-Franciscano da Bahia,29005,Paulo Afonso,Rodelas,BA,4002,4486,4298,6260,7023,7779,3844,3935,6542,1237,2.20%
2927200,2903,Centro Norte Baiano,29011,Itaberaba,Ruy Barbosa,BA,30948,31458,30052,29026,29358,29869,14542,15327,22070,7799,0.29%
2927309,2905,Metropolitana de Salvador,29020,Santo Antônio de Jesus,Salinas da Margarida,BA,6366,7765,8891,10377,13090,13465,6558,6907,5972,7493,2.64%
2927408,2905,Metropolitana de Salvador,29021,Salvador,Salvador,BA,1007195,1502013,2075273,2443107,2892625,2676606,1249301,1427305,2675875,731,0.92%
2927507,2903,Centro Norte Baiano,29012,Feira de Santana,Santa Bárbara,BA,14789,15181,16768,17933,19440,19064,9301,9763,8669,10395,0.61%
2927606,2904,Nordeste Baiano,29013,Jeremoabo,Santa Brígida,BA,6599,9271,13290,16903,15483,15059,7709,7350,5617,9442,-1.15%
2927705,2907,Sul Baiano,29032,Porto Seguro,Santa Cruz Cabrália,BA,27171,49375,6535,23888,25110,26198,13316,12882,18993,7205,0.93%
2927804,2907,Sul Baiano,29031,Ilhéus-Itabuna,Santa Cruz da Vitória,BA,8238,6975,6653,7025,6386,6673,3422,3251,5076,1597,-0.51%
2927903,2906,Centro Sul Baiano,29024,Jequié,Santa Inês,BA,5836,8451,10048,11027,10564,10363,5135,5228,9514,849,-0.62%
2928000,2904,Nordeste Baiano,29016,Serrinha,Santaluz,BA,16312,23119,30634,30955,33633,33816,16616,17200,20801,13015,0.89%
2928059,2907,Sul Baiano,29031,Ilhéus-Itabuna,Santa Luzia,BA,,,16319,15503,15184,13332,7051,6281,8072,5260,-1.50%
2928109,2901,Extremo Oeste Baiano,29003,Santa Maria da Vitória,Santa Maria da Vitória,BA,31216,38759,41528,41261,40571,40316,20341,19975,23820,16496,-0.23%
2928208,2901,Extremo Oeste Baiano,29003,Santa Maria da Vitória,Santana,BA,19118,21898,24669,24139,25947,24747,12549,12198,13483,11264,0.25%
2928307,2903,Centro Norte Baiano,29012,Feira de Santana,Santanópolis,BA,10598,9851,9330,8644,9199,8781,4254,4527,1684,7097,0.16%
2928406,2901,Extremo Oeste Baiano,29002,Cotegipe,Santa Rita de Cássia,BA,20627,26362,23240,24026,26135,26261,13577,12684,14912,11349,0.89%
2928505,2903,Centro Norte Baiano,29012,Feira de Santana,Santa Teresinha,BA,16879,17289,8860,8696,9914,9658,4826,4832,2334,7324,1.05%
2928604,2905,Metropolitana de Salvador,29020,Santo Antônio de Jesus,Santo Amaro,BA,46411,57937,54160,58414,58028,57811,27760,30051,44778,13033,-0.10%
2928703,2905,Metropolitana de Salvador,29020,Santo Antônio de Jesus,Santo Antônio de Jesus,BA,39726,51582,64331,77368,84256,90949,42986,47963,79271,11678,1.63%
2928802,2903,Centro Norte Baiano,29012,Feira de Santana,Santo Estêvão,BA,25410,30863,37007,41145,44532,47901,22939,24962,27707,20194,1.53%
2928901,2901,Extremo Oeste Baiano,29001,Barreiras,São Desidério,BA,12790,14926,18977,19006,25158,27692,14551,13141,8637,19055,3.84%
2928950,2904,Nordeste Baiano,29016,Serrinha,São Domingos,BA,,,10276,8526,8818,9221,4593,4628,5918,3303,0.79%
2929008,2905,Metropolitana de Salvador,29020,Santo Antônio de Jesus,São Félix,BA,13253,15241,12182,13699,15302,14099,6881,7218,9266,4833,0.29%
2929057,2901,Extremo Oeste Baiano,29003,Santa Maria da Vitória,São Félix do Coribe,BA,,,11916,11758,12815,13042,6534,6508,10582,2460,1.04%
2929107,2905,Metropolitana de Salvador,29020,Santo Antônio de Jesus,São Felipe,BA,19205,18680,20107,20228,20265,20305,10083,10222,9820,10485,0.04%
2929206,2905,Metropolitana de Salvador,29021,Salvador,São Francisco do Conde,BA,20738,17838,20238,26282,29829,33172,16216,16956,27412,5760,2.36%
2929255,2903,Centro Norte Baiano,29009,Irecê,São Gabriel,BA,,,17884,18412,18468,18419,9445,8974,10486,7933,0.00%
2929305,2903,Centro Norte Baiano,29012,Feira de Santana,São Gonçalo dos Campos,BA,21858,21715,24288,27000,29205,33289,16032,17257,16503,16786,2.12%
2929354,2907,Sul Baiano,29031,Ilhéus-Itabuna,São José da Vitória,BA,,,8768,6210,6095,5715,2902,2813,5162,553,-0.83%
2929370,2903,Centro Norte Baiano,29010,Jacobina,São José do Jacuípe,BA,,,14100,9233,10477,10213,5115,5098,6997,3216,1.01%
2929404,2906,Centro Sul Baiano,29024,Jequié,São Miguel das Matas,BA,10441,9772,9311,10020,10270,10414,5278,5136,3360,7054,0.39%
2929503,2905,Metropolitana de Salvador,29019,Catu,São Sebastião do Passé,BA,24871,32312,36825,39960,40321,42153,20708,21445,33112,9041,0.54%
2929602,2905,Metropolitana de Salvador,29020,Santo Antônio de Jesus,Sapeaçu,BA,12629,12937,15192,16450,16518,16597,7990,8607,8087,8510,0.09%
2929701,2904,Nordeste Baiano,29017,Alagoinhas,Sátiro Dias,BA,10649,12592,13679,17251,18104,18588,9371,9217,4326,14262,0.75%
2929750,2905,Metropolitana de Salvador,29020,Santo Antônio de Jesus,Saubara,BA,,,8016,10193,11051,11201,5480,5721,10948,253,0.95%
2929800,2903,Centro Norte Baiano,29010,Jacobina,Saúde,BA,7873,8476,11389,11488,11866,11847,5934,5913,6646,5201,0.31%
2929909,2906,Centro Sul Baiano,29023,Seabra,Seabra,BA,21881,23238,37859,39422,40543,41815,20690,21125,20292,21523,0.59%
2930006,2906,Centro Sul Baiano,29026,Guanambi,Sebastião Laranjeiras,BA,5859,6404,9090,9283,10712,10372,5256,5116,4084,6288,1.12%
2930105,2903,Centro Norte Baiano,29008,Senhor do Bonfim,Senhor do Bonfim,BA,46665,63834,83421,67723,72511,74431,36030,38401,57574,16857,0.95%
2930154,2902,Vale São-Franciscano da Bahia,29007,Bom Jesus da Lapa,Serra do Ramalho,BA,,,33164,32600,31130,31646,16381,15265,6282,25364,-0.30%
2930204,2902,Vale São-Franciscano da Bahia,29004,Juazeiro,Sento Sé,BA,22419,31674,28387,32461,36517,37431,19278,18153,21676,15755,1.43%
2930303,2901,Extremo Oeste Baiano,29003,Santa Maria da Vitória,Serra Dourada,BA,14885,16641,17473,18015,17422,18112,9243,8869,6002,12110,0.05%
2930402,2903,Centro Norte Baiano,29012,Feira de Santana,Serra Preta,BA,19233,19568,17656,17726,15149,15401,7587,7814,6920,8481,-1.40%
2930501,2904,Nordeste Baiano,29016,Serrinha,Serrinha,BA,47172,57467,76013,83206,71383,77285,37936,39349,47177,30108,-0.74%
2930600,2903,Centro Norte Baiano,29010,Jacobina,Serrolândia,BA,19812,22361,11812,12616,12120,12347,6042,6305,7282,5065,-0.22%
2930709,2905,Metropolitana de Salvador,29021,Salvador,Simões Filho,BA,22019,43571,72526,94066,109269,118020,57978,60042,105808,12212,2.29%
2930758,2902,Vale São-Franciscano da Bahia,29007,Bom Jesus da Lapa,Sítio do Mato,BA,,,8699,11752,12567,12051,6267,5784,6866,5185,0.25%
2930766,2904,Nordeste Baiano,29013,Jeremoabo,Sítio do Quinto,BA,,,12050,17031,14069,12603,6291,6312,5185,7418,-2.97%
2930774,2902,Vale São-Franciscano da Bahia,29004,Juazeiro,Sobradinho,BA,,,21208,21325,21315,21988,10793,11195,19999,1989,0.31%
2930808,2903,Centro Norte Baiano,29009,Irecê,Souto Soares,BA,9150,12279,18356,14795,18013,15899,8052,7847,6039,9860,0.72%
2930907,2901,Extremo Oeste Baiano,29002,Cotegipe,Tabocas do Brejo Velho,BA,8017,10669,11281,12619,12281,11428,5940,5488,3932,7496,-0.99%
2931004,2906,Centro Sul Baiano,29027,Brumado,Tanhaçu,BA,14132,13987,18310,20044,19591,20022,10077,9945,8299,11723,-0.01%
2931053,2906,Centro Sul Baiano,29022,Boquira,Tanque Novo,BA,,,12661,15771,15745,16133,8130,8003,7322,8811,0.23%
2931103,2903,Centro Norte Baiano,29012,Feira de Santana,Tanquinho,BA,7355,9827,10280,7460,7589,8008,3976,4032,5711,2297,0.71%
2931202,2907,Sul Baiano,29030,Valença,Taperoá,BA,8758,12132,17046,15933,18217,18791,9606,9185,8725,10066,1.66%
2931301,2903,Centro Norte Baiano,29011,Itaberaba,Tapiramutá,BA,6039,7953,13691,17061,17254,16528,8360,8168,12791,3737,-0.32%
2931350,2907,Sul Baiano,29032,Porto Seguro,Teixeira de Freitas,BA,,,85547,107486,118702,138491,68173,70318,129412,9079,2.57%
2931400,2903,Centro Norte Baiano,29012,Feira de Santana,Teodoro Sampaio,BA,10272,9750,9601,8884,8306,7895,3856,4039,6341,1554,-1.17%
2931509,2904,Nordeste Baiano,29016,Serrinha,Teofilândia,BA,12382,15095,21570,20432,20702,21484,10801,10683,6692,14792,0.50%
2931608,2907,Sul Baiano,29031,Ilhéus-Itabuna,Teolândia,BA,7997,9253,12433,12572,12429,14850,7734,7116,5068,9782,1.68%
2931707,2905,Metropolitana de Salvador,29019,Catu,Terra Nova,BA,11192,12337,12238,12875,12310,12806,6223,6583,11491,1315,-0.05%
2931806,2906,Centro Sul Baiano,29027,Brumado,Tremedal,BA,30369,34140,20867,21200,18483,17032,8535,8497,3937,13095,-2.17%
2931905,2904,Nordeste Baiano,29014,Euclides da Cunha,Tucano,BA,31753,36493,46618,50948,48740,52391,26248,26143,21947,30444,0.28%
2932002,2904,Nordeste Baiano,29014,Euclides da Cunha,Uauá,BA,17297,20298,24343,25993,24662,24302,12219,12083,10769,13533,-0.67%
2932101,2906,Centro Sul Baiano,29024,Jequié,Ubaíra,BA,16883,18206,20809,20595,20708,19759,10037,9722,8258,11501,-0.41%
2932200,2907,Sul Baiano,29031,Ilhéus-Itabuna,Ubaitaba,BA,11260,16030,21062,23854,20478,20697,10102,10595,17604,3093,-1.41%
2932309,2907,Sul Baiano,29031,Ilhéus-Itabuna,Ubatã,BA,17374,23248,25900,21803,24791,25015,12494,12521,17958,7057,1.38%
2932408,2903,Centro Norte Baiano,29009,Irecê,Uibaí,BA,11547,11606,13616,13614,13719,13655,6983,6672,8335,5320,0.03%
2932457,2903,Centro Norte Baiano,29008,Senhor do Bonfim,Umburanas,BA,,,11540,14140,16081,17010,8784,8226,7513,9497,1.87%
2932507,2907,Sul Baiano,29031,Ilhéus-Itabuna,Una,BA,22344,37601,23757,31261,25277,24106,12554,11552,15030,9076,-2.57%
2932606,2906,Centro Sul Baiano,29026,Guanambi,Urandi,BA,12371,13295,15974,16076,15822,16499,8343,8156,5946,10553,0.26%
2932705,2907,Sul Baiano,29031,Ilhéus-Itabuna,Uruçuca,BA,15123,21936,30763,20323,22070,19840,9860,9980,15779,4061,-0.24%
2932804,2906,Centro Sul Baiano,29023,Seabra,Utinga,BA,9290,16154,17048,16889,19229,18193,8944,9249,12817,5376,0.75%
2932903,2907,Sul Baiano,29030,Valença,Valença,BA,48038,66277,66931,77509,84931,88729,43564,45165,64401,24328,1.36%
2933000,2904,Nordeste Baiano,29016,Serrinha,Valente,BA,16993,21791,17830,19145,21512,24579,12162,12417,13491,11088,2.53%
2933059,2903,Centro Norte Baiano,29011,Itaberaba,Várzea da Roça,BA,,,13448,13633,14479,13787,6982,6805,6476,7311,0.11%
2933109,2903,Centro Norte Baiano,29010,Jacobina,Várzea do Poço,BA,8504,9999,9633,7515,8569,8664,4357,4307,5789,2875,1.43%
2933158,2903,Centro Norte Baiano,29010,Jacobina,Várzea Nova,BA,,,17144,14154,13949,13127,6623,6504,8611,4516,-0.75%
2933174,2905,Metropolitana de Salvador,29020,Santo Antônio de Jesus,Varzedo,BA,,,8662,8673,9054,9121,4533,4588,3371,5750,0.50%
2933208,2905,Metropolitana de Salvador,29021,Salvador,Vera Cruz,BA,12003,13749,22136,29750,35060,37587,18733,18854,35264,2323,2.37%
2933257,2907,Sul Baiano,29032,Porto Seguro,Vereda,BA,,,8914,7450,7174,6802,3565,3237,1379,5423,-0.91%
2933307,2906,Centro Sul Baiano,29028,Vitória da Conquista,Vitória da Conquista,BA,125573,170619,225091,262494,308204,306374,147677,158697,274805,31569,1.56%
2933406,2906,Centro Sul Baiano,29023,Seabra,Wagner,BA,4920,5351,7834,8976,8610,8983,4498,4485,6482,2501,0.01%
2933455,2901,Extremo Oeste Baiano,29002,Cotegipe,Wanderley,BA,,,13637,13649,12982,12485,6496,5989,5878,6607,-0.89%
2933505,2907,Sul Baiano,29031,Ilhéus-Itabuna,Wenceslau Guimarães,BA,15235,16302,17254,23926,23985,22181,11458,10723,7512,14669,-0.75%
2933604,2902,Vale São-Franciscano da Bahia,29006,Barra,Xique-Xique,BA,30879,42321,40373,44718,45700,45562,22536,23026,32552,13010,0.19%
2300101,2307,Sul Cearense,23033,Brejo Santo,Abaiara,CE,6838,6542,7889,8385,10227,10489,5215,5274,4552,5937,2.26%
2300150,2302,Norte Cearense,23013,Baturité,Acarape,CE,,,10191,12927,14658,15337,7570,7767,7982,7355,1.72%
2300200,2301,Noroeste Cearense,23001,Litoral de Camocim e Acaraú,Acaraú,CE,62857,71897,45505,48968,52123,57542,29093,28449,28237,29305,1.63%
2300309,2304,Sertões Cearenses,23021,Sertão de Senador Pompeu,Acopiara,CE,48292,52047,49259,47137,48703,51171,25629,25542,25237,25934,0.82%
2300408,2304,Sertões Cearenses,23020,Sertão de Inhamuns,Aiuaba,CE,14462,15548,13219,14452,15585,16207,8119,8088,3955,12252,1.15%
2300507,2301,Noroeste Cearense,23004,Meruoca,Alcântaras,CE,9554,9336,8606,9548,10270,10773,5315,5458,3450,7323,1.21%
2300606,2307,Sul Cearense,23030,Caririaçu,Altaneira,CE,3405,4422,4806,5687,6417,6851,3313,3538,4952,1899,1.88%
2300705,2305,Jaguaribe,23023,Baixo Jaguaribe,Alto Santo,CE,11904,12950,13610,15394,19154,16360,8218,8142,8040,8320,0.61%
2300754,2302,Norte Cearense,23008,Itapipoca,Amontada,CE,,,25161,32333,37513,39233,20360,18873,15949,23284,1.95%
2300804,2306,Centro-Sul Cearense,23027,Várzea Alegre,Antonina do Norte,CE,5289,5463,5086,6509,6761,6984,3344,3640,4999,1985,0.71%
2300903,2302,Norte Cearense,23011,Médio Curu,Apuiarés,CE,9749,9234,9516,12540,13649,13927,7073,6854,5774,8153,1.05%
2301000,2303,Metropolitana de Fortaleza,23016,Fortaleza,Aquiraz,CE,32507,45112,46305,60469,67265,72651,37142,35509,67103,5548,1.85%
2301109,2305,Jaguaribe,23022,Litoral de Aracati,Aracati,CE,50120,61145,60687,61187,66049,69167,34152,35015,44038,25129,1.23%
2301208,2302,Norte Cearense,23013,Baturité,Aracoiaba,CE,33902,35257,22508,24064,24423,25405,12795,12610,13745,11660,0.54%
2301257,2304,Sertões Cearenses,23018,Sertão de Cratéus,Ararendá,CE,,,,10008,10649,10500,5183,5317,4908,5592,0.48%
2301307,2307,Sul Cearense,23029,Chapada do Araripe,Araripe,CE,13814,14858,17409,19606,21214,20689,10292,10397,12737,7952,0.54%
2301406,2302,Norte Cearense,23013,Baturité,Aratuba,CE,10558,12433,10578,12359,12129,11529,5823,5706,3769,7760,-0.69%
2301505,2304,Sertões Cearenses,23020,Sertão de Inhamuns,Arneiroz,CE,6768,7023,7387,7538,7302,7657,3853,3804,3884,3773,0.16%
2301604,2307,Sul Cearense,23029,Chapada do Araripe,Assaré,CE,29117,29569,19610,20882,21616,22448,11081,11367,11955,10493,0.73%
2301703,2307,Sul Cearense,23031,Barro,Aurora,CE,24599,25060,24491,25207,24480,24573,12223,12350,11830,12743,-0.25%
2301802,2306,Centro-Sul Cearense,23028,Lavras da Mangabeira,Baixio,CE,4997,5299,5412,5724,5780,6026,3055,2971,3304,2722,0.52%
2301851,2304,Sertões Cearenses,23019,Sertão de Quixeramobim,Banabuiú,CE,,,14364,16173,17448,17320,8739,8581,8760,8560,0.69%
2301901,2307,Sul Cearense,23032,Cariri,Barbalha,CE,25370,30955,38430,47031,50386,55373,26939,28434,38039,17334,1.65%
2301950,2302,Norte Cearense,23014,Chorozinho,Barreira,CE,,,14759,17024,18453,19574,9736,9838,8127,11447,1.41%
2302008,2307,Sul Cearense,23031,Barro,Barro,CE,17497,19023,19375,20007,20673,21528,10632,10896,13168,8360,0.74%
2302057,2301,Noroeste Cearense,23001,Litoral de Camocim e Acaraú,Barroquinha,CE,,,12929,13921,14812,14475,7319,7156,9771,4704,0.39%
2302107,2302,Norte Cearense,23013,Baturité,Baturité,CE,22220,24450,27147,29861,31669,33326,16402,16924,24446,8880,1.10%
2302206,2302,Norte Cearense,23015,Cascavel,Beberibe,CE,29373,35466,36801,42343,46155,49334,24860,24474,21639,27695,1.54%
2302305,2301,Noroeste Cearense,23001,Litoral de Camocim e Acaraú,Bela Cruz,CE,18319,21871,25966,28358,29566,30873,15698,15175,12992,17881,0.85%
2302404,2304,Sertões Cearenses,23019,Sertão de Quixeramobim,Boa Viagem,CE,41825,46562,47918,50306,53538,52521,26347,26174,26622,25899,0.43%
2302503,2307,Sul Cearense,23033,Brejo Santo,Brejo Santo,CE,21752,26501,33721,38484,39613,45190,21913,23277,28048,17142,1.62%
2302602,2301,Noroeste Cearense,23001,Litoral de Camocim e Acaraú,Camocim,CE,35736,46004,51035,55448,58470,60163,29769,30394,44647,15516,0.82%
2302701,2307,Sul Cearense,23029,Chapada do Araripe,Campos Sales,CE,31694,32121,23282,25566,25553,26510,12707,13803,19085,7425,0.36%
2302800,2302,Norte Cearense,23012,Canindé,Canindé,CE,50652,58178,61827,69601,73878,74486,36920,37566,46878,27608,0.68%
2302909,2302,Norte Cearense,23013,Baturité,Capistrano,CE,12568,15149,15559,15830,16403,17063,8637,8426,6212,10851,0.75%
2303006,2302,Norte Cearense,23012,Canindé,Caridade,CE,10301,11903,12432,15604,17977,20020,10123,9897,11523,8497,2.52%
2303105,2301,Noroeste Cearense,23005,Sobral,Cariré,CE,18410,18319,17747,18617,18527,18348,9143,9205,8302,10046,-0.15%
2303204,2307,Sul Cearense,23030,Caririaçu,Caririaçu,CE,23766,23530,21318,25733,26325,26387,12795,13592,14044,12343,0.25%
2303303,2306,Centro-Sul Cearense,23027,Várzea Alegre,Cariús,CE,18576,18152,17571,18444,18649,18567,9334,9233,8310,10257,0.07%
2303402,2301,Noroeste Cearense,23002,Ibiapaba,Carnaubal,CE,9655,11219,13625,15230,16001,16746,8346,8400,7960,8786,0.95%
2303501,2302,Norte Cearense,23015,Cascavel,Cascavel,CE,39028,47677,46507,57129,63932,66124,32874,33250,56143,9981,1.47%
2303600,2304,Sertões Cearenses,23020,Sertão de Inhamuns,Catarina,CE,9122,8924,11934,15547,17028,18745,9302,9443,8728,10017,1.89%
2303659,2301,Noroeste Cearense,23007,Santa Quitéria,Catunda,CE,,,,9286,10508,9951,5034,4917,5395,4556,0.69%
2303709,2303,Metropolitana de Fortaleza,23016,Fortaleza,Caucaia,CE,54754,94106,165099,250479,316906,324738,159175,165563,289918,34820,2.63%
2303808,2306,Centro-Sul Cearense,23026,Iguatu,Cedro,CE,22758,21753,22930,24062,24607,24538,12111,12427,15164,9374,0.20%
2303907,2301,Noroeste Cearense,23001,Litoral de Camocim e Acaraú,Chaval,CE,6876,8563,10560,12163,12215,12617,6195,6422,9170,3447,0.37%
2303931,2304,Sertões Cearenses,23019,Sertão de Quixeramobim,Choró,CE,,,,12001,12790,12853,6585,6268,3794,9059,0.69%
2303956,2302,Norte Cearense,23014,Chorozinho,Chorozinho,CE,,,15492,18707,18261,18920,9602,9318,11427,7493,0.11%
2304004,2301,Noroeste Cearense,23003,Coreaú,Coreaú,CE,14760,17325,17565,19981,21171,22018,10981,11037,14258,7760,0.98%
2304103,2304,Sertões Cearenses,23018,Sertão de Cratéus,Crateús,CE,62011,65869,66652,70898,72386,72853,35527,37326,52688,20165,0.27%
2304202,2307,Sul Cearense,23032,Cariri,Crato,CE,70996,80675,90519,104646,111198,121462,57632,63830,100937,20525,1.50%
2304236,2301,Noroeste Cearense,23002,Ibiapaba,Croatá,CE,,,14884,16064,17317,17077,8330,8747,9038,8039,0.61%
2304251,2301,Noroeste Cearense,23001,Litoral de Camocim e Acaraú,Cruz,CE,,,20098,19779,22144,22480,11092,11388,9570,12910,1.29%
2304269,2304,Sertões Cearenses,23021,Sertão de Senador Pompeu,Deputado Irapuan Pinheiro,CE,,,8441,8385,9108,9094,4560,4534,4131,4963,0.82%
2304277,2305,Jaguaribe,23025,Serra do Pereiro,Ererê,CE,,,6437,6302,6927,6853,3435,3418,3461,3392,0.84%
2304285,2303,Metropolitana de Fortaleza,23016,Fortaleza,Eusébio,CE,,,20410,31500,38189,46047,22957,23090,46047,0,3.87%
2304301,2307,Sul Cearense,23030,Caririaçu,Farias Brito,CE,17277,17362,17625,20315,19244,19007,9329,9678,8871,10136,-0.66%
2304350,2301,Noroeste Cearense,23005,Sobral,Forquilha,CE,,,15245,17488,20181,21786,10786,11000,15473,6313,2.22%
2304400,2303,Metropolitana de Fortaleza,23016,Fortaleza,Fortaleza,CE,857980,1307608,1768637,2141402,2431415,2447409,1145799,1301610,2447409,0,1.34%
2304459,2305,Jaguaribe,23022,Litoral de Aracati,Fortim,CE,,,,12066,14072,14851,7469,7382,9627,5224,2.10%
2304509,2301,Noroeste Cearense,23003,Coreaú,Frecheirinha,CE,8200,9176,9704,11832,12830,12991,6378,6613,7636,5355,0.94%
2304608,2302,Norte Cearense,23011,Médio Curu,General Sampaio,CE,4163,4753,5565,4866,6540,6216,3163,3053,3648,2568,2.48%
2304657,2301,Noroeste Cearense,23005,Sobral,Graça,CE,,,14365,14813,15297,15052,7441,7611,5818,9234,0.16%
2304707,2301,Noroeste Cearense,23001,Litoral de Camocim e Acaraú,Granja,CE,36053,39653,41501,48484,51410,52670,26725,25945,25902,26768,0.83%
2304806,2307,Sul Cearense,23030,Caririaçu,Granjeiro,CE,5771,4406,4743,5295,4931,4626,2265,2361,1369,3257,-1.34%
2304905,2301,Noroeste Cearense,23005,Sobral,Groaíras,CE,6290,7237,8079,8741,9456,10228,5045,5183,7076,3152,1.58%
2304954,2303,Metropolitana de Fortaleza,23016,Fortaleza,Guaiúba,CE,,,17562,19884,22405,24091,12140,11951,18877,5214,1.94%
2305001,2301,Noroeste Cearense,23002,Ibiapaba,Guaraciaba do Norte,CE,32140,36972,30312,35037,36705,37777,18661,19116,17405,20372,0.76%
2305100,2302,Norte Cearense,23013,Baturité,Guaramiranga,CE,6412,5423,5293,5714,4307,4165,2100,2065,2495,1670,-3.11%
2305209,2301,Noroeste Cearense,23007,Santa Quitéria,Hidrolândia,CE,17458,17679,17900,17687,18534,19342,9638,9704,11054,8288,0.90%
2305233,2303,Metropolitana de Fortaleza,23017,Pacajus,Horizonte,CE,,,18283,33790,48660,55154,27519,27635,51016,4138,5.02%
2305266,2304,Sertões Cearenses,23019,Sertão de Quixeramobim,Ibaretama,CE,,,11253,12561,12728,12928,6671,6257,4449,8479,0.29%
2305308,2301,Noroeste Cearense,23002,Ibiapaba,Ibiapina,CE,14863,16903,20031,22157,23088,23810,11942,11868,10743,13067,0.72%
2305332,2305,Jaguaribe,23023,Baixo Jaguaribe,Ibicuitinga,CE,,,8598,9435,11000,11335,5861,5474,5742,5593,1.85%
2305357,2305,Jaguaribe,23022,Litoral de Aracati,Icapuí,CE,,,13661,16052,18186,18393,9414,8979,5779,12614,1.37%
2305407,2306,Centro-Sul Cearense,23026,Iguatu,Icó,CE,41569,53342,60466,62521,63262,65453,31882,33571,30465,34988,0.46%
2305506,2306,Centro-Sul Cearense,23026,Iguatu,Iguatu,CE,75682,82946,75649,85615,92260,96523,46438,50085,74654,21869,1.21%
2305605,2304,Sertões Cearenses,23018,Sertão de Cratéus,Independência,CE,39075,43842,24031,25262,25413,25586,12746,12840,11480,14106,0.13%
2305654,2304,Sertões Cearenses,23018,Sertão de Cratéus,Ipaporanga,CE,,,10849,11247,11353,11335,5658,5677,4128,7207,0.08%
2305704,2306,Centro-Sul Cearense,23028,Lavras da Mangabeira,Ipaumirim,CE,10627,11112,11284,11539,11591,12014,5999,6015,7138,4876,0.40%
2305803,2301,Noroeste Cearense,23006,Ipu,Ipu,CE,42412,44191,35689,39078,39438,40300,19955,20345,25582,14718,0.31%
2305902,2301,Noroeste Cearense,23006,Ipu,Ipueiras,CE,30332,33322,35099,38219,38044,37874,18538,19336,18366,19508,-0.09%
2306009,2305,Jaguaribe,23025,Serra do Pereiro,Iracema,CE,20310,21119,14015,13155,14313,13725,6765,6960,9821,3904,0.43%
2306108,2301,Noroeste Cearense,23005,Sobral,Irauçuba,CE,15557,16396,17155,19560,21921,22347,11353,10994,14366,7981,1.34%
2306207,2305,Jaguaribe,23022,Litoral de Aracati,Itaiçaba,CE,4822,5311,5701,6579,7462,7321,3644,3677,4282,3039,1.07%
2306256,2303,Metropolitana de Fortaleza,23016,Fortaleza,Itaitinga,CE,,,,29217,31107,35838,18304,17534,35586,252,2.06%
2306306,2302,Norte Cearense,23010,Uruburetama,Itapagé,CE,33778,40664,33645,41093,45426,48366,23996,24370,34001,14365,1.64%
2306405,2302,Norte Cearense,23008,Itapipoca,Itapipoca,CE,94846,103815,77263,94369,107281,116065,58244,57821,66895,49170,2.09%
2306504,2302,Norte Cearense,23013,Baturité,Itapiúna,CE,13824,13222,12854,16276,17602,18626,9461,9165,8819,9807,1.36%
2306553,2301,Noroeste Cearense,23001,Litoral de Camocim e Acaraú,Itarema,CE,,,25548,30347,34296,37462,19345,18117,15937,21525,2.13%
2306603,2302,Norte Cearense,23012,Canindé,Itatira,CE,15990,15844,13853,15541,17689,18894,9588,9306,9522,9372,1.97%
2306702,2305,Jaguaribe,23024,Médio Jaguaribe,Jaguaretama,CE,16838,17194,17580,18024,17851,17867,9074,8793,8470,9397,-0.09%
2306801,2305,Jaguaribe,23024,Médio Jaguaribe,Jaguaribara,CE,8714,8131,7718,8730,9780,10405,5281,5124,7218,3187,1.77%
2306900,2305,Jaguaribe,23024,Médio Jaguaribe,Jaguaribe,CE,26161,28541,32340,35062,35237,34416,16824,17592,23278,11138,-0.19%
2307007,2305,Jaguaribe,23023,Baixo Jaguaribe,Jaguaruana,CE,22437,24900,25917,29735,30965,32239,16078,16161,19139,13100,0.81%
2307106,2307,Sul Cearense,23032,Cariri,Jardim,CE,19472,22514,23964,26414,25853,26697,13076,13621,8998,17699,0.11%
2307205,2307,Sul Cearense,23033,Brejo Santo,Jati,CE,5633,7708,6863,7265,7270,7649,3835,3814,4483,3166,0.52%
2307254,2301,Noroeste Cearense,23001,Litoral de Camocim e Acaraú,Jijoca de Jericoacoara,CE,,,,12089,15442,17002,8520,8482,5556,11446,3.47%
2307304,2307,Sul Cearense,23032,Cariri,Juazeiro do Norte,CE,96047,135620,173566,212133,242139,249936,118395,131541,240121,9815,1.65%
2307403,2306,Centro-Sul Cearense,23027,Várzea Alegre,Jucás,CE,21012,20507,21100,22632,22890,23809,11762,12047,14150,9659,0.51%
2307502,2306,Centro-Sul Cearense,23028,Lavras da Mangabeira,Lavras da Mangabeira,CE,30838,30525,30751,31203,29872,31096,15571,15525,18138,12958,-0.03%
2307601,2305,Jaguaribe,23023,Baixo Jaguaribe,Limoeiro do Norte,CE,25623,32754,41700,49620,53289,56281,27573,28708,32502,23779,1.27%
2307635,2304,Sertões Cearenses,23019,Sertão de Quixeramobim,Madalena,CE,,,12660,14864,17051,18085,9083,9002,8915,9170,1.98%
2307650,2303,Metropolitana de Fortaleza,23016,Fortaleza,Maracanaú,CE,,,157151,179732,197301,209748,102453,107295,208848,900,1.56%
2307700,2303,Metropolitana de Fortaleza,23016,Fortaleza,Maranguape,CE,59622,91137,71705,88135,102982,112926,56260,56666,86873,26053,2.51%
2307809,2301,Noroeste Cearense,23001,Litoral de Camocim e Acaraú,Marco,CE,12631,13928,20704,20427,23107,24707,12601,12106,15435,9272,1.92%
2307908,2301,Noroeste Cearense,23001,Litoral de Camocim e Acaraú,Martinópole,CE,5596,6981,6447,8602,10304,10220,5097,5123,8009,2211,1.74%
2308005,2301,Noroeste Cearense,23005,Sobral,Massapê,CE,21715,23224,23689,29574,33256,35201,17449,17752,23993,11208,1.76%
2308104,2307,Sul Cearense,23031,Barro,Mauriti,CE,31508,35747,37153,42399,41679,44217,22079,22138,23282,20935,0.42%
2308203,2301,Noroeste Cearense,23004,Meruoca,Meruoca,CE,10864,10489,10446,11339,12148,13693,6874,6819,7420,6273,1.90%
2308302,2307,Sul Cearense,23033,Brejo Santo,Milagres,CE,18910,20792,24187,26959,27355,28317,13932,14385,13558,14759,0.49%
2308351,2304,Sertões Cearenses,23021,Sertão de Senador Pompeu,Milhã,CE,,,12019,13028,14111,13078,6523,6555,5969,7109,0.04%
2308377,2301,Noroeste Cearense,23005,Sobral,Miraíma,CE,,,10052,11417,12131,12800,6607,6193,6847,5953,1.15%
2308401,2307,Sul Cearense,23032,Cariri,Missão Velha,CE,30087,28754,29228,32586,33690,34258,16894,17364,15413,18845,0.50%
2308500,2304,Sertões Cearenses,23021,Sertão de Senador Pompeu,Mombaça,CE,40789,46457,40833,41215,44364,42707,21256,21451,18828,23879,0.36%
2308609,2304,Sertões Cearenses,23018,Sertão de Cratéus,Monsenhor Tabosa,CE,13931,15852,15527,16344,16557,16706,8295,8411,9363,7343,0.22%
2308708,2305,Jaguaribe,23023,Baixo Jaguaribe,Morada Nova,CE,53552,64533,58912,64400,61751,62086,31147,30939,35412,26674,-0.37%
2308807,2301,Noroeste Cearense,23003,Coreaú,Moraújo,CE,6184,7936,6272,7046,8005,8069,4069,4000,3603,4466,1.36%
2308906,2301,Noroeste Cearense,23001,Litoral de Camocim e Acaraú,Morrinhos,CE,12008,13581,14526,17928,21111,20703,10442,10261,9615,11088,1.45%
2309003,2301,Noroeste Cearense,23005,Sobral,Mucambo,CE,10887,12137,11952,13811,14007,14102,6699,7403,9066,5036,0.21%
2309102,2302,Norte Cearense,23013,Baturité,Mulungu,CE,8382,7429,7842,8897,10975,11485,5842,5643,4198,7287,2.59%
2309201,2307,Sul Cearense,23032,Cariri,Nova Olinda,CE,9862,9769,11354,12077,12974,14256,7020,7236,9696,4560,1.67%
2309300,2304,Sertões Cearenses,23018,Sertão de Cratéus,Nova Russas,CE,41052,46602,37832,29347,30615,30977,15030,15947,23256,7721,0.54%
2309409,2304,Sertões Cearenses,23018,Sertão de Cratéus,Novo Oriente,CE,17361,24694,26318,26119,27418,27461,13552,13909,14237,13224,0.50%
2309458,2302,Norte Cearense,23014,Chorozinho,Ocara,CE,,,19828,21584,23359,24012,12318,11694,7605,16407,1.07%
2309508,2306,Centro-Sul Cearense,23026,Iguatu,Orós,CE,17515,19104,22014,22023,21268,21392,10424,10968,16026,5366,-0.29%
2309607,2303,Metropolitana de Fortaleza,23017,Pacajus,Pacajus,CE,33335,46981,31800,44070,54881,61846,30375,31471,50681,11165,3.45%
2309706,2303,Metropolitana de Fortaleza,23016,Fortaleza,Pacatuba,CE,31916,42106,60148,51696,65772,72249,35581,36668,62061,10188,3.40%
2309805,2302,Norte Cearense,23013,Baturité,Pacoti,CE,11273,10186,10100,10929,11097,11607,5851,5756,4745,6862,0.60%
2309904,2301,Noroeste Cearense,23005,Sobral,Pacujá,CE,3772,4301,5006,5653,5950,5986,2902,3084,3723,2263,0.57%
2310001,2305,Jaguaribe,23023,Baixo Jaguaribe,Palhano,CE,5106,7105,7946,8166,8797,8869,4471,4398,4518,4351,0.83%
2310100,2302,Norte Cearense,23013,Baturité,Palmácia,CE,11295,10391,10236,9859,10352,12005,6002,6003,4957,7048,1.99%
2310209,2302,Norte Cearense,23009,Baixo Curu,Paracuru,CE,24522,28610,20942,27541,30665,31638,15856,15782,20590,11048,1.40%
2310258,2302,Norte Cearense,23009,Baixo Curu,Paraipaba,CE,,,19791,25462,28192,30041,15291,14750,13435,16606,1.67%
2310308,2304,Sertões Cearenses,23020,Sertão de Inhamuns,Parambu,CE,21925,29547,30079,32302,30596,31320,15269,16051,14115,17205,-0.31%
2310407,2302,Norte Cearense,23012,Canindé,Paramoti,CE,10628,9802,10447,10970,11573,11308,5814,5494,5540,5768,0.30%
2310506,2304,Sertões Cearenses,23021,Sertão de Senador Pompeu,Pedra Branca,CE,31558,35770,38800,40742,40762,41942,20705,21237,24549,17393,0.29%
2310605,2307,Sul Cearense,23033,Brejo Santo,Penaforte,CE,4798,5536,6435,7017,7715,8226,4044,4182,6399,1827,1.60%
2310704,2302,Norte Cearense,23011,Médio Curu,Pentecoste,CE,34620,32127,32252,32600,33717,35412,17902,17510,21406,14006,0.83%
2310803,2305,Jaguaribe,23025,Serra do Pereiro,Pereiro,CE,20609,21568,14792,15225,15291,15764,7766,7998,5433,10331,0.35%
2310852,2302,Norte Cearense,23015,Cascavel,Pindoretama,CE,,,12442,14951,17143,18691,9345,9346,11289,7402,2.26%
2310902,2304,Sertões Cearenses,23021,Sertão de Senador Pompeu,Piquet Carneiro,CE,15305,15402,13097,13131,14736,15501,7804,7697,7451,8050,1.67%
2310951,2301,Noroeste Cearense,23006,Ipu,Pires Ferreira,CE,,,9472,8643,9483,10216,5139,5077,3354,6862,1.69%
2311009,2301,Noroeste Cearense,23006,Ipu,Poranga,CE,7369,9808,11057,11737,11905,12003,5976,6027,7800,4203,0.22%
2311108,2307,Sul Cearense,23032,Cariri,Porteiras,CE,12576,13768,15027,15658,14792,15065,7370,7695,6179,8886,-0.39%
2311207,2307,Sul Cearense,23029,Chapada do Araripe,Potengi,CE,7001,7217,8148,9138,9670,10276,4987,5289,5714,4562,1.18%
2311231,2305,Jaguaribe,23025,Serra do Pereiro,Potiretama,CE,,,5784,5768,6478,6129,3161,2968,2707,3422,0.61%
2311264,2304,Sertões Cearenses,23018,Sertão de Cratéus,Quiterianópolis,CE,,,17345,18355,20079,19918,9853,10065,6305,13613,0.82%
2311306,2304,Sertões Cearenses,23019,Sertão de Quixeramobim,Quixadá,CE,98509,99290,72224,69654,76105,80605,39768,40837,57482,23123,1.47%
2311355,2306,Centro-Sul Cearense,23026,Iguatu,Quixelô,CE,,,15679,15596,15708,15000,7549,7451,4929,10071,-0.39%
2311405,2304,Sertões Cearenses,23019,Sertão de Quixeramobim,Quixeramobim,CE,66740,66163,59100,59235,68966,71912,35739,36173,43446,28466,1.96%
2311504,2305,Jaguaribe,23023,Baixo Jaguaribe,Quixeré,CE,11221,12485,13801,16862,18652,19422,9712,9710,11936,7486,1.42%
2311603,2302,Norte Cearense,23013,Baturité,Redenção,CE,37669,42642,22757,24993,25702,26423,13133,13290,15142,11281,0.56%
2311702,2301,Noroeste Cearense,23006,Ipu,Reriutaba,CE,27997,29244,17305,21224,19310,19460,9683,9777,10590,8870,-0.86%
2311801,2305,Jaguaribe,23023,Baixo Jaguaribe,Russas,CE,34239,38513,46566,57320,63975,69892,34430,35462,45007,24885,2.00%
2311900,2304,Sertões Cearenses,23020,Sertão de Inhamuns,Saboeiro,CE,16183,16894,15461,16226,16282,15754,7763,7991,8457,7297,-0.29%
2311959,2307,Sul Cearense,23029,Chapada do Araripe,Salitre,CE,,,12645,13925,15798,15453,7770,7683,6263,9190,1.05%
2312007,2301,Noroeste Cearense,23005,Sobral,Santana do Acaraú,CE,22537,23730,22447,26198,28741,29977,15182,14795,15402,14575,1.36%
2312106,2307,Sul Cearense,23032,Cariri,Santana do Cariri,CE,15975,16608,15403,16847,17574,17181,8641,8540,8824,8357,0.20%
2312205,2301,Noroeste Cearense,23007,Santa Quitéria,Santa Quitéria,CE,42778,52263,49343,42375,43344,42759,21436,21323,22257,20502,0.09%
2312304,2301,Noroeste Cearense,23002,Ibiapaba,São Benedito,CE,41076,43759,36700,39894,43077,44186,21832,22354,24556,19630,1.03%
2312403,2302,Norte Cearense,23009,Baixo Curu,São Gonçalo do Amarante,CE,21003,24694,29286,35608,40312,43947,22382,21565,28581,15366,2.13%
2312502,2305,Jaguaribe,23023,Baixo Jaguaribe,São João do Jaguaribe,CE,7723,8335,8018,8650,8310,7902,3853,4049,3169,4733,-0.90%
2312601,2302,Norte Cearense,23011,Médio Curu,São Luís do Curu,CE,7888,8149,10609,11497,12052,12336,6145,6191,7963,4373,0.71%
2312700,2304,Sertões Cearenses,23021,Sertão de Senador Pompeu,Senador Pompeu,CE,24693,26900,26597,27225,25290,26494,13033,13461,15715,10779,-0.27%
2312809,2301,Noroeste Cearense,23005,Sobral,Senador Sá,CE,4582,4602,5175,5605,6274,6852,3431,3421,5068,1784,2.03%
2312908,2301,Noroeste Cearense,23005,Sobral,Sobral,CE,102197,118024,127489,155276,176895,188271,91475,96796,166333,21938,1.95%
2313005,2304,Sertões Cearenses,23021,Sertão de Senador Pompeu,Solonópole,CE,34085,37255,15831,16902,17340,17657,8831,8826,9102,8555,0.44%
2313104,2305,Jaguaribe,23023,Baixo Jaguaribe,Tabuleiro do Norte,CE,19421,23243,25106,27098,28291,29210,14217,14993,18812,10398,0.75%
2313203,2304,Sertões Cearenses,23018,Sertão de Cratéus,Tamboril,CE,21065,25923,26260,25973,25459,25455,12633,12822,14206,11249,-0.20%
2313252,2306,Centro-Sul Cearense,23027,Várzea Alegre,Tarrafas,CE,,,10113,9213,8734,8910,4452,4458,2624,6286,-0.33%
2313302,2304,Sertões Cearenses,23020,Sertão de Inhamuns,Tauá,CE,44855,46670,51339,51948,54273,55755,27366,28389,32280,23475,0.71%
2313351,2302,Norte Cearense,23011,Médio Curu,Tejuçuoca,CE,,,11805,13519,15062,16836,8611,8225,6333,10503,2.22%
2313401,2301,Noroeste Cearense,23002,Ibiapaba,Tianguá,CE,26200,34287,44005,58069,64612,68901,34179,34722,45828,23073,1.73%
2313500,2302,Norte Cearense,23008,Itapipoca,Trairi,CE,26423,29919,36344,44527,48620,51432,26443,24989,18787,32645,1.45%
2313559,2302,Norte Cearense,23010,Uruburetama,Tururu,CE,,,9916,11498,13350,14415,7474,6941,5295,9120,2.29%
2313609,2301,Noroeste Cearense,23002,Ibiapaba,Ubajara,CE,17700,20346,23374,27095,29569,31792,15764,16028,15350,16442,1.61%
2313708,2306,Centro-Sul Cearense,23028,Lavras da Mangabeira,Umari,CE,7471,8189,7896,7435,7591,7545,3772,3773,3918,3627,0.15%
2313757,2302,Norte Cearense,23010,Uruburetama,Umirim,CE,,,15331,17343,18195,18807,9643,9164,11096,7711,0.81%
2313807,2302,Norte Cearense,23010,Uruburetama,Uruburetama,CE,30033,35164,13518,16444,19218,19765,9928,9837,14686,5079,1.86%
2313906,2301,Noroeste Cearense,23003,Coreaú,Uruoca,CE,10874,10600,10220,11479,12973,12894,6503,6391,7671,5223,1.17%
2313955,2301,Noroeste Cearense,23006,Ipu,Varjota,CE,,,13465,16593,17087,17584,8701,8883,14413,3171,0.58%
2314003,2306,Centro-Sul Cearense,23027,Várzea Alegre,Várzea Alegre,CE,27423,29785,31331,34844,37740,38442,18664,19778,23898,14544,0.99%
2314102,2301,Noroeste Cearense,23002,Ibiapaba,Viçosa do Ceará,CE,33859,37200,40865,45427,52855,54961,27668,27293,17827,37134,1.92%
,,,,,Cococi,CE,4163,,,,,,,,,,-
5300108,5301,Distrito Federal,53001,Brasília,Brasília,DF,537492,1176908,1601094,2051146,2455903,2562963,1225237,1337726,2476249,86714,2.25%
3200102,3203,Central Espírito-santense,32007,Afonso Cláudio,Afonso Cláudio,ES,47383,48288,40001,32232,30773,31086,15684,15402,15861,15225,-0.36%
3200136,3201,Noroeste Espírito-santense,32002,Nova Venécia,Águia Branca,ES,,,9820,9599,9281,9517,4900,4617,3051,6466,-0.09%
3200169,3201,Noroeste Espírito-santense,32001,Barra de São Francisco,Água Doce do Norte,ES,,,12701,12751,11934,11771,5956,5815,6699,5072,-0.80%
3200201,3204,Sul Espírito-santense,32011,Alegre,Alegre,ES,40312,33519,30422,31714,30473,30784,15288,15496,21521,9263,-0.30%
3200300,3203,Central Espírito-santense,32010,Guarapari,Alfredo Chaves,ES,10290,10726,12647,13616,13983,13960,7107,6853,6557,7403,0.25%
3200359,3201,Noroeste Espírito-santense,32003,Colatina,Alto Rio Novo,ES,,,7488,6964,6198,7303,3658,3645,4239,3064,0.48%
3200409,3203,Central Espírito-santense,32010,Guarapari,Anchieta,ES,11361,11413,14934,19176,19459,23894,12057,11837,18153,5741,2.22%
3200508,3204,Sul Espírito-santense,32012,Cachoeiro de Itapemirim,Apiacá,ES,7366,6510,6995,7615,7617,7513,3779,3734,5212,2301,-0.13%
3200607,3202,Litoral Norte Espírito-santense,32006,Linhares,Aracruz,ES,26507,35791,52433,64637,73358,81746,40768,40978,71407,10339,2.38%
3200706,3204,Sul Espírito-santense,32012,Cachoeiro de Itapemirim,Atilio Vivacqua,ES,7112,5952,6666,8327,8878,9840,4990,4850,6114,3726,1.68%
3200805,3201,Noroeste Espírito-santense,32003,Colatina,Baixo Guandu,ES,26958,25933,27121,27819,28637,29086,14220,14866,22519,6567,0.45%
3200904,3201,Noroeste Espírito-santense,32001,Barra de São Francisco,Barra de São Francisco,ES,54069,51519,35738,37597,39627,40610,20373,20237,26340,14270,0.77%
3201001,3201,Noroeste Espírito-santense,32002,Nova Venécia,Boa Esperança,ES,10534,11109,12555,13679,12912,14199,7180,7019,10239,3960,0.37%
3201100,3204,Sul Espírito-santense,32012,Cachoeiro de Itapemirim,Bom Jesus do Norte,ES,5190,6573,7963,9226,9318,9479,4582,4897,8702,777,0.27%
3201159,3203,Central Espírito-santense,32007,Afonso Cláudio,Brejetuba,ES,,,,11687,10949,11921,6217,5704,3417,8504,0.20%
3201209,3204,Sul Espírito-santense,32012,Cachoeiro de Itapemirim,Cachoeiro de Itapemirim,ES,100010,123686,143449,174879,195288,189878,92751,97127,173572,16306,0.83%
3201308,3203,Central Espírito-santense,32009,Vitória,Cariacica,ES,101422,189099,274532,324285,356536,348933,169982,178951,337822,11111,0.74%
3201407,3204,Sul Espírito-santense,32012,Cachoeiro de Itapemirim,Castelo,ES,25759,25885,29592,32756,32250,34826,17429,17397,21879,12947,0.61%
3201506,3201,Noroeste Espírito-santense,32003,Colatina,Colatina,ES,105096,111678,106845,112711,106637,111794,54303,57491,98395,13399,-0.08%
3201605,3202,Litoral Norte Espírito-santense,32005,São Mateus,Conceição da Barra,ES,32078,28384,22282,26494,26230,28477,14178,14299,22591,5886,0.72%
3201704,3203,Central Espírito-santense,32007,Afonso Cláudio,Conceição do Castelo,ES,14992,17324,10533,10910,11326,11686,5941,5745,5902,5784,0.69%
3201803,3204,Sul Espírito-santense,32011,Alegre,Divino de São Lourenço,ES,3933,3419,4090,4817,4837,4515,2351,2164,1742,2773,-0.65%
3201902,3203,Central Espírito-santense,32007,Afonso Cláudio,Domingos Martins,ES,24453,27584,35598,30559,31175,31824,16068,15756,7741,24083,0.41%
3202009,3204,Sul Espírito-santense,32011,Alegre,Dores do Rio Preto,ES,3721,4008,5265,6188,6106,6399,3222,3177,3542,2857,0.34%
3202108,3201,Noroeste Espírito-santense,32001,Barra de São Francisco,Ecoporanga,ES,47501,31399,24432,23979,23296,23223,11566,11657,14776,8447,-0.32%
3202207,3202,Litoral Norte Espírito-santense,32006,Linhares,Fundão,ES,8170,9215,10204,13009,15209,17028,8493,8535,14382,2646,2.73%
3202256,3201,Noroeste Espírito-santense,32003,Colatina,Governador Lindenberg,ES,,,,,9890,10874,5673,5201,4234,6640,-
3202306,3204,Sul Espírito-santense,32011,Alegre,Guaçuí,ES,16715,19405,21964,25492,25761,27853,13686,14167,22403,5450,0.89%
3202405,3203,Central Espírito-santense,32010,Guarapari,Guarapari,ES,24105,38500,61719,88400,98073,105227,51424,53803,100268,4959,1.76%
3202454,3204,Sul Espírito-santense,32011,Alegre,Ibatiba,ES,,,15558,19210,19649,22346,11293,11053,13358,8988,1.52%
3202504,3202,Litoral Norte Espírito-santense,32006,Linhares,Ibiraçu,ES,17064,20234,9405,10143,10312,11158,5518,5640,8451,2707,0.96%
3202553,3204,Sul Espírito-santense,32011,Alegre,Ibitirama,ES,,,7655,9211,8994,8964,4657,4307,3179,5785,-0.27%
3202603,3203,Central Espírito-santense,32010,Guarapari,Iconha,ES,7604,8282,10172,11481,11496,12514,6410,6104,7273,5241,0.87%
3202652,3204,Sul Espírito-santense,32011,Alegre,Irupi,ES,,,,10354,10369,11729,6032,5697,4440,7289,1.25%
3202702,3203,Central Espírito-santense,32008,Santa Teresa,Itaguaçu,ES,12015,13266,13393,14495,13881,14134,7197,6937,8054,6080,-0.25%
3202801,3204,Sul Espírito-santense,32013,Itapemirim,Itapemirim,ES,28558,35113,44492,28121,30833,30988,15537,15451,19325,11663,0.98%
3202900,3203,Central Espírito-santense,32008,Santa Teresa,Itarana,ES,8760,8925,10394,11425,10569,10881,5455,5426,4095,6786,-0.49%
3203007,3204,Sul Espírito-santense,32011,Alegre,Iúna,ES,31876,37622,32508,26112,25533,27340,13649,13691,15640,11700,0.46%
3203056,3202,Litoral Norte Espírito-santense,32005,São Mateus,Jaguaré,ES,,,17050,19539,21949,24718,12486,12232,15056,9662,2.38%
3203106,3204,Sul Espírito-santense,32012,Cachoeiro de Itapemirim,Jerônimo Monteiro,ES,7268,8291,8898,10189,10701,10888,5298,5590,8540,2348,0.67%
3203130,3202,Litoral Norte Espírito-santense,32006,Linhares,João Neiva,ES,,,13472,15301,14403,15808,7805,8003,12755,3053,0.33%
3203163,3203,Central Espírito-santense,32007,Afonso Cláudio,Laranja da Terra,ES,,,10635,10934,10802,10825,5523,5302,3527,7298,-0.10%
3203205,3202,Litoral Norte Espírito-santense,32006,Linhares,Linhares,ES,92329,123163,119690,112617,124564,141254,70366,70888,121503,19751,2.29%
3203304,3201,Noroeste Espírito-santense,32001,Barra de São Francisco,Mantenópolis,ES,12105,13631,13935,12201,11463,13600,6816,6784,8653,4947,1.09%
3203320,3204,Sul Espírito-santense,32013,Itapemirim,Marataízes,ES,,,,30603,31221,34147,16880,17267,27619,6528,1.10%
3203346,3203,Central Espírito-santense,32007,Afonso Cláudio,Marechal Floriano,ES,,,,12188,12699,14249,7251,6998,7408,6841,1.57%
3203353,3201,Noroeste Espírito-santense,32003,Colatina,Marilândia,ES,,,9004,9924,10226,11107,5572,5535,5648,5459,1.13%
3203403,3204,Sul Espírito-santense,32012,Cachoeiro de Itapemirim,Mimoso do Sul,ES,23778,23275,24041,26199,26208,25898,13039,12859,16226,9672,-0.12%
3203502,3202,Litoral Norte Espírito-santense,32004,Montanha,Montanha,ES,13363,17394,18133,17263,17998,17854,8977,8877,13525,4329,0.34%
3203601,3202,Litoral Norte Espírito-santense,32004,Montanha,Mucurici,ES,19825,11531,11331,5900,5755,5672,2877,2795,3599,2073,-0.39%
3203700,3204,Sul Espírito-santense,32011,Alegre,Muniz Freire,ES,18799,18964,20156,19689,18196,18387,9305,9082,8669,9718,-0.68%
3203809,3204,Sul Espírito-santense,32012,Cachoeiro de Itapemirim,Muqui,ES,12666,12565,13619,13670,13841,14396,7255,7141,9309,5087,0.52%
3203908,3201,Noroeste Espírito-santense,32002,Nova Venécia,Nova Venécia,ES,47480,45660,47624,43015,44380,46020,23111,22909,30824,15196,0.68%
3204005,3201,Noroeste Espírito-santense,32003,Colatina,Pancas,ES,28117,30095,21004,20402,18465,21520,10995,10525,10082,11438,0.53%
3204054,3202,Litoral Norte Espírito-santense,32005,São Mateus,Pedro Canário,ES,,,21348,21961,23204,23789,11900,11889,22052,1737,0.80%
3204104,3202,Litoral Norte Espírito-santense,32004,Montanha,Pinheiros,ES,21153,20045,21307,21320,22663,23891,12002,11889,18714,5177,1.15%
3204203,3203,Central Espírito-santense,32010,Guarapari,Piúma,ES,3583,5345,9430,14987,16249,18123,8950,9173,17450,673,1.92%
3204252,3202,Litoral Norte Espírito-santense,32004,Montanha,Ponto Belo,ES,,,,6263,6831,6979,3493,3486,5588,1391,1.09%
3204302,3204,Sul Espírito-santense,32013,Itapemirim,Presidente Kennedy,ES,10789,9801,9433,9555,10307,10315,5253,5062,3440,6875,0.77%
3204351,3202,Litoral Norte Espírito-santense,32006,Linhares,Rio Bananal,ES,,,15428,16324,16587,17538,9076,8462,6796,10742,0.72%
3204401,3203,Central Espírito-santense,32010,Guarapari,Rio Novo do Sul,ES,9161,8900,10004,11271,11111,11333,5748,5585,5950,5383,0.05%
3204500,3203,Central Espírito-santense,32008,Santa Teresa,Santa Leopoldina,ES,21911,24664,11122,12463,12349,12255,6437,5818,2634,9621,-0.17%
3204559,3203,Central Espírito-santense,32008,Santa Teresa,Santa Maria de Jetibá,ES,,,23268,28774,31845,34178,17534,16644,11791,22387,1.74%
3204609,3203,Central Espírito-santense,32008,Santa Teresa,Santa Teresa,ES,25330,25991,29356,20622,20179,21815,10908,10907,11763,10052,0.56%
3204658,3201,Noroeste Espírito-santense,32003,Colatina,São Domingos do Norte,ES,,,,7547,7840,8016,4172,3844,3439,4577,0.60%
3204708,3201,Noroeste Espírito-santense,32002,Nova Venécia,São Gabriel da Palha,ES,35439,42296,30148,26588,28878,31859,15902,15957,24327,7532,1.83%
3204807,3204,Sul Espírito-santense,32012,Cachoeiro de Itapemirim,São José do Calçado,ES,9588,9141,10208,10481,10570,10417,5200,5217,8358,2059,-0.06%
3204906,3202,Litoral Norte Espírito-santense,32005,São Mateus,São Mateus,ES,41150,55080,73903,90460,96390,109067,53964,55103,84586,24481,1.89%
3204955,3203,Central Espírito-santense,32008,Santa Teresa,São Roque do Canaã,ES,,,,10395,10439,11287,5695,5592,5597,5690,0.83%
3205002,3203,Central Espírito-santense,32009,Vitória,Serra,ES,17286,82568,222158,321181,385370,409324,201407,207917,406517,2807,2.45%
3205010,3202,Litoral Norte Espírito-santense,32006,Linhares,Sooretama,ES,,,,18269,21867,23860,12142,11718,16882,6978,2.71%
3205036,3204,Sul Espírito-santense,32012,Cachoeiro de Itapemirim,Vargem Alta,ES,,,13082,17376,17862,19141,9832,9309,6724,12417,0.97%
3205069,3203,Central Espírito-santense,32007,Afonso Cláudio,Venda Nova do Imigrante,ES,,,12036,16165,18610,20468,10345,10123,14812,5656,2.39%
3205101,3203,Central Espírito-santense,32009,Vitória,Viana,ES,10529,23440,43866,53452,57539,64999,33167,31832,59640,5359,1.98%
3205150,3201,Noroeste Espírito-santense,32002,Nova Venécia,Vila Pavão,ES,,,,8330,8705,8672,4493,4179,2998,5674,0.40%
3205176,3201,Noroeste Espírito-santense,32002,Nova Venécia,Vila Valério,ES,,,,13875,13646,13830,7207,6623,5042,8788,-0.03%
3205200,3203,Central Espírito-santense,32009,Vitória,Vila Velha,ES,123742,203401,265586,345965,398068,414420,199083,215337,412402,2018,1.82%
3205309,3203,Central Espírito-santense,32009,Vitória,Vitória,ES,133019,207736,258777,292304,314042,325453,152630,172823,325453,0,1.08%
5200050,5203,Centro Goiano,52010,Goiânia,Abadia de Goiás,GO,,,,4971,5868,6868,3376,3492,5072,1796,3.29%
5200100,5204,Leste Goiano,52012,Entorno de Brasília,Abadiânia,GO,7772,9030,9402,11452,12640,15752,8088,7664,10773,4979,3.24%
5200134,5205,Sul Goiano,52014,Vale do Rio dos Bois,Acreúna,GO,,12319,14059,18301,18553,20283,10380,9903,17700,2583,1.03%
5200159,5203,Centro Goiano,52009,Anicuns,Adelândia,GO,,,2339,2460,2510,2483,1277,1206,2204,279,0.09%
5200175,5204,Leste Goiano,52012,Entorno de Brasília,Água Fria de Goiás,GO,,,3976,4469,5008,5095,2738,2357,2137,2958,1.32%
5200209,5205,Sul Goiano,52015,Meia Ponte,Água Limpa,GO,2627,2226,1937,2200,2074,2012,1048,964,1425,587,-0.89%
5200258,5204,Leste Goiano,52012,Entorno de Brasília,Águas Lindas de Goiás,GO,,,,105746,131884,159505,79813,79692,159265,240,4.20%
5200308,5204,Leste Goiano,52012,Entorno de Brasília,Alexânia,GO,9390,12116,16472,20047,20033,23828,12012,11816,19701,4127,1.74%
5200506,5205,Sul Goiano,52015,Meia Ponte,Aloândia,GO,3022,2233,1992,2128,2065,2044,1045,999,1764,280,-0.40%
5200555,5202,Norte Goiano,52004,Porangatu,Alto Horizonte,GO,,,,2564,3136,4505,2351,2154,3863,642,5.80%
5200605,5202,Norte Goiano,52005,Chapada dos Veadeiros,Alto Paraíso de Goiás,GO,2775,2721,4193,6182,6638,6864,3400,3464,5202,1662,1.05%
5200803,5204,Leste Goiano,52011,Vão do Paranã,Alvorada do Norte,GO,4113,6056,7391,7560,8217,8093,4113,3980,6882,1211,0.68%
5200829,5202,Norte Goiano,52004,Porangatu,Amaralina,GO,,,,3074,3492,3424,1828,1596,1093,2331,1.08%
5200852,5203,Centro Goiano,52009,Anicuns,Americano do Brasil,GO,,,4861,4933,4698,5508,2858,2650,4718,790,1.11%
5200902,5203,Centro Goiano,52008,Iporá,Amorinópolis,GO,6607,5348,4428,4145,3527,3607,1829,1778,2169,1438,-1.38%
5201108,5203,Centro Goiano,52007,Anápolis,Anápolis,GO,105029,180012,239378,288085,325544,335032,163467,171565,329170,5862,1.52%
5201207,5205,Sul Goiano,52017,Catalão,Anhanguera,GO,1079,732,869,895,966,1017,514,503,955,62,1.29%
5201306,5203,Centro Goiano,52009,Anicuns,Anicuns,GO,22733,23150,18206,18754,17705,20272,10429,9843,17332,2940,0.78%
5201405,5203,Centro Goiano,52010,Goiânia,Aparecida de Goiânia,GO,7470,42627,178483,336392,475303,455735,224841,230894,455264,471,3.08%
5201454,5205,Sul Goiano,52013,Sudoeste de Goiás,Aparecida do Rio Doce,GO,,,,2402,2702,2433,1243,1190,1954,479,0.13%
5201504,5205,Sul Goiano,52013,Sudoeste de Goiás,Aporé,GO,3174,2764,4979,3427,3554,3811,2010,1801,2546,1265,1.07%
5201603,5203,Centro Goiano,52007,Anápolis,Araçu,GO,4845,3908,3691,4127,3880,3785,1902,1883,3340,445,-0.86%
5201702,5201,Noroeste Goiano,52003,Aragarças,Aragarças,GO,4636,9690,13742,16592,17156,18310,9193,9117,17625,685,0.99%
5201801,5203,Centro Goiano,52010,Goiânia,Aragoiânia,GO,2848,3707,4910,6424,7243,8375,4275,4100,5529,2846,2.69%
5202155,5201,Noroeste Goiano,52002,Rio Vermelho,Araguapaz,GO,,,7372,7310,7482,7513,3860,3653,5204,2309,0.27%
5202353,5201,Noroeste Goiano,52003,Aragarças,Arenópolis,GO,,,4147,3999,3495,3278,1676,1602,1919,1359,-1.97%
5202502,5201,Noroeste Goiano,52002,Rio Vermelho,Aruanã,GO,4778,7293,4909,5095,6476,7506,3925,3581,6182,1324,3.95%
5202601,5203,Centro Goiano,52009,Anicuns,Aurilândia,GO,6780,4953,4265,4235,3719,3650,1839,1811,2800,850,-1.48%
5202809,5203,Centro Goiano,52009,Anicuns,Avelinópolis,GO,2928,2687,2336,2507,2375,2451,1236,1215,1876,575,-0.23%
5203104,5201,Noroeste Goiano,52003,Aragarças,Baliza,GO,2578,2783,4128,2270,3299,3714,2043,1671,1094,2620,5.05%
5203203,5203,Centro Goiano,52006,Ceres,Barro Alto,GO,7236,12021,9919,6251,6446,8701,4500,4201,6249,2452,3.36%
5203302,5203,Centro Goiano,52010,Goiânia,Bela Vista de Goiás,GO,14298,17255,17316,19210,20615,24539,12602,11937,17945,6594,2.48%
5203401,5201,Noroeste Goiano,52003,Aragarças,Bom Jardim de Goiás,GO,4257,7178,7986,8068,8372,8423,4304,4119,6349,2074,0.43%
5203500,5205,Sul Goiano,52015,Meia Ponte,Bom Jesus de Goiás,GO,10699,11623,13851,16257,19574,20729,10757,9972,19255,1474,2.46%
5203559,5203,Centro Goiano,52010,Goiânia,Bonfinópolis,GO,,,3324,5353,6744,7536,3777,3759,7021,515,3.48%
5203575,5202,Norte Goiano,52004,Porangatu,Bonópolis,GO,,,,2598,3160,3503,1834,1669,1301,2202,3.03%
5203609,5203,Centro Goiano,52007,Anápolis,Brazabrantes,GO,3132,2241,2334,2772,3142,3240,1649,1591,2179,1061,1.57%
5203807,5201,Noroeste Goiano,52002,Rio Vermelho,Britânia,GO,2239,3435,4686,5279,5073,5509,2809,2700,4543,966,0.43%
5203906,5205,Sul Goiano,52015,Meia Ponte,Buriti Alegre,GO,10471,8803,8742,8718,8287,9056,4535,4521,8414,642,0.38%
5203939,5203,Centro Goiano,52009,Anicuns,Buriti de Goiás,GO,,,,2659,2238,2561,1323,1238,1734,827,-0.37%
5203962,5204,Leste Goiano,52011,Vão do Paranã,Buritinópolis,GO,,,,3383,3442,3319,1701,1618,1883,1436,-0.19%
5204003,5204,Leste Goiano,52012,Entorno de Brasília,Cabeceiras,GO,4056,4993,6464,6758,6610,7346,3775,3571,5497,1849,0.84%
5204102,5205,Sul Goiano,52018,Quirinópolis,Cachoeira Alta,GO,11159,9243,8605,8646,8103,10539,5734,4805,8382,2157,2.00%
5204201,5203,Centro Goiano,52008,Iporá,Cachoeira de Goiás,GO,1762,1242,1435,1498,1410,1417,731,686,1171,246,-0.55%
5204250,5205,Sul Goiano,52015,Meia Ponte,Cachoeira Dourada,GO,,,8502,8525,7567,8267,4184,4083,5368,2899,-0.31%
5204300,5205,Sul Goiano,52018,Quirinópolis,Caçu,GO,9885,10739,11228,10575,10892,13279,7029,6250,10739,2540,2.30%
5204409,5205,Sul Goiano,52013,Sudoeste de Goiás,Caiapônia,GO,21522,28632,13915,14673,15747,16734,8500,8234,12257,4477,1.32%
5204508,5205,Sul Goiano,52015,Meia Ponte,Caldas Novas,GO,8630,11274,24159,49660,62204,70463,34995,35468,67693,2770,3.56%
5204557,5203,Centro Goiano,52010,Goiânia,Caldazinha,GO,,,,2859,3157,3322,1691,1631,1918,1404,1.51%
5204607,5205,Sul Goiano,52014,Vale do Rio dos Bois,Campestre de Goiás,GO,2724,2459,2316,3167,3411,3387,1772,1615,2376,1011,0.67%
5204656,5202,Norte Goiano,52004,Porangatu,Campinaçu,GO,,,4483,3707,3765,3654,1933,1721,2175,1479,-0.14%
5204706,5202,Norte Goiano,52004,Porangatu,Campinorte,GO,5158,7984,8257,9641,9697,11115,5703,5412,8999,2116,1.43%
5204805,5205,Sul Goiano,52017,Catalão,Campo Alegre de Goiás,GO,4457,4386,4536,4528,5767,6057,3095,2962,4494,1563,2.95%
5204854,5203,Centro Goiano,52007,Anápolis,Campo Limpo de Goiás,GO,,,,,5596,6270,3185,3085,5309,961,-
5204904,5202,Norte Goiano,52005,Chapada dos Veadeiros,Campos Belos,GO,5886,10126,14746,17047,18238,18395,9133,9262,16184,2211,0.76%
5204953,5202,Norte Goiano,52004,Porangatu,Campos Verdes,GO,,,16648,8057,6331,5022,2572,2450,4478,544,-4.62%
5205000,5203,Centro Goiano,52006,Ceres,Carmo do Rio Verde,GO,14264,10233,10292,7941,8897,8939,4547,4392,7065,1874,1.19%
5205059,5205,Sul Goiano,52013,Sudoeste de Goiás,Castelândia,GO,,,,3882,3530,3638,1918,1720,3344,294,-0.65%
5205109,5205,Sul Goiano,52017,Catalão,Catalão,GO,27338,39172,54525,64347,75623,86597,43470,43127,81020,5577,3.01%
5205208,5203,Centro Goiano,52007,Anápolis,Caturaí,GO,4669,3899,4134,4330,4477,4670,2390,2280,3655,1015,0.76%
5205307,5202,Norte Goiano,52005,Chapada dos Veadeiros,Cavalcante,GO,8258,11181,8156,9150,9875,9394,4915,4479,4747,4647,0.26%
5205406,5203,Centro Goiano,52006,Ceres,Ceres,GO,39510,31493,22874,22209,18637,20686,10119,10567,19753,933,-0.71%
5205455,5205,Sul Goiano,52014,Vale do Rio dos Bois,Cezarina,GO,,,5744,6514,7361,7548,3873,3675,5598,1950,1.48%
5205471,5205,Sul Goiano,52013,Sudoeste de Goiás,Chapadão do Céu,GO,,,,3778,5289,7004,3660,3344,5879,1125,6.37%
5205497,5204,Leste Goiano,52012,Entorno de Brasília,Cidade Ocidental,GO,,,,40377,48589,55883,27416,28467,43613,12270,3.30%
5205513,5204,Leste Goiano,52012,Entorno de Brasília,Cocalzinho de Goiás,GO,,,,14626,14762,17391,8937,8454,6448,10943,1.75%
5205521,5202,Norte Goiano,52005,Chapada dos Veadeiros,Colinas do Sul,GO,,,3458,3702,3856,3523,1838,1685,2525,998,-0.49%
5205703,5203,Centro Goiano,52008,Iporá,Córrego do Ouro,GO,6011,4367,3289,2973,2633,2629,1337,1292,1632,997,-1.22%
5205802,5204,Leste Goiano,52012,Entorno de Brasília,Corumbá de Goiás,GO,18439,20212,19663,9679,9190,10344,5402,4942,6416,3928,0.67%
5205901,5205,Sul Goiano,52017,Catalão,Corumbaíba,GO,7488,5909,5529,6655,8001,8164,4275,3889,6303,1861,2.06%
5206206,5204,Leste Goiano,52012,Entorno de Brasília,Cristalina,GO,11600,15977,24937,34116,36614,46568,23993,22575,38430,8138,3.16%
5206305,5205,Sul Goiano,52016,Pires do Rio,Cristianópolis,GO,1692,1661,2383,2924,3041,2933,1498,1435,2472,461,0.03%
5206404,5201,Noroeste Goiano,52001,São Miguel do Araguaia,Crixás,GO,18304,30219,22213,14673,14547,15762,8252,7510,12325,3437,0.72%
5206503,5205,Sul Goiano,52015,Meia Ponte,Cromínia,GO,4277,3362,3400,3660,3618,3555,1794,1761,2675,880,-0.29%
5206602,5205,Sul Goiano,52017,Catalão,Cumari,GO,4977,3783,2883,3105,3055,2961,1512,1449,2419,542,-0.47%
5206701,5204,Leste Goiano,52011,Vão do Paranã,Damianópolis,GO,3667,3528,3675,3303,3507,3297,1712,1585,1857,1440,-0.02%
5206800,5203,Centro Goiano,52007,Anápolis,Damolândia,GO,3641,2366,2593,2573,2688,2747,1383,1364,2182,565,0.66%
5206909,5205,Sul Goiano,52017,Catalão,Davinópolis,GO,3205,2450,2118,2109,2013,2050,1077,973,1398,652,-0.28%
5207105,5201,Noroeste Goiano,52003,Aragarças,Diorama,GO,4948,3571,2637,2498,2236,2479,1262,1217,1506,973,-0.08%
5207253,5205,Sul Goiano,52013,Sudoeste de Goiás,Doverlândia,GO,,,10213,8558,8344,7892,4162,3730,4916,2976,-0.81%
5207352,5205,Sul Goiano,52014,Vale do Rio dos Bois,Edealina,GO,,,4039,3803,3718,3733,1930,1803,2569,1164,-0.19%
5207402,5205,Sul Goiano,52014,Vale do Rio dos Bois,Edéia,GO,10039,12597,8999,10223,10251,11266,5778,5488,9538,1728,0.98%
5207501,5202,Norte Goiano,52004,Porangatu,Estrela do Norte,GO,2836,3198,3387,3398,3174,3318,1722,1596,2929,389,-0.24%
5207535,5201,Noroeste Goiano,52002,Rio Vermelho,Faina,GO,,,8003,7419,6918,6980,3652,3328,3850,3130,-0.61%
5207600,5203,Centro Goiano,52008,Iporá,Fazenda Nova,GO,9713,9887,7165,7093,6373,6318,3248,3070,4074,2244,-1.15%
5207808,5203,Centro Goiano,52009,Anicuns,Firminópolis,GO,11375,10058,9757,9909,10286,11603,5715,5888,8791,2812,1.59%
5207907,5204,Leste Goiano,52011,Vão do Paranã,Flores de Goiás,GO,2274,3888,5071,7514,10382,12058,6642,5416,3175,8883,4.84%
5208004,5204,Leste Goiano,52012,Entorno de Brasília,Formosa,GO,28874,43297,62982,78651,90212,100084,49965,50119,92035,8049,2.44%
5208103,5202,Norte Goiano,52004,Porangatu,Formoso,GO,13055,15403,6158,5589,5241,4891,2481,2410,3615,1276,-1.33%
5208152,5205,Sul Goiano,52016,Pires do Rio,Gameleira de Goiás,GO,,,,,3289,3275,1724,1551,1094,2181,-
5208301,5204,Leste Goiano,52011,Vão do Paranã,Divinópolis de Goiás,GO,3141,4244,5025,5172,5344,4967,2596,2371,3492,1475,-0.40%
5208400,5203,Centro Goiano,52010,Goiânia,Goianápolis,GO,7340,7569,10716,10671,11159,10681,5439,5242,9677,1004,0.01%
5208509,5205,Sul Goiano,52017,Catalão,Goiandira,GO,6033,5711,5368,4967,4925,5268,2641,2627,4542,726,0.59%
5208608,5203,Centro Goiano,52006,Ceres,Goianésia,GO,40769,32875,43535,49160,53806,59545,30067,29478,55665,3880,1.94%
5208707,5203,Centro Goiano,52010,Goiânia,Goiânia,GO,380773,717519,922222,1093007,1244645,1301892,620816,681076,1296969,4923,1.76%
5208806,5203,Centro Goiano,52010,Goiânia,Goianira,GO,6091,7488,12896,18719,24110,34061,17100,16961,33455,606,6.17%
5208905,5201,Noroeste Goiano,52002,Rio Vermelho,Goiás,GO,43242,42967,27782,27120,24472,24745,12277,12468,18664,6081,-0.91%
5209101,5205,Sul Goiano,52015,Meia Ponte,Goiatuba,GO,24579,26937,32469,31130,31225,32481,16218,16263,29934,2547,0.43%
5209150,5205,Sul Goiano,52018,Quirinópolis,Gouvelândia,GO,,,4136,4009,4507,4948,2565,2383,3894,1054,2.13%
5209200,5203,Centro Goiano,52010,Goiânia,Guapó,GO,8804,10028,11785,13863,13586,14002,6983,7019,11354,2648,0.10%
5209291,5203,Centro Goiano,52006,Ceres,Guaraíta,GO,,,,2794,2394,2372,1187,1185,1442,930,-1.62%
5209408,5204,Leste Goiano,52011,Vão do Paranã,Guarani de Goiás,GO,3504,3978,5611,4678,4105,4262,2294,1968,1764,2498,-0.93%
5209457,5203,Centro Goiano,52006,Ceres,Guarinos,GO,,,3711,2844,2411,2306,1227,1079,1133,1173,-2.08%
5209606,5203,Centro Goiano,52007,Anápolis,Heitoraí,GO,4715,3283,3021,3445,3556,3568,1826,1742,2643,925,0.35%
5209705,5203,Centro Goiano,52010,Goiânia,Hidrolândia,GO,8014,8559,10254,13086,14004,17398,8937,8461,10455,6943,2.89%
5209804,5203,Centro Goiano,52006,Ceres,Hidrolina,GO,6469,4813,4979,4548,4157,4029,2043,1986,2980,1049,-1.20%
5209903,5204,Leste Goiano,52011,Vão do Paranã,Iaciara,GO,3458,7974,9709,11295,12674,12438,6380,6058,9300,3138,0.97%
5209937,5205,Sul Goiano,52015,Meia Ponte,Inaciolândia,GO,,,,5239,5650,5702,2918,2784,4818,884,0.85%
5209952,5205,Sul Goiano,52014,Vale do Rio dos Bois,Indiara,GO,,,9843,11816,12703,13703,7084,6619,11667,2036,1.49%
5210000,5203,Centro Goiano,52007,Anápolis,Inhumas,GO,30144,31430,38368,43897,44983,48212,23620,24592,45079,3133,0.94%
5210109,5205,Sul Goiano,52017,Catalão,Ipameri,GO,20518,20384,20794,22628,23114,24745,12444,12301,21337,3408,0.90%
5210158,5203,Centro Goiano,52006,Ceres,Ipiranga de Goiás,GO,,,,,2813,2844,1451,1393,1272,1572,-
5210208,5203,Centro Goiano,52008,Iporá,Iporá,GO,17199,27248,29688,31300,31060,31274,15307,15967,28545,2729,-0.01%
5210307,5203,Centro Goiano,52008,Iporá,Israelândia,GO,6436,3583,3356,3004,2827,2888,1464,1424,2250,638,-0.39%
5210406,5203,Centro Goiano,52007,Anápolis,Itaberaí,GO,25371,25822,24852,27879,30609,35412,17880,17532,29802,5610,2.42%
5210562,5203,Centro Goiano,52007,Anápolis,Itaguari,GO,,,4085,4385,4254,4508,2275,2233,3963,545,0.28%
5210604,5203,Centro Goiano,52007,Anápolis,Itaguaru,GO,7024,7130,6450,5696,5467,5429,2736,2693,4515,914,-0.48%
5210802,5205,Sul Goiano,52018,Quirinópolis,Itajá,GO,6700,6289,6141,6572,5409,5066,2510,2556,3744,1322,-2.57%
5210901,5203,Centro Goiano,52006,Ceres,Itapaci,GO,14093,14225,12652,13931,16003,18481,9408,9073,16698,1783,2.87%
5211008,5201,Noroeste Goiano,52002,Rio Vermelho,Itapirapuã,GO,12641,10824,9052,10856,8208,7851,3972,3879,5548,2303,-3.19%
5211206,5203,Centro Goiano,52006,Ceres,Itapuranga,GO,30086,30358,31215,26740,24832,26085,12901,13184,21213,4872,-0.25%
5211305,5205,Sul Goiano,52018,Quirinópolis,Itarumã,GO,6206,5579,5859,5446,5338,6298,3317,2981,4078,2220,1.46%
5211404,5203,Centro Goiano,52007,Anápolis,Itauçu,GO,11855,9770,8678,8277,8710,8549,4234,4315,6426,2123,0.32%
5211503,5205,Sul Goiano,52015,Meia Ponte,Itumbiara,GO,64162,78049,79533,81430,88109,92942,45825,47117,89000,3942,1.33%
5211602,5203,Centro Goiano,52008,Iporá,Ivolândia,GO,5895,4269,3014,2992,2718,2663,1405,1258,1535,1128,-1.16%
5211701,5205,Sul Goiano,52014,Vale do Rio dos Bois,Jandaia,GO,9911,10981,6474,6342,6373,6164,3175,2989,4154,2010,-0.28%
5211800,5203,Centro Goiano,52007,Anápolis,Jaraguá,GO,42130,36559,28184,33284,38968,41888,21249,20639,35318,6570,2.33%
5211909,5205,Sul Goiano,52013,Sudoeste de Goiás,Jataí,GO,41364,53394,65957,75451,81972,88048,43998,44050,81044,7004,1.56%
5212006,5203,Centro Goiano,52008,Iporá,Jaupaci,GO,3696,2652,3154,3154,2998,3000,1517,1483,2358,642,-0.50%
5212055,5203,Centro Goiano,52007,Anápolis,Jesúpolis,GO,,,,2123,2201,2293,1201,1092,1827,466,0.77%
5212105,5205,Sul Goiano,52015,Meia Ponte,Joviânia,GO,6768,6320,6538,6904,6731,7108,3598,3510,6462,646,0.29%
5212204,5201,Noroeste Goiano,52002,Rio Vermelho,Jussara,GO,20950,22520,20917,20034,18814,19086,9547,9539,15138,3948,-0.48%
5212253,5205,Sul Goiano,52018,Quirinópolis,Lagoa Santa,GO,,,,,1225,1259,643,616,778,481,-
5212303,5203,Centro Goiano,52010,Goiânia,Leopoldo de Bulhões,GO,9109,8336,7376,7766,8916,7875,4008,3867,4843,3032,0.14%
5212501,5204,Leste Goiano,52012,Entorno de Brasília,Luziânia,GO,32807,92817,207674,141082,196046,174546,87108,87438,162835,11711,2.15%
5212600,5205,Sul Goiano,52015,Meia Ponte,Mairipotaba,GO,3375,2670,2665,2403,2655,2378,1241,1137,1573,805,-0.10%
5212709,5204,Leste Goiano,52011,Vão do Paranã,Mambaí,GO,4514,5125,6999,4838,6454,6885,3541,3344,4814,2071,3.59%
5212808,5202,Norte Goiano,52004,Porangatu,Mara Rosa,GO,20047,21524,21291,11939,10409,10659,5431,5228,7963,2696,-1.13%
5212907,5205,Sul Goiano,52015,Meia Ponte,Marzagão,GO,1044,1095,1405,1920,2053,2072,1026,1046,1804,268,0.76%
5212956,5201,Noroeste Goiano,52002,Rio Vermelho,Matrinchã,GO,,,3869,4520,4325,4414,2254,2160,2995,1419,-0.24%
5213004,5205,Sul Goiano,52013,Sudoeste de Goiás,Maurilândia,GO,5732,5032,7321,8969,10769,11516,6026,5490,11116,400,2.53%
5213053,5204,Leste Goiano,52012,Entorno de Brasília,Mimoso de Goiás,GO,,,3750,2801,2836,2685,1427,1258,1242,1443,-0.42%
5213087,5202,Norte Goiano,52004,Porangatu,Minaçu,GO,,28371,32288,33608,31041,31149,15816,15333,26546,4603,-0.76%
5213103,5205,Sul Goiano,52013,Sudoeste de Goiás,Mineiros,GO,15182,21690,31144,39024,45189,52964,27199,25765,48327,4637,3.10%
5213400,5203,Centro Goiano,52008,Iporá,Moiporá,GO,4948,2787,2254,2023,1848,1763,899,864,1133,630,-1.37%
5213509,5202,Norte Goiano,52005,Chapada dos Veadeiros,Monte Alegre de Goiás,GO,5295,7343,7966,6892,7155,7742,3990,3752,3174,4568,1.17%
5213707,5201,Noroeste Goiano,52003,Aragarças,Montes Claros de Goiás,GO,7802,9247,8450,7991,7844,8000,4110,3890,5328,2672,0.01%
5213756,5205,Sul Goiano,52013,Sudoeste de Goiás,Montividiu,GO,,,5595,7736,9255,10576,5500,5076,8592,1984,3.18%
5213772,5202,Norte Goiano,52004,Porangatu,Montividiu do Norte,GO,,,,3789,4395,4114,2104,2010,1347,2767,0.83%
5213806,5205,Sul Goiano,52015,Meia Ponte,Morrinhos,GO,31672,32122,32592,36990,38997,41457,20766,20691,35956,5501,1.15%
5213855,5203,Centro Goiano,52006,Ceres,Morro Agudo de Goiás,GO,,,2526,2489,2339,2365,1179,1186,1658,707,-0.51%
5213905,5203,Centro Goiano,52009,Anicuns,Mossâmedes,GO,12771,12208,9056,5798,4954,5005,2557,2448,3273,1732,-1.46%
5214002,5201,Noroeste Goiano,52001,São Miguel do Araguaia,Mozarlândia,GO,7393,8451,10078,11186,13123,13403,6850,6553,12162,1241,1.82%
5214051,5201,Noroeste Goiano,52001,São Miguel do Araguaia,Mundo Novo,GO,,,5476,8109,6877,6422,3415,3007,3768,2654,-2.31%
5214101,5202,Norte Goiano,52004,Porangatu,Mutunópolis,GO,4347,5157,4064,3958,3954,3842,1996,1846,2538,1304,-0.30%
5214408,5203,Centro Goiano,52009,Anicuns,Nazário,GO,6150,5834,6244,6631,7223,7874,3963,3911,6187,1687,1.73%
5214507,5203,Centro Goiano,52010,Goiânia,Nerópolis,GO,7735,9368,12987,18578,19392,24189,11928,12261,23208,981,2.67%
5214606,5202,Norte Goiano,52004,Porangatu,Niquelândia,GO,23736,33484,40751,38573,38517,42380,21678,20702,33346,9034,0.95%
5214705,5203,Centro Goiano,52006,Ceres,Nova América,GO,3339,2204,2022,2185,2200,2254,1158,1096,1643,611,0.31%
5214804,5205,Sul Goiano,52017,Catalão,Nova Aurora,GO,2166,1940,1845,1927,2094,2069,1074,995,1880,189,0.71%
5214838,5201,Noroeste Goiano,52001,São Miguel do Araguaia,Nova Crixás,GO,,,11102,11061,12603,11911,6217,5694,7702,4209,0.74%
5214861,5203,Centro Goiano,52006,Ceres,Nova Glória,GO,,,8506,8944,8470,8514,4248,4266,5728,2786,-0.49%
5214879,5202,Norte Goiano,52004,Porangatu,Nova Iguaçu de Goiás,GO,,,,2746,2622,2826,1455,1371,2024,802,0.29%
5214903,5202,Norte Goiano,52005,Chapada dos Veadeiros,Nova Roma,GO,3318,4110,4715,3717,3555,3468,1793,1675,1423,2045,-0.69%
5215009,5203,Centro Goiano,52007,Anápolis,Nova Veneza,GO,5733,5083,5003,6414,6884,8129,4128,4001,7026,1103,2.40%
5215207,5203,Centro Goiano,52008,Iporá,Novo Brasil,GO,6799,4966,4798,4181,3451,3516,1817,1699,2275,1241,-1.72%
5215231,5204,Leste Goiano,52012,Entorno de Brasília,Novo Gama,GO,,,,74380,83599,95013,46672,48341,93967,1046,2.48%
5215256,5201,Noroeste Goiano,52001,São Miguel do Araguaia,Novo Planalto,GO,,,4394,3432,3986,3953,2075,1878,2587,1366,1.42%
5215306,5205,Sul Goiano,52016,Pires do Rio,Orizona,GO,13546,12362,12471,13067,14374,14292,7375,6917,7981,6311,0.90%
5215405,5203,Centro Goiano,52007,Anápolis,Ouro Verde de Goiás,GO,5701,3844,4259,4358,4430,4040,2010,2030,2683,1357,-0.75%
5215504,5205,Sul Goiano,52017,Catalão,Ouvidor,GO,3928,3443,3703,4271,4736,5446,2804,2642,4795,651,2.46%
5215603,5204,Leste Goiano,52012,Entorno de Brasília,Padre Bernardo,GO,8381,15855,16500,21514,25969,27689,14000,13689,10794,16895,2.56%
5215652,5205,Sul Goiano,52013,Sudoeste de Goiás,Palestina de Goiás,GO,,,3174,3307,3229,3382,1779,1603,2180,1202,0.22%
5215702,5205,Sul Goiano,52014,Vale do Rio dos Bois,Palmeiras de Goiás,GO,24042,22536,16635,17822,21199,23333,11813,11520,19154,4179,2.73%
5215801,5205,Sul Goiano,52016,Pires do Rio,Palmelo,GO,1506,1833,2123,2309,2260,2339,1152,1187,2216,123,0.13%
5215900,5205,Sul Goiano,52014,Vale do Rio dos Bois,Palminópolis,GO,5248,4303,3629,3561,3622,3561,1779,1782,2699,862,0.00%
5216007,5205,Sul Goiano,52015,Meia Ponte,Panamá,GO,3939,2878,2501,2776,2618,2676,1367,1309,2035,641,-0.37%
5216304,5205,Sul Goiano,52018,Quirinópolis,Paranaiguara,GO,9499,6782,7479,8192,7724,9119,4598,4521,8397,722,1.08%
5216403,5205,Sul Goiano,52014,Vale do Rio dos Bois,Paraúna,GO,18545,13569,9832,10834,10926,10860,5517,5343,7987,2873,0.02%
5216452,5205,Sul Goiano,52013,Sudoeste de Goiás,Perolândia,GO,,,,2791,2748,2950,1570,1380,1859,1091,0.56%
5216809,5203,Centro Goiano,52007,Anápolis,Petrolina de Goiás,GO,14919,12153,10741,10381,9864,10285,5364,4921,6684,3601,-0.09%
5216908,5203,Centro Goiano,52006,Ceres,Pilar de Goiás,GO,10217,9246,4845,3339,2852,2766,1467,1299,1198,1568,-1.87%
5217104,5205,Sul Goiano,52015,Meia Ponte,Piracanjuba,GO,22842,24095,25273,23557,23310,24033,12204,11829,17553,6480,0.20%
5217203,5201,Noroeste Goiano,52003,Aragarças,Piranhas,GO,11441,15877,12810,12287,11139,11268,5719,5549,9071,2197,-0.86%
5217302,5204,Leste Goiano,52012,Entorno de Brasília,Pirenópolis,GO,32065,29329,25056,21245,20460,23065,11826,11239,15589,7476,0.83%
5217401,5205,Sul Goiano,52016,Pires do Rio,Pires do Rio,GO,18423,19258,22131,26229,26857,28691,14071,14620,27018,1673,0.90%
5217609,5204,Leste Goiano,52012,Entorno de Brasília,Planaltina,GO,8972,16178,40201,73718,76376,81612,40491,41121,77583,4029,1.02%
5217708,5205,Sul Goiano,52015,Meia Ponte,Pontalina,GO,19314,19120,15409,16556,16226,17112,8567,8545,13890,3222,0.33%
5218003,5202,Norte Goiano,52004,Porangatu,Porangatu,GO,25874,34881,41086,39593,39238,42356,21285,21071,35742,6614,0.68%
5218052,5205,Sul Goiano,52015,Meia Ponte,Porteirão,GO,,,,2823,3008,3347,1808,1539,2929,418,1.72%
5218102,5205,Sul Goiano,52013,Sudoeste de Goiás,Portelândia,GO,1827,2352,3021,3696,3310,3839,1986,1853,3110,729,0.38%
5218300,5204,Leste Goiano,52011,Vão do Paranã,Posse,GO,13286,21684,23518,25696,28850,31417,15927,15490,23934,7483,2.03%
5218391,5205,Sul Goiano,52015,Meia Ponte,Professor Jamil,GO,,,,3403,3298,3244,1678,1566,2263,981,-0.48%
5218508,5205,Sul Goiano,52018,Quirinópolis,Quirinópolis,GO,37917,36236,34276,36512,38064,43243,21940,21303,38179,5064,1.71%
5218607,5203,Centro Goiano,52006,Ceres,Rialma,GO,6011,7516,8912,10210,10485,10516,5230,5286,9794,722,0.30%
5218706,5203,Centro Goiano,52006,Ceres,Rianápolis,GO,3070,3501,4290,4364,4167,4556,2312,2244,4071,485,0.43%
5218789,5205,Sul Goiano,52015,Meia Ponte,Rio Quente,GO,,,837,2097,2959,3311,1732,1579,2838,473,4.67%
5218805,5205,Sul Goiano,52013,Sudoeste de Goiás,Rio Verde,GO,55697,74699,96309,116552,149382,176502,90021,86481,163621,12881,4.24%
5218904,5203,Centro Goiano,52006,Ceres,Rubiataba,GO,23199,19918,16686,18087,18025,18848,9385,9463,16158,2690,0.41%
5219001,5203,Centro Goiano,52009,Anicuns,Sanclerlândia,GO,8478,8535,7353,7530,7647,7563,3847,3716,6079,1484,0.04%
5219100,5203,Centro Goiano,52009,Anicuns,Santa Bárbara de Goiás,GO,2748,3247,3916,4963,5658,5751,2932,2819,5206,545,1.48%
5219209,5205,Sul Goiano,52016,Pires do Rio,Santa Cruz de Goiás,GO,3594,3086,3261,3470,3542,3142,1645,1497,981,2161,-0.99%
5219258,5201,Noroeste Goiano,52002,Rio Vermelho,Santa Fé de Goiás,GO,,,3523,4083,4594,4768,2411,2357,3823,945,1.56%
5219308,5205,Sul Goiano,52013,Sudoeste de Goiás,Santa Helena de Goiás,GO,25481,26654,33142,34545,35027,36459,18311,18148,34810,1649,0.54%
5219357,5203,Centro Goiano,52006,Ceres,Santa Isabel,GO,,,3887,3592,3485,3680,1900,1780,1361,2319,0.24%
5219407,5205,Sul Goiano,52013,Sudoeste de Goiás,Santa Rita do Araguaia,GO,2309,3933,4534,5087,5873,6928,3549,3379,6163,765,3.14%
5219456,5203,Centro Goiano,52006,Ceres,Santa Rita do Novo Destino,GO,,,,3025,3372,3170,1725,1445,1114,2056,0.47%
5219506,5203,Centro Goiano,52007,Anápolis,Santa Rosa de Goiás,GO,4688,4236,3982,3548,2851,2905,1451,1454,2177,728,-1.98%
5219605,5202,Norte Goiano,52004,Porangatu,Santa Tereza de Goiás,GO,3804,5417,5102,4697,4145,3991,1993,1998,3351,640,-1.62%
5219704,5202,Norte Goiano,52004,Porangatu,Santa Terezinha de Goiás,GO,8644,10964,16522,12015,11558,10304,5261,5043,7768,2536,-1.52%
5219712,5205,Sul Goiano,52013,Sudoeste de Goiás,Santo Antônio da Barra,GO,,,,4052,4134,4430,2350,2080,3384,1046,0.90%
5219738,5203,Centro Goiano,52010,Goiânia,Santo Antônio de Goiás,GO,,,,3106,3893,4690,2379,2311,4258,432,4.21%
5219753,5204,Leste Goiano,52012,Entorno de Brasília,Santo Antônio do Descoberto,GO,,,35509,51897,55621,63166,31340,31826,56721,6445,1.98%
5219803,5204,Leste Goiano,52011,Vão do Paranã,São Domingos,GO,7941,9660,10330,9636,9786,11236,5903,5333,5745,5491,1.55%
5219902,5203,Centro Goiano,52007,Anápolis,São Francisco de Goiás,GO,8299,9427,8097,6028,5713,6117,3142,2975,4461,1656,0.15%
5220009,5202,Norte Goiano,52005,Chapada dos Veadeiros,São João d'Aliança,GO,3489,4333,5116,6736,8177,10254,5273,4981,6721,3533,4.29%
5220058,5205,Sul Goiano,52014,Vale do Rio dos Bois,São João da Paraúna,GO,,,1878,2024,1699,1692,845,847,1277,415,-1.78%
5220108,5203,Centro Goiano,52009,Anicuns,São Luís de Montes Belos,GO,25246,25228,25039,26383,26784,30050,14743,15307,26601,3449,1.31%
5220157,5203,Centro Goiano,52006,Ceres,São Luíz do Norte,GO,,,4162,4089,4266,4617,2334,2283,3908,709,1.22%
5220207,5201,Noroeste Goiano,52001,São Miguel do Araguaia,São Miguel do Araguaia,GO,18759,22793,19169,22793,22468,22294,11397,10897,17668,4626,-0.22%
5220264,5205,Sul Goiano,52016,Pires do Rio,São Miguel do Passa Quatro,GO,,,2820,3481,3680,3761,1945,1816,2076,1685,0.78%
5220280,5203,Centro Goiano,52006,Ceres,São Patrício,GO,,,,1835,2051,1991,1000,991,1171,820,0.82%
5220405,5205,Sul Goiano,52018,Quirinópolis,São Simão,GO,7208,11374,11096,13552,13832,17086,8863,8223,16307,779,2.34%
5220454,5203,Centro Goiano,52010,Goiânia,Senador Canedo,GO,,,23905,53105,70559,84399,42184,42215,84066,333,4.74%
5220504,5205,Sul Goiano,52013,Sudoeste de Goiás,Serranópolis,GO,5179,5390,7855,6447,7333,7477,3971,3506,5540,1937,1.49%
5220603,5205,Sul Goiano,52016,Pires do Rio,Silvânia,GO,20523,19809,18000,20339,18370,19096,9811,9285,12679,6417,-0.63%
5220686,5204,Leste Goiano,52011,Vão do Paranã,Simolândia,GO,,,5578,6219,6915,6512,3301,3211,5377,1135,0.46%
5220702,5204,Leste Goiano,52011,Vão do Paranã,Sítio d'Abadia,GO,2724,2712,2748,2681,3251,2821,1517,1304,994,1827,0.51%
5221007,5203,Centro Goiano,52007,Anápolis,Taquaral de Goiás,GO,11797,9154,4069,3587,3404,3540,1766,1774,2876,664,-0.13%
5221080,5202,Norte Goiano,52005,Chapada dos Veadeiros,Teresina de Goiás,GO,,,1373,2585,2773,3016,1542,1474,2134,882,1.55%
5221197,5203,Centro Goiano,52010,Goiânia,Terezópolis de Goiás,GO,,,,5083,5620,6562,3347,3215,5677,885,2.59%
5221304,5205,Sul Goiano,52017,Catalão,Três Ranchos,GO,3248,2249,2260,2831,2862,2817,1423,1394,2486,331,-0.05%
5221403,5203,Centro Goiano,52010,Goiânia,Trindade,GO,22519,30609,54072,81457,97491,104506,51407,53099,100107,4399,2.52%
5221452,5202,Norte Goiano,52004,Porangatu,Trombas,GO,,,6493,3434,3537,3435,1778,1657,2183,1252,0.00%
5221502,5203,Centro Goiano,52009,Anicuns,Turvânia,GO,6671,5913,5385,5134,4962,4839,2431,2408,3891,948,-0.59%
5221551,5205,Sul Goiano,52014,Vale do Rio dos Bois,Turvelândia,GO,,,2437,3524,3852,4399,2338,2061,3138,1261,2.24%
5221577,5201,Noroeste Goiano,52001,São Miguel do Araguaia,Uirapuru,GO,,,,3043,3021,2935,1527,1408,1464,1471,-0.36%
5221601,5202,Norte Goiano,52004,Porangatu,Uruaçu,GO,36304,32226,33929,33530,33382,36949,18443,18506,33816,3133,0.98%
5221700,5203,Centro Goiano,52006,Ceres,Uruana,GO,14037,12011,13757,13938,13712,13821,7004,6817,11227,2594,-0.08%
5221809,5205,Sul Goiano,52016,Pires do Rio,Urutaí,GO,4003,3138,2834,3104,2727,3058,1560,1498,2165,893,-0.15%
5221858,5204,Leste Goiano,52012,Entorno de Brasília,Valparaíso de Goiás,GO,,,,94856,114450,132947,64616,68331,132947,0,3.43%
5221908,5205,Sul Goiano,52014,Vale do Rio dos Bois,Varjão,GO,4727,3650,3424,3519,3649,3661,1854,1807,2245,1416,0.40%
5222005,5205,Sul Goiano,52016,Pires do Rio,Vianópolis,GO,6757,7934,9067,11300,12187,12549,6284,6265,9164,3385,1.05%
5222054,5205,Sul Goiano,52015,Meia Ponte,Vicentinópolis,GO,,,5149,6015,5919,7371,3871,3500,6322,1049,2.05%
5222203,5204,Leste Goiano,52012,Entorno de Brasília,Vila Boa,GO,,,,3287,4198,4742,2606,2136,3497,1245,3.73%
5222302,5204,Leste Goiano,52012,Entorno de Brasília,Vila Propício,GO,,,,4492,5044,5145,2690,2455,1504,3641,1.37%
2100055,2102,Oeste Maranhense,21009,Imperatriz,Açailândia,MA,,,83820,88320,97034,104013,52093,51920,78241,25772,1.65%
2100105,2104,Leste Maranhense,21016,Coelho Neto,Afonso Cunha,MA,3045,3422,4580,4680,5651,5957,3001,2956,3272,2685,2.44%
2100154,2104,Leste Maranhense,21013,Baixo Parnaíba Maranhense,Água Doce do Maranhão,MA,,,,9703,11829,11590,6026,5564,3124,8466,1.79%
2100204,2101,Norte Maranhense,21001,Litoral Ocidental Maranhense,Alcântara,MA,16627,18509,19587,21291,21349,21852,11251,10601,6400,15452,0.26%
2100303,2104,Leste Maranhense,21016,Coelho Neto,Aldeias Altas,MA,16845,18994,19520,18827,21645,23952,12393,11559,13634,10318,2.44%
2100402,2102,Oeste Maranhense,21008,Pindaré,Altamira do Maranhão,MA,21345,24722,20003,8865,7365,10211,5190,5021,3141,7070,1.42%
2100436,2104,Leste Maranhense,21015,Codó,Alto Alegre do Maranhão,MA,,,,20162,22002,24596,12272,12324,19374,5222,2.01%
2100477,2102,Oeste Maranhense,21008,Pindaré,Alto Alegre do Pindaré,MA,,,,30177,31992,31028,15995,15033,9834,21194,0.28%
2100501,2105,Sul Maranhense,21020,Gerais de Balsas,Alto Parnaíba,MA,7209,7731,10336,10174,10304,10765,5468,5297,7028,3737,0.57%
2100550,2102,Oeste Maranhense,21007,Gurupi,Amapá do Maranhão,MA,,,,5431,6168,6431,3311,3120,4841,1590,1.70%
2100600,2102,Oeste Maranhense,21009,Imperatriz,Amarante do Maranhão,MA,13831,17009,23102,31292,35727,37894,19760,18134,15006,22888,1.93%
2100709,2101,Norte Maranhense,21005,Baixada Maranhense,Anajatuba,MA,16350,19200,19528,22978,23941,25294,12960,12334,7018,18276,0.96%
2100808,2104,Leste Maranhense,21014,Chapadinha,Anapurus,MA,6719,8554,10249,10280,12580,13923,6984,6939,7158,6765,3.08%
2100832,2101,Norte Maranhense,21001,Litoral Ocidental Maranhense,Apicum-Açu,MA,,,,11099,13216,14959,7816,7143,9162,5797,3.03%
2100873,2102,Oeste Maranhense,21008,Pindaré,Araguanã,MA,,,,9123,9918,13957,7110,6847,5376,8581,4.34%
2100907,2104,Leste Maranhense,21013,Baixo Parnaíba Maranhense,Araioses,MA,39561,44351,44029,34906,37655,42600,22019,20581,12088,30512,2.01%
2100956,2103,Centro Maranhense,21011,Alto Mearim e Grajaú,Arame,MA,,,33923,29843,27229,31568,16393,15175,12558,19010,0.56%
2101004,2101,Norte Maranhense,21005,Baixada Maranhense,Arari,MA,17792,22274,24826,26366,27753,28477,14308,14169,17484,10993,0.77%
2101103,2101,Norte Maranhense,21003,Rosário,Axixá,MA,7644,8906,9358,10142,14249,11425,5831,5594,4705,6720,1.20%
2101202,2103,Centro Maranhense,21010,Médio Mearim,Bacabal,MA,69578,81361,98793,91823,95124,99960,47747,52213,77836,22124,0.85%
2101251,2101,Norte Maranhense,21003,Rosário,Bacabeira,MA,,,,10516,14611,14965,7542,7423,3324,11641,3.59%
2101301,2101,Norte Maranhense,21001,Litoral Ocidental Maranhense,Bacuri,MA,17054,18855,22205,15531,16026,16626,8494,8132,8692,7934,0.68%
2101350,2101,Norte Maranhense,21001,Litoral Ocidental Maranhense,Bacurituba,MA,,,,4671,5425,5304,2743,2561,1429,3875,1.28%
2101400,2105,Sul Maranhense,21020,Gerais de Balsas,Balsas,MA,19385,23703,41648,60163,78845,83537,41568,41969,72786,10751,3.34%
2101509,2104,Leste Maranhense,21018,Chapadas do Alto Itapecuru,Barão de Grajaú,MA,11452,12172,13500,15349,16565,17816,8924,8892,10308,7508,1.50%
2101608,2103,Centro Maranhense,21011,Alto Mearim e Grajaú,Barra do Corda,MA,57839,76673,90820,78147,78718,82692,41580,41112,51572,31120,0.57%
2101707,2101,Norte Maranhense,21004,Lençois Maranhenses,Barreirinhas,MA,24969,26588,29640,39669,47850,54991,28159,26832,22156,32835,3.32%
2101731,2104,Leste Maranhense,21014,Chapadinha,Belágua,MA,,,,5253,5717,6527,3425,3102,3266,3261,2.20%
2101772,2101,Norte Maranhense,21005,Baixada Maranhense,Bela Vista do Maranhão,MA,,,,9900,8603,11946,6034,5912,5167,6779,1.90%
2101806,2105,Sul Maranhense,21021,Chapadas das Mangabeiras,Benedito Leite,MA,7374,8439,8960,5288,5387,5473,2858,2615,2817,2656,0.34%
2101905,2101,Norte Maranhense,21001,Litoral Ocidental Maranhense,Bequimão,MA,18736,20192,21377,19700,20735,20339,10344,9995,6591,13748,0.32%
2101939,2103,Centro Maranhense,21010,Médio Mearim,Bernardo do Mearim,MA,,,,5239,5972,5996,2973,3023,2324,3672,1.36%
2101970,2102,Oeste Maranhense,21007,Gurupi,Boa Vista do Gurupi,MA,,,,5128,7385,7949,4041,3908,5619,2330,4.48%
2102002,2102,Oeste Maranhense,21008,Pindaré,Bom Jardim,MA,24991,31953,40572,34474,37659,39093,19891,19202,16439,22654,1.27%
2102036,2102,Oeste Maranhense,21008,Pindaré,Bom Jesus das Selvas,MA,,,,16545,23827,28456,14872,13584,13431,15025,5.57%
2102077,2103,Centro Maranhense,21010,Médio Mearim,Bom Lugar,MA,,,,11534,12825,14823,7555,7268,4181,10642,2.54%
2102101,2104,Leste Maranhense,21014,Chapadinha,Brejo,MA,22049,25561,27153,27513,31049,33314,16858,16456,12312,21002,1.93%
2102150,2102,Oeste Maranhense,21008,Pindaré,Brejo de Areia,MA,,,,10418,5803,10540,5460,5080,2853,7687,0.12%
2102200,2104,Leste Maranhense,21014,Chapadinha,Buriti,MA,19231,22165,22856,24126,25274,27042,13714,13328,8417,18625,1.15%
2102309,2104,Leste Maranhense,21017,Caxias,Buriti Bravo,MA,13587,17692,21142,21446,22279,22886,11303,11583,17004,5882,0.65%
2102325,2102,Oeste Maranhense,21008,Pindaré,Buriticupu,MA,,,,51059,61480,65226,33305,31921,35790,29436,2.48%
2102358,2102,Oeste Maranhense,21009,Imperatriz,Buritirana,MA,,,,13822,12596,14770,7530,7240,4152,10618,0.67%
2102374,2101,Norte Maranhense,21003,Rosário,Cachoeira Grande,MA,,,,7383,8831,8442,4402,4040,3793,4649,1.35%
2102408,2101,Norte Maranhense,21001,Litoral Ocidental Maranhense,Cajapió,MA,11050,12287,12038,9622,9982,10632,5363,5269,3905,6727,1.00%
2102507,2101,Norte Maranhense,21005,Baixada Maranhense,Cajari,MA,13448,16508,16018,13405,12842,18348,9517,8831,4285,14063,3.19%
2102556,2105,Sul Maranhense,21019,Porto Franco,Campestre do Maranhão,MA,,,,11521,12246,13369,6819,6550,10621,2748,1.50%
2102606,2102,Oeste Maranhense,21007,Gurupi,Cândido Mendes,MA,10165,19988,32244,16566,18820,18505,9690,8815,11911,6594,1.11%
2102705,2101,Norte Maranhense,21006,Itapecuru Mirim,Cantanhede,MA,15412,17247,23308,17713,18827,20457,10257,10200,12965,7492,1.45%
2102754,2104,Leste Maranhense,21015,Codó,Capinzal do Norte,MA,,,,10543,10385,10698,5345,5353,5610,5088,0.15%
2102804,2105,Sul Maranhense,21019,Porto Franco,Carolina,MA,28815,34953,24665,23991,24442,23979,12289,11690,16240,7739,-0.01%
2102903,2102,Oeste Maranhense,21007,Gurupi,Carutapera,MA,10356,17843,32037,18624,20285,22008,11339,10669,16224,5784,1.68%
2103000,2104,Leste Maranhense,21017,Caxias,Caxias,MA,88334,125509,145725,139756,143197,155202,75111,80091,118559,36643,1.05%
2103109,2101,Norte Maranhense,21001,Litoral Ocidental Maranhense,Cedral,MA,11400,12809,15104,9793,9841,10300,5395,4905,2400,7900,0.51%
2103125,2101,Norte Maranhense,21001,Litoral Ocidental Maranhense,Central do Maranhão,MA,,,,7186,8776,7988,4137,3851,4175,3813,1.06%
2103158,2102,Oeste Maranhense,21007,Gurupi,Centro do Guilherme,MA,,,,6152,7094,12517,6610,5907,7037,5480,7.36%
2103174,2102,Oeste Maranhense,21007,Gurupi,Centro Novo do Maranhão,MA,,,,14554,15127,17622,9331,8291,5522,12100,1.93%
2103208,2104,Leste Maranhense,21014,Chapadinha,Chapadinha,MA,44997,52646,56862,61322,67649,73281,36230,37051,52814,20467,1.80%
2103257,2102,Oeste Maranhense,21009,Imperatriz,Cidelândia,MA,,,,11816,12407,13593,6976,6617,5997,7596,1.41%
2103307,2104,Leste Maranhense,21015,Codó,Codó,MA,93003,108966,111967,111146,110574,118072,57432,60640,81043,37029,0.61%
2103406,2104,Leste Maranhense,21016,Coelho Neto,Coelho Neto,MA,16660,24470,39669,42214,44031,46792,23004,23788,38770,8022,1.03%
2103505,2104,Leste Maranhense,21018,Chapadas do Alto Itapecuru,Colinas,MA,22824,31365,35164,35803,35692,39167,19399,19768,25596,13571,0.90%
2103554,2101,Norte Maranhense,21005,Baixada Maranhense,Conceição do Lago-Açu,MA,,,,10774,14063,14428,7482,6946,6860,7568,2.96%
2103604,2104,Leste Maranhense,21015,Codó,Coroatá,MA,65797,66913,70360,55676,60589,61653,30636,31017,43017,18636,1.02%
2103703,2101,Norte Maranhense,21001,Litoral Ocidental Maranhense,Cururupu,MA,33880,38096,41332,33747,34018,32594,16566,16028,22216,10378,-0.35%
2103752,2102,Oeste Maranhense,21009,Imperatriz,Davinópolis,MA,,,,12275,11786,12551,6252,6299,10475,2076,0.22%
2103802,2103,Centro Maranhense,21012,Presidente Dutra,Dom Pedro,MA,16315,18501,19726,21956,21479,22673,10960,11713,15257,7416,0.32%
2103901,2104,Leste Maranhense,21016,Coelho Neto,Duque Bacelar,MA,15413,7961,7539,9413,10384,10634,5367,5267,5318,5316,1.23%
2104008,2103,Centro Maranhense,21010,Médio Mearim,Esperantinópolis,MA,23210,42955,30567,21224,18569,18456,9077,9379,10039,8417,-1.39%
2104057,2105,Sul Maranhense,21019,Porto Franco,Estreito,MA,,,23031,22930,26490,35738,18927,16811,25676,10062,4.54%
2104073,2105,Sul Maranhense,21020,Gerais de Balsas,Feira Nova do Maranhão,MA,,,,7543,7648,8120,4265,3855,1927,6193,0.74%
2104081,2103,Centro Maranhense,21011,Alto Mearim e Grajaú,Fernando Falcão,MA,,,,4823,8105,9180,4806,4374,1511,7669,6.65%
2104099,2103,Centro Maranhense,21011,Alto Mearim e Grajaú,Formosa da Serra Negra,MA,,,,13781,16882,17780,9333,8447,5915,11865,2.58%
2104107,2105,Sul Maranhense,21021,Chapadas das Mangabeiras,Fortaleza dos Nogueiras,MA,7245,9796,12428,11301,11578,11644,5968,5676,7019,4625,0.30%
2104206,2103,Centro Maranhense,21012,Presidente Dutra,Fortuna,MA,8432,12254,15570,14596,14486,15108,7618,7490,9504,5604,0.35%
2104305,2102,Oeste Maranhense,21007,Gurupi,Godofredo Viana,MA,7562,11070,28315,6994,10452,10635,5566,5069,6723,3912,4.28%
2104404,2103,Centro Maranhense,21012,Presidente Dutra,Gonçalves Dias,MA,15881,18613,16533,16790,16444,17485,8676,8809,7778,9707,0.41%
2104503,2103,Centro Maranhense,21012,Presidente Dutra,Governador Archer,MA,10722,12051,10267,9100,9920,10205,5066,5139,6630,3575,1.15%
2104552,2102,Oeste Maranhense,21009,Imperatriz,Governador Edison Lobão,MA,,,,10891,14086,15895,8156,7739,6954,8941,3.85%
2104602,2103,Centro Maranhense,21012,Presidente Dutra,Governador Eugênio Barros,MA,20290,21798,22743,14629,15857,15983,8057,7926,4690,11293,0.89%
2104628,2103,Centro Maranhense,21012,Presidente Dutra,Governador Luiz Rocha,MA,,,,6513,6884,7337,3750,3587,5187,2150,1.20%
2104651,2102,Oeste Maranhense,21008,Pindaré,Governador Newton Bello,MA,,,,11804,11346,11922,6017,5905,4291,7631,0.10%
2104677,2102,Oeste Maranhense,21007,Gurupi,Governador Nunes Freire,MA,,,,25921,24012,25402,12863,12539,15945,9457,-0.20%
2104701,2103,Centro Maranhense,21012,Presidente Dutra,Graça Aranha,MA,6012,5576,5891,6080,6254,6140,3031,3109,2912,3228,0.10%
2104800,2103,Centro Maranhense,21011,Alto Mearim e Grajaú,Grajaú,MA,33130,57940,54403,47155,54135,61903,31605,30298,36983,24920,2.76%
2104909,2101,Norte Maranhense,21001,Litoral Ocidental Maranhense,Guimarães,MA,9670,12414,12360,12641,12387,12105,6146,5959,6929,5176,-0.43%
2105005,2101,Norte Maranhense,21004,Lençois Maranhenses,Humberto de Campos,MA,16242,18325,20071,21266,24275,26197,13687,12510,10505,15692,2.11%
2105104,2101,Norte Maranhense,21003,Rosário,Icatu,MA,15228,19493,20679,21489,24432,25147,13093,12054,7813,17334,1.58%
2105153,2101,Norte Maranhense,21005,Baixada Maranhense,Igarapé do Meio,MA,,,,9842,11697,12543,6331,6212,6203,6340,2.45%
2105203,2103,Centro Maranhense,21010,Médio Mearim,Igarapé Grande,MA,15904,15949,14810,9759,10676,11047,5428,5619,6670,4377,1.25%
2105302,2102,Oeste Maranhense,21009,Imperatriz,Imperatriz,MA,80827,220079,276502,230566,229671,247553,119230,128323,234671,12882,0.71%
2105351,2103,Centro Maranhense,21011,Alto Mearim e Grajaú,Itaipava do Grajaú,MA,,,,13341,13197,14264,7382,6882,4243,10021,0.67%
2105401,2101,Norte Maranhense,21006,Itapecuru Mirim,Itapecuru Mirim,MA,31589,44120,42853,42772,54573,62123,31030,31093,34717,27406,3.80%
2105427,2102,Oeste Maranhense,21009,Imperatriz,Itinga do Maranhão,MA,,,,23128,25100,24891,12580,12311,17660,7231,0.74%
2105450,2104,Leste Maranhense,21018,Chapadas do Alto Itapecuru,Jatobá,MA,,,,5055,8255,8526,4303,4223,3740,4786,5.37%
2105476,2103,Centro Maranhense,21011,Alto Mearim e Grajaú,Jenipapo dos Vieiras,MA,,,,10119,14815,15397,7959,7438,2536,12861,4.29%
2105500,2102,Oeste Maranhense,21009,Imperatriz,João Lisboa,MA,26997,41965,53249,24598,19928,20381,9976,10405,15346,5035,-1.86%
2105609,2103,Centro Maranhense,21011,Alto Mearim e Grajaú,Joselândia,MA,15541,16490,15267,14609,15583,15437,7818,7619,5960,9477,0.55%
2105658,2102,Oeste Maranhense,21007,Gurupi,Junco do Maranhão,MA,,,,5533,4014,4020,2007,2013,2819,1201,-3.14%
2105708,2102,Oeste Maranhense,21008,Pindaré,Lago da Pedra,MA,43525,44807,46877,40405,42666,46108,22983,23125,30109,15999,1.33%
2105807,2103,Centro Maranhense,21010,Médio Mearim,Lago do Junco,MA,17766,18588,19276,9833,9616,10736,5417,5319,3924,6812,0.88%
2105906,2103,Centro Maranhense,21010,Médio Mearim,Lago Verde,MA,10657,10472,13220,13038,14580,15407,7730,7677,5053,10354,1.68%
2105922,2104,Leste Maranhense,21018,Chapadas do Alto Itapecuru,Lagoa do Mato,MA,,,,9446,10225,10954,5623,5331,4469,6485,1.49%
2105948,2103,Centro Maranhense,21010,Médio Mearim,Lago dos Rodrigues,MA,,,,8443,7780,7799,3867,3932,4850,2949,-0.79%
2105963,2102,Oeste Maranhense,21008,Pindaré,Lagoa Grande do Maranhão,MA,,,,8469,9015,10536,5553,4983,5497,5039,2.21%
2105989,2102,Oeste Maranhense,21009,Imperatriz,Lajeado Novo,MA,,,,5717,6620,6923,3624,3299,3194,3729,1.93%
2106003,2103,Centro Maranhense,21010,Médio Mearim,Lima Campos,MA,10639,12544,12404,10749,11365,11415,5608,5807,6785,4630,0.60%
2106102,2105,Sul Maranhense,21021,Chapadas das Mangabeiras,Loreto,MA,7643,8068,9465,10024,10340,11374,5858,5516,6344,5030,1.27%
2106201,2102,Oeste Maranhense,21007,Gurupi,Luís Domingues,MA,5893,6080,9140,5724,6672,6510,3399,3111,5503,1007,1.30%
2106300,2104,Leste Maranhense,21013,Baixo Parnaíba Maranhense,Magalhães de Almeida,MA,10232,11240,11495,13021,14217,17633,8992,8641,8920,8713,3.08%
2106326,2102,Oeste Maranhense,21007,Gurupi,Maracaçumé,MA,,,,14866,17537,19142,9586,9556,15825,3317,2.56%
2106359,2102,Oeste Maranhense,21008,Pindaré,Marajá do Sena,MA,,,,7161,6790,8045,4381,3664,1155,6890,1.17%
2106375,2102,Oeste Maranhense,21007,Gurupi,Maranhãozinho,MA,,,,8445,11887,14066,7168,6898,9020,5046,5.23%
2106409,2104,Leste Maranhense,21014,Chapadinha,Mata Roma,MA,8068,9903,10607,11799,13812,15123,7566,7557,7120,8003,2.51%
2106508,2101,Norte Maranhense,21005,Baixada Maranhense,Matinha,MA,18536,15018,18326,19231,20422,21832,11020,10812,8838,12994,1.28%
2106607,2104,Leste Maranhense,21017,Caxias,Matões,MA,19200,23773,25318,26433,28278,30930,15534,15396,13623,17307,1.58%
2106631,2101,Norte Maranhense,21006,Itapecuru Mirim,Matões do Norte,MA,,,,7435,10576,13796,7242,6554,4679,9117,6.38%
2106672,2104,Leste Maranhense,21014,Chapadinha,Milagres do Maranhão,MA,,,,5149,7617,8118,4197,3921,1760,6358,4.66%
2106706,2104,Leste Maranhense,21018,Chapadas do Alto Itapecuru,Mirador,MA,13378,15493,17136,19906,19445,20434,10446,9988,9366,11068,0.26%
2106755,2101,Norte Maranhense,21006,Itapecuru Mirim,Miranda do Norte,MA,,,14277,16123,17742,24331,11759,12572,19423,4908,4.20%
2106805,2101,Norte Maranhense,21001,Litoral Ocidental Maranhense,Mirinzal,MA,12377,16073,16856,13005,13786,14213,7286,6927,9031,5182,0.89%
2106904,2101,Norte Maranhense,21005,Baixada Maranhense,Monção,MA,50090,66869,25362,26043,27558,31748,16185,15563,11753,19995,2.00%
2107001,2102,Oeste Maranhense,21009,Imperatriz,Montes Altos,MA,11824,15753,19521,10347,8828,9424,4910,4514,5135,4289,-0.93%
2107100,2101,Norte Maranhense,21003,Rosário,Morros,MA,15729,17197,18730,14594,17077,17805,9156,8649,6733,11072,2.01%
2107209,2101,Norte Maranhense,21006,Itapecuru Mirim,Nina Rodrigues,MA,6336,8037,7498,8289,10003,12467,6338,6129,4432,8035,4.17%
2107258,2105,Sul Maranhense,21021,Chapadas das Mangabeiras,Nova Colinas,MA,,,,3904,4829,4885,2600,2285,2210,2675,2.27%
2107308,2104,Leste Maranhense,21018,Chapadas do Alto Itapecuru,Nova Iorque,MA,4638,4764,4934,4543,4892,4600,2336,2264,2877,1723,0.12%
2107357,2102,Oeste Maranhense,21008,Pindaré,Nova Olinda do Maranhão,MA,,,,15660,17121,19125,9539,9586,11843,7282,2.02%
2107407,2103,Centro Maranhense,21010,Médio Mearim,Olho d'Água das Cunhãs,MA,22315,15323,16249,14377,17361,18505,9154,9351,9555,8950,2.56%
2107456,2101,Norte Maranhense,21005,Baixada Maranhense,Olinda Nova do Maranhão,MA,,,,10128,12068,13122,6780,6342,5943,7179,2.62%
2107506,2101,Norte Maranhense,21002,Aglomeração Urbana de São Luís,Paço do Lumiar,MA,13487,17216,53195,76188,98175,104881,50744,54137,78749,26132,3.25%
2107605,2101,Norte Maranhense,21005,Baixada Maranhense,Palmeirândia,MA,10620,14138,15565,17264,18105,18766,9388,9378,3461,15305,0.84%
2107704,2104,Leste Maranhense,21018,Chapadas do Alto Itapecuru,Paraibano,MA,10079,13550,15776,17854,19453,20104,9875,10229,15747,4357,1.19%
2107803,2104,Leste Maranhense,21017,Caxias,Parnarama,MA,24109,35287,31332,32469,34912,34613,17541,17072,13530,21083,0.64%
2107902,2104,Leste Maranhense,21018,Chapadas do Alto Itapecuru,Passagem Franca,MA,19419,21599,22649,14817,17085,17576,8702,8874,10473,7103,1.72%
2108009,2104,Leste Maranhense,21018,Chapadas do Alto Itapecuru,Pastos Bons,MA,12712,13294,14037,15460,17507,18079,9168,8911,12308,5771,1.58%
2108058,2101,Norte Maranhense,21004,Lençois Maranhenses,Paulino Neves,MA,,,,11526,12799,14498,7486,7012,4651,9847,2.32%
2108108,2102,Oeste Maranhense,21008,Pindaré,Paulo Ramos,MA,21548,26265,26978,19290,16129,20087,10137,9950,10836,9251,0.41%
2108207,2103,Centro Maranhense,21010,Médio Mearim,Pedreiras,MA,33054,48541,50603,39828,37984,39481,18889,20592,32965,6516,-0.09%
2108256,2101,Norte Maranhense,21005,Baixada Maranhense,Pedro do Rosário,MA,,,,17954,21714,22731,11830,10901,5893,16838,2.39%
2108306,2101,Norte Maranhense,21005,Baixada Maranhense,Penalva,MA,22644,26094,29287,30299,33473,34246,17397,16849,16575,17671,1.23%
2108405,2101,Norte Maranhense,21005,Baixada Maranhense,Peri Mirim,MA,10821,11395,13375,13071,12219,13807,6993,6814,3668,10139,0.55%
2108454,2104,Leste Maranhense,21015,Codó,Peritoró,MA,,,,17336,19017,20274,10119,10155,6827,13447,1.58%
2108504,2102,Oeste Maranhense,21008,Pindaré,Pindaré-Mirim,MA,23585,26469,31579,27517,30927,31145,15220,15925,22402,8743,1.25%
2108603,2101,Norte Maranhense,21005,Baixada Maranhense,Pinheiro,MA,53831,68637,82432,68030,74123,78147,38066,40081,46458,31689,1.40%
2108702,2103,Centro Maranhense,21010,Médio Mearim,Pio XII,MA,26324,24128,27300,28413,21821,22016,11004,11012,12459,9557,-2.52%
2108801,2101,Norte Maranhense,21006,Itapecuru Mirim,Pirapemas,MA,12359,14775,16443,15124,15043,17358,8656,8702,11114,6244,1.39%
2108900,2103,Centro Maranhense,21010,Médio Mearim,Poção de Pedras,MA,30215,35856,24481,22378,15853,19705,9914,9791,8377,11328,-1.26%
2109007,2105,Sul Maranhense,21019,Porto Franco,Porto Franco,MA,16058,23142,32403,16840,18692,21506,10832,10674,16865,4641,2.48%
2109056,2101,Norte Maranhense,21001,Litoral Ocidental Maranhense,Porto Rico do Maranhão,MA,,,,6380,6900,6062,3211,2851,2432,3630,-0.51%
2109106,2103,Centro Maranhense,21012,Presidente Dutra,Presidente Dutra,MA,30756,39769,42721,39541,40004,44719,21966,22753,31997,12722,1.24%
2109205,2101,Norte Maranhense,21003,Rosário,Presidente Juscelino,MA,6094,5814,6435,10693,11705,11537,6006,5531,4120,7417,0.76%
2109239,2102,Oeste Maranhense,21008,Pindaré,Presidente Médici,MA,,,,5116,6058,6370,3293,3077,3904,2466,2.22%
2109270,2101,Norte Maranhense,21005,Baixada Maranhense,Presidente Sarney,MA,,,,13718,15606,17143,8881,8262,4286,12857,2.25%
2109304,2101,Norte Maranhense,21006,Itapecuru Mirim,Presidente Vargas,MA,6264,7923,7855,10483,9798,10729,5467,5262,4588,6141,0.23%
2109403,2101,Norte Maranhense,21004,Lençois Maranhenses,Primeira Cruz,MA,15507,17568,18419,11019,11999,13896,7382,6514,4294,9602,2.35%
2109452,2101,Norte Maranhense,21002,Aglomeração Urbana de São Luís,Raposa,MA,,,,17088,24201,26280,13129,13151,16642,9638,4.40%
2109502,2105,Sul Maranhense,21020,Gerais de Balsas,Riachão,MA,17831,24223,28058,20983,21016,20218,10392,9826,10210,10008,-0.37%
2109551,2102,Oeste Maranhense,21009,Imperatriz,Ribamar Fiquene,MA,,,,6488,7170,7294,3759,3535,3662,3632,1.18%
2109601,2101,Norte Maranhense,21003,Rosário,Rosário,MA,22041,28328,40916,33665,37920,39582,19660,19922,23258,16324,1.63%
2109700,2105,Sul Maranhense,21021,Chapadas das Mangabeiras,Sambaíba,MA,5110,5506,5743,5261,5792,5484,2891,2593,2836,2648,0.42%
2109759,2103,Centro Maranhense,21011,Alto Mearim e Grajaú,Santa Filomena do Maranhão,MA,,,,4667,5526,7063,3671,3392,2293,4770,4.23%
2109809,2101,Norte Maranhense,21005,Baixada Maranhense,Santa Helena,MA,16428,33026,26434,30860,34022,39060,19383,19677,19583,19477,2.38%
2109908,2102,Oeste Maranhense,21008,Pindaré,Santa Inês,MA,27598,49442,64713,68321,82026,78182,37303,40879,73932,4250,1.36%
2110005,2102,Oeste Maranhense,21008,Pindaré,Santa Luzia,MA,47714,94224,116525,69271,69306,69392,35320,34072,25862,43530,0.02%
2110039,2102,Oeste Maranhense,21008,Pindaré,Santa Luzia do Paruá,MA,,,46387,20058,19633,22644,11377,11267,12591,10053,1.22%
2110104,2104,Leste Maranhense,21013,Baixo Parnaíba Maranhense,Santa Quitéria do Maranhão,MA,14896,18349,20937,28150,28341,29172,14716,14456,14139,15033,0.36%
2110203,2101,Norte Maranhense,21003,Rosário,Santa Rita,MA,12286,16933,21280,24922,30882,32365,16324,16041,14898,17467,2.65%
2110237,2104,Leste Maranhense,21013,Baixo Parnaíba Maranhense,Santana do Maranhão,MA,,,,10944,10537,11661,6028,5633,1842,9819,0.64%
2110278,2101,Norte Maranhense,21004,Lençois Maranhenses,Santo Amaro do Maranhão,MA,,,,9612,11155,13821,7309,6512,3610,10211,3.70%
2110302,2103,Centro Maranhense,21010,Médio Mearim,Santo Antônio dos Lopes,MA,19664,21868,17629,14253,14225,14288,7190,7098,5732,8556,0.02%
2110401,2104,Leste Maranhense,21014,Chapadinha,São Benedito do Rio Preto,MA,12211,13130,15057,16442,17191,17802,9042,8760,11049,6753,0.80%
2110500,2101,Norte Maranhense,21005,Baixada Maranhense,São Bento,MA,18743,23515,28036,31819,37449,40717,19933,20784,23496,17221,2.50%
2110609,2104,Leste Maranhense,21013,Baixo Parnaíba Maranhense,São Bernardo,MA,19795,22574,24667,22720,25480,26480,13366,13114,11800,14680,1.54%
2110658,2105,Sul Maranhense,21021,Chapadas das Mangabeiras,São Domingos do Azeitão,MA,,,,6289,6953,6983,3566,3417,4961,2022,1.05%
2110708,2103,Centro Maranhense,21012,Presidente Dutra,São Domingos do Maranhão,MA,20440,28875,34404,33049,32557,33630,16900,16730,17320,16310,0.17%
2110807,2105,Sul Maranhense,21021,Chapadas das Mangabeiras,São Félix de Balsas,MA,4850,5995,6244,5144,4398,4688,2445,2243,1627,3061,-0.92%
2110856,2102,Oeste Maranhense,21009,Imperatriz,São Francisco do Brejão,MA,,,,7062,8431,10226,5255,4971,4809,5417,3.77%
2110906,2104,Leste Maranhense,21018,Chapadas do Alto Itapecuru,São Francisco do Maranhão,MA,12237,13190,12917,12854,14194,12163,6164,5999,4117,8046,-0.55%
2111003,2101,Norte Maranhense,21005,Baixada Maranhense,São João Batista,MA,21240,23063,20447,18917,18108,19966,10164,9802,5357,14609,0.54%
2111029,2102,Oeste Maranhense,21008,Pindaré,São João do Carú,MA,,,,13495,12281,12315,6343,5972,6329,5986,-0.91%
2111052,2105,Sul Maranhense,21019,Porto Franco,São João do Paraíso,MA,,,,10365,11267,10823,5778,5045,5278,5545,0.43%
2111078,2104,Leste Maranhense,21017,Caxias,São João do Soter,MA,,,,14834,16592,17104,8754,8350,6614,10490,1.43%
2111102,2104,Leste Maranhense,21018,Chapadas do Alto Itapecuru,São João dos Patos,MA,17457,22892,25552,23182,23576,24913,12180,12733,20553,4360,0.72%
2111201,2101,Norte Maranhense,21002,Aglomeração Urbana de São Luís,São José de Ribamar,MA,23636,32309,70571,107384,131379,162925,78626,84299,37713,125212,4.26%
2111250,2103,Centro Maranhense,21012,Presidente Dutra,São José dos Basílios,MA,,,,7432,7282,7496,3760,3736,3006,4490,0.09%
2111300,2101,Norte Maranhense,21002,Aglomeração Urbana de São Luís,São Luís,MA,265486,449433,696371,870028,957515,1011943,473762,538181,955600,56343,1.52%
2111409,2103,Centro Maranhense,21010,Médio Mearim,São Luís Gonzaga do Maranhão,MA,29844,28585,26085,22772,19655,20156,10161,9995,7896,12260,-1.21%
2111508,2103,Centro Maranhense,21010,Médio Mearim,São Mateus do Maranhão,MA,17284,25008,31076,34859,38045,39109,19241,19868,28724,10385,1.16%
2111532,2102,Oeste Maranhense,21009,Imperatriz,São Pedro da Água Branca,MA,,,,10927,11113,12025,6117,5908,10707,1318,0.96%
2111573,2105,Sul Maranhense,21019,Porto Franco,São Pedro dos Crentes,MA,,,,4024,4020,4428,2360,2068,2437,1991,0.96%
2111607,2105,Sul Maranhense,21021,Chapadas das Mangabeiras,São Raimundo das Mangabeiras,MA,11336,12318,14147,14870,15962,17480,8888,8592,12540,4940,1.63%
2111631,2103,Centro Maranhense,21010,Médio Mearim,São Raimundo do Doca Bezerra,MA,,,,6671,4502,6090,3186,2904,1731,4359,-0.91%
2111672,2103,Centro Maranhense,21010,Médio Mearim,São Roberto,MA,,,,4400,4989,5957,3091,2866,2845,3112,3.08%
2111706,2101,Norte Maranhense,21005,Baixada Maranhense,São Vicente Ferrer,MA,15933,19164,18467,18406,19692,20870,10586,10284,5445,15425,1.26%
2111722,2103,Centro Maranhense,21010,Médio Mearim,Satubinha,MA,,,,10815,8399,11987,6164,5823,3634,8353,1.03%
2111748,2103,Centro Maranhense,21012,Presidente Dutra,Senador Alexandre Costa,MA,,,,8571,9071,10253,5123,5130,6160,4093,1.81%
2111763,2102,Oeste Maranhense,21009,Imperatriz,Senador La Rocque,MA,,,,16242,20793,18010,9069,8941,8733,9277,1.04%
2111789,2101,Norte Maranhense,21001,Litoral Ocidental Maranhense,Serrano do Maranhão,MA,,,,9120,10576,10924,5843,5081,4222,6702,1.82%
2111805,2103,Centro Maranhense,21011,Alto Mearim e Grajaú,Sítio Novo,MA,6500,9881,13639,15114,15549,17007,8949,8058,5137,11870,1.19%
2111904,2104,Leste Maranhense,21018,Chapadas do Alto Itapecuru,Sucupira do Norte,MA,9298,10201,10420,10378,10235,10431,5328,5103,4945,5486,0.05%
2111953,2104,Leste Maranhense,21018,Chapadas do Alto Itapecuru,Sucupira do Riachão,MA,,,,4287,4675,4610,2371,2239,2862,1748,0.73%
2112001,2105,Sul Maranhense,21020,Gerais de Balsas,Tasso Fragoso,MA,5008,5213,6197,6393,6652,7796,3972,3824,4648,3148,2.00%
2112100,2104,Leste Maranhense,21015,Codó,Timbiras,MA,18648,20240,22960,26401,26132,28007,14100,13907,17471,10536,0.59%
2112209,2104,Leste Maranhense,21017,Caxias,Timon,MA,36893,74399,107439,129692,144333,155396,75465,79931,135119,20277,1.82%
2112233,2103,Centro Maranhense,21010,Médio Mearim,Trizidela do Vale,MA,,,,16402,18300,18951,9140,9811,16168,2783,1.46%
2112274,2102,Oeste Maranhense,21008,Pindaré,Tufilândia,MA,,,,5527,5517,5607,2862,2745,2746,2861,0.14%
2112308,2103,Centro Maranhense,21011,Alto Mearim e Grajaú,Tuntum,MA,30269,34699,36006,35411,37894,39257,20025,19232,17911,21346,1.04%
2112407,2102,Oeste Maranhense,21007,Gurupi,Turiaçu,MA,23867,57471,39599,31289,32491,33956,17634,16322,10922,23034,0.82%
2112456,2102,Oeste Maranhense,21007,Gurupi,Turilândia,MA,,,,17231,20119,22850,11481,11369,10353,12497,2.86%
2112506,2101,Norte Maranhense,21004,Lençois Maranhenses,Tutóia,MA,32832,39610,43313,37728,46280,52711,26675,26036,18717,33994,3.40%
2112605,2104,Leste Maranhense,21014,Chapadinha,Urbano Santos,MA,16383,19870,23388,17603,21747,24548,12353,12195,17358,7190,3.38%
2112704,2101,Norte Maranhense,21006,Itapecuru Mirim,Vargem Grande,MA,27431,33373,32897,34707,43228,49415,24625,24790,26687,22728,3.60%
2112803,2101,Norte Maranhense,21005,Baixada Maranhense,Viana,MA,36633,43475,42161,44190,47466,49452,24694,24758,26902,22550,1.13%
2112852,2102,Oeste Maranhense,21009,Imperatriz,Vila Nova dos Martírios,MA,,,,6705,8671,11258,5930,5328,6187,5071,5.32%
2112902,2101,Norte Maranhense,21005,Baixada Maranhense,Vitória do Mearim,MA,34168,50409,50294,29953,30935,31234,15565,15669,14818,16416,0.42%
2113009,2102,Oeste Maranhense,21008,Pindaré,Vitorino Freire,MA,36792,28215,30885,27462,30235,31654,15716,15938,16164,15490,1.43%
2114007,2102,Oeste Maranhense,21008,Pindaré,Zé Doca,MA,,,58012,46134,45008,50160,24891,25269,30856,19304,0.84%
3100104,3105,Triângulo Mineiro/Alto Paranaíba,31019,Patrocínio,Abadia dos Dourados,MG,10077,8004,6492,6446,6556,6704,3399,3305,4189,2515,0.39%
3100203,3106,Central Mineira,31024,Três Marias,Abaeté,MG,20039,17858,20689,22360,22474,22700,11229,11471,19714,2986,0.15%
3100302,3112,Zona da Mata,31061,Manhuaçu,Abre Campo,MG,20013,17712,18961,13348,12867,13311,6670,6641,7284,6027,-0.03%
3100401,3112,Zona da Mata,31060,Ponte Nova,Acaiaca,MG,3324,3292,3589,3889,4056,3924,1895,2029,2553,1371,0.09%
3100500,3108,Vale do Rio Doce,31039,Ipatinga,Açucena,MG,28085,28537,24849,11489,11127,10298,5231,5067,4826,5472,-1.09%
3100609,3108,Vale do Rio Doce,31036,Peçanha,Água Boa,MG,24765,20626,15769,17795,16435,15193,7739,7454,7042,8151,-1.57%
3100708,3105,Triângulo Mineiro/Alto Paranaíba,31022,Uberaba,Água Comprida,MG,3234,1966,1808,2092,2093,2020,1071,949,1516,504,-0.35%
3100807,3109,Oeste de Minas,31045,Campo Belo,Aguanil,MG,2838,3173,3197,3562,4054,4049,2055,1994,2337,1712,1.29%
3100906,3104,Vale do Mucuri,31016,Nanuque,Águas Formosas,MG,25038,22204,22156,17845,18518,18482,9318,9164,14321,4161,0.35%
3101003,3102,Norte de Minas,31005,Salinas,Águas Vermelhas,MG,12276,14959,19185,11878,12674,12718,6527,6191,8943,3775,0.69%
3101102,3108,Vale do Rio Doce,31041,Aimorés,Aimorés,MG,38060,28869,26440,25105,24232,24969,12060,12909,19705,5264,-0.05%
3101201,3110,Sul/Sudoeste de Minas,31055,Andrelândia,Aiuruoca,MG,7314,7511,6616,6469,6099,6173,3212,2961,3123,3050,-0.47%
3101300,3110,Sul/Sudoeste de Minas,31054,São Lourenço,Alagoa,MG,3153,3032,2756,2800,2825,2709,1408,1301,1110,1599,-0.33%
3101409,3110,Sul/Sudoeste de Minas,31051,Poços de Caldas,Albertina,MG,1953,2066,2486,2841,2872,2913,1488,1425,2012,901,0.25%
3101508,3112,Zona da Mata,31066,Cataguases,Além Paraíba,MG,28442,28829,30932,33610,33495,34341,16541,17800,32062,2279,0.22%
3101607,3110,Sul/Sudoeste de Minas,31049,Alfenas,Alfenas,MG,28331,38271,52700,66957,71628,73722,36049,37673,69127,4595,0.97%
3101631,3111,Campo das Vertentes,31059,Barbacena,Alfredo Vasconcelos,MG,,,,5101,5900,6078,3116,2962,4032,2046,1.77%
3101706,3103,Jequitinhonha,31014,Almenara,Almenara,MG,40463,38826,45416,35385,36907,38779,19536,19243,31751,7028,0.92%
3101805,3108,Vale do Rio Doce,31037,Governador Valadares,Alpercata,MG,9715,5888,6752,6966,7007,7172,3590,3582,5660,1512,0.29%
3101904,3110,Sul/Sudoeste de Minas,31047,Passos,Alpinópolis,MG,15930,17978,19919,17031,17821,18490,9494,8996,14994,3496,0.83%
3102001,3110,Sul/Sudoeste de Minas,31049,Alfenas,Alterosa,MG,8060,10108,11615,12976,13286,13714,6978,6736,10000,3714,0.55%
3102050,3112,Zona da Mata,31061,Manhuaçu,Alto Caparaó,MG,,,,4673,5048,5297,2726,2571,3972,1325,1.26%
3102100,3112,Zona da Mata,31062,Viçosa,Alto Rio Doce,MG,15411,14959,14160,13858,12657,12158,6102,6056,5069,7089,-1.30%
3102209,3108,Vale do Rio Doce,31041,Aimorés,Alvarenga,MG,8613,6085,6004,5212,4558,4443,2237,2206,2119,2324,-1.58%
3102308,3107,Metropolitana de Belo Horizonte,31031,Itabira,Alvinópolis,MG,15547,15047,15324,15588,15251,15263,7536,7727,11433,3830,-0.21%
3102407,3107,Metropolitana de Belo Horizonte,31028,Conceição do Mato Dentro,Alvorada de Minas,MG,4023,3966,3893,3527,3482,3548,1777,1771,1450,2098,0.06%
3102506,3112,Zona da Mata,31062,Viçosa,Amparo do Serra,MG,7081,5941,6232,5477,5245,5052,2484,2568,2642,2410,-0.80%
3102605,3110,Sul/Sudoeste de Minas,31051,Poços de Caldas,Andradas,MG,20009,24206,28377,32968,34956,37302,18707,18595,28059,9243,1.24%
3102704,3103,Jequitinhonha,31013,Pedra Azul,Cachoeira de Pajeú,MG,8171,8234,8774,8523,9089,8962,4508,4454,4457,4505,0.50%
3102803,3110,Sul/Sudoeste de Minas,31055,Andrelândia,Andrelândia,MG,13231,14604,12497,12310,12035,12146,6061,6085,9798,2348,-0.13%
3102852,3103,Jequitinhonha,31011,Capelinha,Angelândia,MG,,,,7468,8130,8003,3950,4053,4036,3967,0.69%
3102902,3111,Campo das Vertentes,31059,Barbacena,Antônio Carlos,MG,9065,9618,9812,10870,11172,11112,5523,5589,7836,3276,0.22%
3103009,3108,Vale do Rio Doce,31039,Ipatinga,Antônio Dias,MG,11666,10663,9772,10044,9435,9573,4831,4742,4671,4902,-0.48%
3103108,3112,Zona da Mata,31063,Muriaé,Antônio Prado de Minas,MG,2525,2128,2255,1794,1962,1673,861,812,1004,669,-0.70%
3103207,3107,Metropolitana de Belo Horizonte,31027,Sete Lagoas,Araçaí,MG,1828,1704,1978,2145,2384,2247,1085,1162,1787,460,0.47%
3103306,3112,Zona da Mata,31065,Juiz de Fora,Aracitaba,MG,2825,2671,2400,2086,1875,2057,1053,1004,1640,417,-0.14%
3103405,3103,Jequitinhonha,31012,Araçuaí,Araçuaí,MG,30280,31367,33826,35713,36083,36041,17854,18187,23430,12611,0.09%
3103504,3105,Triângulo Mineiro/Alto Paranaíba,31018,Uberlândia,Araguari,MG,63368,83519,91283,101974,106403,109779,54135,55644,102558,7221,0.74%
3103603,3110,Sul/Sudoeste de Minas,31055,Andrelândia,Arantina,MG,2590,2911,2638,2906,2544,2823,1415,1408,2633,190,-0.29%
3103702,3112,Zona da Mata,31062,Viçosa,Araponga,MG,6354,6625,7874,7916,8029,8165,4198,3967,3043,5122,0.31%
3103751,3105,Triângulo Mineiro/Alto Paranaíba,31018,Uberlândia,Araporã,MG,,,,5309,6113,6233,3163,3070,5904,329,1.62%
3103801,3105,Triângulo Mineiro/Alto Paranaíba,31020,Patos de Minas,Arapuá,MG,4502,3408,3113,2744,2699,2772,1405,1367,2085,687,0.10%
3103900,3106,Central Mineira,31026,Bom Despacho,Araújos,MG,4564,4695,5507,6217,7201,7884,4011,3873,6813,1071,2.40%
3104007,3105,Triângulo Mineiro/Alto Paranaíba,31023,Araxá,Araxá,MG,35676,53414,69911,78997,87764,93683,46275,47408,92300,1383,1.72%
3104106,3110,Sul/Sudoeste de Minas,31048,São Sebastião do Paraíso,Arceburgo,MG,6822,7215,7259,8035,7994,9509,4914,4595,8179,1330,1.70%
3104205,3109,Oeste de Minas,31044,Formiga,Arcos,MG,16962,22036,27418,32687,34763,36582,18208,18374,33962,2620,1.13%
3104304,3110,Sul/Sudoeste de Minas,31049,Alfenas,Areado,MG,8049,9015,10817,12228,13181,13729,6925,6804,11530,2199,1.16%
3104403,3112,Zona da Mata,31066,Cataguases,Argirita,MG,4217,3799,3091,3173,2995,2901,1485,1416,2192,709,-0.89%
3104452,3103,Jequitinhonha,31011,Capelinha,Aricanduva,MG,,,,4255,4832,4770,2426,2344,1697,3073,1.15%
3104502,3101,Noroeste de Minas,31001,Unaí,Arinos,MG,9295,14068,17125,17709,17592,17674,9172,8502,10851,6823,-0.02%
3104601,3112,Zona da Mata,31064,Ubá,Astolfo Dutra,MG,11119,10513,11412,11805,12510,13049,6553,6496,11882,1167,1.01%
3104700,3104,Vale do Mucuri,31015,Teófilo Otoni,Ataléia,MG,33933,21341,17890,16747,15078,14451,7307,7144,7199,7252,-1.46%
3104809,3106,Central Mineira,31025,Curvelo,Augusto de Lima,MG,6118,5959,5726,5159,4589,4962,2526,2436,2926,2036,-0.39%
3104908,3110,Sul/Sudoeste de Minas,31054,São Lourenço,Baependi,MG,15561,15234,16643,17523,18016,18292,9164,9128,13245,5047,0.43%
3105004,3107,Metropolitana de Belo Horizonte,31027,Sete Lagoas,Baldim,MG,9362,7567,8383,8155,8274,7917,3948,3969,5068,2849,-0.30%
3105103,3109,Oeste de Minas,31042,Piuí,Bambuí,MG,20637,20544,20573,21697,21850,22709,11241,11468,19313,3396,0.46%
3105202,3103,Jequitinhonha,31014,Almenara,Bandeira,MG,7507,6178,5813,5318,5337,4988,2538,2450,2378,2610,-0.64%
3105301,3110,Sul/Sudoeste de Minas,31051,Poços de Caldas,Bandeira do Sul,MG,2723,3347,4100,4899,5106,5340,2742,2598,4872,468,0.87%
3105400,3107,Metropolitana de Belo Horizonte,31031,Itabira,Barão de Cocais,MG,11966,15293,20291,23391,26421,28432,14065,14367,25772,2660,1.97%
3105509,3112,Zona da Mata,31063,Muriaé,Barão de Monte Alto,MG,7357,6597,6212,6232,5656,5727,2843,2884,4120,1607,-0.84%
3105608,3111,Campo das Vertentes,31059,Barbacena,Barbacena,MG,73898,86391,99954,114126,122377,126325,60155,66170,115617,10708,1.02%
3105707,3112,Zona da Mata,31060,Ponte Nova,Barra Longa,MG,11037,8928,8902,7554,6965,6147,3024,3123,2313,3834,-2.04%
3105905,3111,Campo das Vertentes,31059,Barbacena,Barroso,MG,10940,14321,17014,18359,19352,19623,9558,10065,19003,620,0.67%
3106002,3107,Metropolitana de Belo Horizonte,31031,Itabira,Bela Vista de Minas,MG,7584,9915,9594,9846,9968,10012,4823,5189,9384,628,0.17%
3106101,3112,Zona da Mata,31065,Juiz de Fora,Belmiro Braga,MG,5328,3927,3975,3427,3067,3404,1722,1682,1099,2305,-0.07%
3106200,3107,Metropolitana de Belo Horizonte,31030,Belo Horizonte,Belo Horizonte,MG,1235030,1780839,2020161,2238526,2412937,2375444,1113654,1261790,2375444,0,0.60%
3106309,3108,Vale do Rio Doce,31039,Ipatinga,Belo Oriente,MG,9978,12630,16718,19516,21369,23397,11616,11781,19665,3732,1.83%
3106408,3107,Metropolitana de Belo Horizonte,31032,Itaguara,Belo Vale,MG,8746,7247,7040,7429,7267,7536,3776,3760,3295,4241,0.14%
3106507,3103,Jequitinhonha,31011,Capelinha,Berilo,MG,15686,17686,17745,12979,13214,12307,6286,6021,3892,8415,-0.53%
3106606,3104,Vale do Mucuri,31016,Nanuque,Bertópolis,MG,13005,10267,10573,4436,4588,4498,2384,2114,2731,1767,0.14%
3106655,3102,Norte de Minas,31005,Salinas,Berizal,MG,,,,3970,4399,4371,2193,2178,2484,1887,0.97%
3106705,3107,Metropolitana de Belo Horizonte,31030,Belo Horizonte,Betim,MG,37815,84193,170934,306675,415098,377547,186104,191443,374789,2758,2.10%
3106804,3112,Zona da Mata,31065,Juiz de Fora,Bias Fortes,MG,5591,5044,4852,4392,3880,3796,1972,1824,1502,2294,-1.45%
3106903,3112,Zona da Mata,31065,Juiz de Fora,Bicas,MG,10389,10335,11239,12793,13638,13653,6558,7095,12957,696,0.65%
3107000,3106,Central Mineira,31024,Três Marias,Biquinhas,MG,5179,3487,3055,2821,2592,2634,1322,1312,1639,995,-0.68%
3107109,3110,Sul/Sudoeste de Minas,31050,Varginha,Boa Esperança,MG,20518,25492,33015,37074,37801,38509,19263,19246,32188,6321,0.38%
3107208,3110,Sul/Sudoeste de Minas,31055,Andrelândia,Bocaina de Minas,MG,5727,5324,4944,4983,5034,5000,2634,2366,2394,2606,0.03%
3107307,3102,Norte de Minas,31009,Bocaiúva,Bocaiúva,MG,35392,40466,47045,42806,44657,46595,23329,23266,36597,9998,0.85%
3107406,3106,Central Mineira,31026,Bom Despacho,Bom Despacho,MG,27298,29347,35330,39943,42260,45626,22627,22999,42965,2661,1.34%
3107505,3110,Sul/Sudoeste de Minas,31055,Andrelândia,Bom Jardim de Minas,MG,5378,7710,6236,6643,6481,6513,3251,3262,5585,928,-0.20%
3107604,3110,Sul/Sudoeste de Minas,31047,Passos,Bom Jesus da Penha,MG,2653,2754,2922,3523,3787,3882,2023,1859,2825,1057,0.98%
3107703,3107,Metropolitana de Belo Horizonte,31031,Itabira,Bom Jesus do Amparo,MG,4057,4322,4951,4817,5412,5495,2713,2782,2516,2979,1.33%
3107802,3108,Vale do Rio Doce,31040,Caratinga,Bom Jesus do Galho,MG,21841,17446,17519,16173,15198,15376,7833,7543,10030,5346,-0.50%
3107901,3110,Sul/Sudoeste de Minas,31052,Pouso Alegre,Bom Repouso,MG,6138,6933,8901,10514,10482,10457,5444,5013,5679,4778,-0.05%
3108008,3109,Oeste de Minas,31046,Oliveira,Bom Sucesso,MG,15963,16326,16472,17064,17194,17244,8551,8693,14195,3049,0.10%
3108107,3107,Metropolitana de Belo Horizonte,31032,Itaguara,Bonfim,MG,8180,7015,7183,6866,6715,6816,3419,3397,3330,3486,-0.07%
3108206,3101,Noroeste de Minas,31001,Unaí,Bonfinópolis de Minas,MG,13296,16387,14464,6443,5828,5867,2978,2889,4142,1725,-0.93%
3108255,3102,Norte de Minas,31003,Januária,Bonito de Minas,MG,,,,7863,8787,9671,4995,4676,2211,7460,2.09%
3108305,3110,Sul/Sudoeste de Minas,31052,Pouso Alegre,Borda da Mata,MG,12520,13468,15410,14439,14892,17129,8673,8456,13729,3400,1.72%
3108404,3110,Sul/Sudoeste de Minas,31051,Poços de Caldas,Botelhos,MG,12654,13473,14247,15101,14853,14935,7479,7456,11368,3567,-0.11%
3108503,3102,Norte de Minas,31008,Grão Mogol,Botumirim,MG,7063,7087,7229,6834,6435,6497,3395,3102,3470,3027,-0.50%
3108552,3101,Noroeste de Minas,31002,Paracatu,Brasilândia de Minas,MG,,,,11473,12821,14226,7384,6842,12372,1854,2.17%
3108602,3102,Norte de Minas,31007,Montes Claros,Brasília de Minas,MG,38363,40331,44979,30266,31165,31221,15597,15624,20672,10549,0.31%
3108701,3112,Zona da Mata,31062,Viçosa,Brás Pires,MG,5725,6026,5836,5107,4592,4650,2331,2319,2231,2419,-0.93%
3108800,3108,Vale do Rio Doce,31035,Guanhães,Braúnas,MG,9405,6855,6515,5408,5208,5034,2466,2568,1596,3438,-0.71%
3108909,3110,Sul/Sudoeste de Minas,31056,Itajubá,Brasópolis,MG,15054,14263,13711,15165,14452,14663,7431,7232,7891,6772,-0.34%
3109006,3107,Metropolitana de Belo Horizonte,31030,Belo Horizonte,Brumadinho,MG,17874,18018,19308,26614,31965,34013,17027,16986,28687,5326,2.48%
3109105,3110,Sul/Sudoeste de Minas,31052,Pouso Alegre,Bueno Brandão,MG,9982,10285,10787,10932,10864,10892,5659,5233,5675,5217,-0.04%
3109204,3106,Central Mineira,31025,Curvelo,Buenópolis,MG,8593,9974,9936,10368,9522,10291,5168,5123,7767,2524,-0.07%
3109253,3108,Vale do Rio Doce,31040,Caratinga,Bugre,MG,,,,3949,3960,3990,2029,1961,1528,2462,0.10%
3109303,3101,Noroeste de Minas,31001,Unaí,Buritis,MG,9810,15429,18417,20396,21472,22729,11544,11185,16103,6626,1.09%
3109402,3102,Norte de Minas,31006,Pirapora,Buritizeiro,MG,12215,18269,24477,25904,26133,26921,13525,13396,23618,3303,0.39%
3109451,3101,Noroeste de Minas,31001,Unaí,Cabeceira Grande,MG,,,,5920,6294,6453,3394,3059,5297,1156,0.87%
3109501,3110,Sul/Sudoeste de Minas,31048,São Sebastião do Paraíso,Cabo Verde,MG,10580,12065,12223,13727,13614,13823,7452,6371,7627,6196,0.07%
3109600,3107,Metropolitana de Belo Horizonte,31027,Sete Lagoas,Cachoeira da Prata,MG,2451,2897,3656,3780,3802,3654,1718,1936,3528,126,-0.34%
3109709,3110,Sul/Sudoeste de Minas,31053,Santa Rita do Sapucaí,Cachoeira de Minas,MG,8640,8418,9323,10555,10820,11034,5767,5267,7064,3970,0.44%
3109808,3105,Triângulo Mineiro/Alto Paranaíba,31017,Ituiutaba,Cachoeira Dourada,MG,4305,2366,2284,2305,2470,2506,1250,1256,2226,280,0.84%
3109907,3107,Metropolitana de Belo Horizonte,31027,Sete Lagoas,Caetanópolis,MG,5357,5766,7403,8571,9490,10227,5121,5106,8391,1836,1.78%
3110004,3107,Metropolitana de Belo Horizonte,31030,Belo Horizonte,Caeté,MG,25166,30630,33251,36299,39039,40786,19857,20929,35451,5335,1.17%
3110103,3112,Zona da Mata,31063,Muriaé,Caiana,MG,3687,3710,4583,4367,4537,4970,2588,2382,2618,2352,1.30%
3110202,3112,Zona da Mata,31062,Viçosa,Cajuri,MG,4175,3938,3721,4190,4015,4047,2121,1926,2096,1951,-0.35%
3110301,3110,Sul/Sudoeste de Minas,31051,Poços de Caldas,Caldas,MG,14613,13676,12372,12766,13901,13630,6953,6677,7741,5889,0.66%
3110400,3109,Oeste de Minas,31044,Formiga,Camacho,MG,3028,3548,3814,3533,3204,3154,1665,1489,1458,1696,-1.13%
3110509,3110,Sul/Sudoeste de Minas,31052,Pouso Alegre,Camanducaia,MG,10849,12515,16927,20537,19708,21074,10867,10207,15475,5599,0.26%
3110608,3110,Sul/Sudoeste de Minas,31052,Pouso Alegre,Cambuí,MG,15717,17303,22302,22969,25010,26491,13234,13257,22362,4129,1.44%
3110707,3110,Sul/Sudoeste de Minas,31054,São Lourenço,Cambuquira,MG,10142,10611,11508,12538,12520,12658,6251,6407,10513,2145,0.10%
3110806,3108,Vale do Rio Doce,31037,Governador Valadares,Campanário,MG,14723,9313,7914,3419,3592,3559,1732,1827,2646,913,0.40%
3110905,3110,Sul/Sudoeste de Minas,31050,Varginha,Campanha,MG,10030,10511,12260,14098,15169,15435,7761,7674,13328,2107,0.91%
3111002,3110,Sul/Sudoeste de Minas,31051,Poços de Caldas,Campestre,MG,15578,17308,17440,20553,20251,20701,10767,9934,10971,9730,0.07%
3111101,3105,Triângulo Mineiro/Alto Paranaíba,31021,Frutal,Campina Verde,MG,21940,21152,20080,19100,18680,19285,9790,9495,14413,4872,0.10%
3111150,3102,Norte de Minas,31007,Montes Claros,Campo Azul,MG,,,,3574,3828,3685,1947,1738,1554,2131,0.31%
3111200,3109,Oeste de Minas,31045,Campo Belo,Campo Belo,MG,28619,37346,44527,49187,51375,51509,25121,26388,48600,2909,0.46%
3111309,3110,Sul/Sudoeste de Minas,31050,Varginha,Campo do Meio,MG,8125,9195,10883,11436,11476,11518,5856,5662,10106,1412,0.07%
3111408,3105,Triângulo Mineiro/Alto Paranaíba,31022,Uberaba,Campo Florido,MG,4881,4962,4519,5328,6570,6870,3679,3191,5208,1662,2.57%
3111507,3105,Triângulo Mineiro/Alto Paranaíba,31023,Araxá,Campos Altos,MG,8687,10544,11112,12819,13184,14213,7266,6947,12921,1292,1.04%
3111606,3110,Sul/Sudoeste de Minas,31050,Varginha,Campos Gerais,MG,19333,21303,23946,26541,26954,27623,14062,13561,19177,8446,0.40%
3111705,3112,Zona da Mata,31062,Viçosa,Canaã,MG,6034,5325,5411,4789,4668,4631,2375,2256,1859,2772,-0.33%
3111804,3105,Triângulo Mineiro/Alto Paranaíba,31018,Uberlândia,Canápolis,MG,9777,7084,15990,10633,11313,11357,5981,5376,10172,1185,0.66%
3111903,3109,Oeste de Minas,31045,Campo Belo,Cana Verde,MG,4524,5169,5602,5664,5712,5589,2861,2728,4068,1521,-0.13%
3112000,3109,Oeste de Minas,31045,Campo Belo,Candeias,MG,13252,12752,13609,14461,15499,14592,7463,7129,10204,4388,0.09%
3112059,3108,Vale do Rio Doce,31036,Peçanha,Cantagalo,MG,,,,3838,3967,4190,2045,2145,2478,1712,0.88%
3112109,3112,Zona da Mata,31061,Manhuaçu,Caparaó,MG,5545,5545,7923,5000,4863,5209,2743,2466,2006,3203,0.41%
3112208,3111,Campo das Vertentes,31059,Barbacena,Capela Nova,MG,5286,5405,5140,4964,4598,4758,2335,2423,2135,2623,-0.42%
3112307,3103,Jequitinhonha,31011,Capelinha,Capelinha,MG,19634,23719,30338,31231,33061,34796,17144,17652,24749,10047,1.09%
3112406,3110,Sul/Sudoeste de Minas,31047,Passos,Capetinga,MG,6528,6760,7300,7424,7154,7089,3741,3348,5919,1170,-0.46%
3112505,3107,Metropolitana de Belo Horizonte,31027,Sete Lagoas,Capim Branco,MG,4147,4930,6344,7900,8763,8880,4415,4465,8089,791,1.18%
3112604,3105,Triângulo Mineiro/Alto Paranaíba,31017,Ituiutaba,Capinópolis,MG,14280,13160,15060,14403,15302,15297,7829,7468,14309,988,0.60%
3112653,3108,Vale do Rio Doce,31037,Governador Valadares,Capitão Andrade,MG,,,,4306,4801,4929,2422,2507,3578,1351,1.36%
3112703,3102,Norte de Minas,31007,Montes Claros,Capitão Enéas,MG,11234,9934,11731,13113,14106,14206,7202,7004,11520,2686,0.80%
3112802,3110,Sul/Sudoeste de Minas,31047,Passos,Capitólio,MG,5778,5222,6823,7737,7634,8185,4166,4019,6504,1681,0.56%
3112901,3112,Zona da Mata,31061,Manhuaçu,Caputira,MG,6989,6726,7826,8834,8855,9033,4641,4392,3782,5251,0.22%
3113008,3103,Jequitinhonha,31012,Araçuaí,Caraí,MG,19006,17343,21778,20981,21530,22343,11294,11049,7190,15153,0.63%
3113107,3111,Campo das Vertentes,31059,Barbacena,Caranaíba,MG,4716,4138,3461,3478,3445,3288,1678,1610,1177,2111,-0.56%
3113206,3111,Campo das Vertentes,31059,Barbacena,Carandaí,MG,13129,15621,18833,21057,22240,23341,11554,11787,18199,5142,1.04%
3113305,3112,Zona da Mata,31063,Muriaé,Carangola,MG,34121,33370,40053,31921,32068,32321,15702,16619,26079,6242,0.12%
3113404,3108,Vale do Rio Doce,31040,Caratinga,Caratinga,MG,109772,110038,125686,77789,81731,85322,41729,43593,70548,14774,0.93%
3113503,3103,Jequitinhonha,31011,Capelinha,Carbonita,MG,6959,8273,8195,8967,10145,9158,4681,4477,6744,2414,0.21%
3113602,3110,Sul/Sudoeste de Minas,31053,Santa Rita do Sapucaí,Careaçu,MG,5119,5259,5507,5810,6029,6302,3226,3076,4706,1596,0.82%
3113701,3104,Vale do Mucuri,31016,Nanuque,Carlos Chagas,MG,32655,26901,23287,21994,20812,20087,10006,10081,13034,7053,-0.90%
3113800,3108,Vale do Rio Doce,31035,Guanhães,Carmésia,MG,3059,3037,2242,2246,2550,2460,1227,1233,1321,1139,0.91%
3113909,3110,Sul/Sudoeste de Minas,31050,Varginha,Carmo da Cachoeira,MG,7294,8569,10279,11600,11656,11836,5976,5860,8966,2870,0.20%
3114006,3109,Oeste de Minas,31046,Oliveira,Carmo da Mata,MG,9525,9545,10231,10400,10942,10927,5452,5475,8610,2317,0.50%
3114105,3110,Sul/Sudoeste de Minas,31054,São Lourenço,Carmo de Minas,MG,9774,9728,11291,12545,13657,13752,6896,6856,10189,3563,0.92%
3114204,3109,Oeste de Minas,31043,Divinópolis,Carmo do Cajuru,MG,10855,12504,14415,17157,18943,20018,10034,9984,17341,2677,1.55%
3114303,3105,Triângulo Mineiro/Alto Paranaíba,31020,Patos de Minas,Carmo do Paranaíba,MG,25978,25382,27358,29460,30712,29752,15042,14710,25216,4536,0.10%
3114402,3110,Sul/Sudoeste de Minas,31049,Alfenas,Carmo do Rio Claro,MG,13763,14830,17470,19732,19480,20426,10483,9943,14362,6064,0.35%
3114501,3109,Oeste de Minas,31046,Oliveira,Carmópolis de Minas,MG,9999,11322,13635,14348,15743,17050,8762,8288,11823,5227,1.74%
3114550,3105,Triângulo Mineiro/Alto Paranaíba,31021,Frutal,Carneirinho,MG,,,,8910,8859,9467,4866,4601,6971,2496,0.61%
3114600,3111,Campo das Vertentes,31057,Lavras,Carrancas,MG,4881,4395,4528,3887,4015,3952,2009,1943,2613,1339,0.17%
3114709,3110,Sul/Sudoeste de Minas,31049,Alfenas,Carvalhópolis,MG,2152,2324,2575,3089,3234,3350,1705,1645,2461,889,0.81%
3114808,3110,Sul/Sudoeste de Minas,31055,Andrelândia,Carvalhos,MG,5278,5211,4680,4733,4611,4555,2343,2212,2436,2119,-0.38%
3114907,3107,Metropolitana de Belo Horizonte,31034,Conselheiro Lafaiete,Casa Grande,MG,2105,2209,2093,2264,2100,2242,1153,1089,1122,1120,-0.10%
3115003,3105,Triângulo Mineiro/Alto Paranaíba,31018,Uberlândia,Cascalho Rico,MG,3403,2447,2629,2622,2799,2857,1527,1330,1796,1061,0.86%
3115102,3110,Sul/Sudoeste de Minas,31047,Passos,Cássia,MG,16378,16448,15818,17278,17067,17428,8807,8621,14237,3191,0.09%
3115201,3111,Campo das Vertentes,31058,São João Del Rei,Conceição da Barra de Minas,MG,3937,3374,3898,4021,3960,3961,2067,1894,2795,1166,-0.15%
3115300,3112,Zona da Mata,31066,Cataguases,Cataguases,MG,43846,49269,58138,63980,67384,69810,34240,35570,66833,2977,0.88%
3115359,3107,Metropolitana de Belo Horizonte,31031,Itabira,Catas Altas,MG,,,,4241,4561,4839,2384,2455,4233,606,1.33%
3115409,3107,Metropolitana de Belo Horizonte,31034,Conselheiro Lafaiete,Catas Altas da Noruega,MG,3104,3044,3379,3288,3424,3462,1761,1701,1429,2033,0.52%
3115458,3104,Vale do Mucuri,31015,Teófilo Otoni,Catuji,MG,,,,7332,6597,6705,3355,3350,1688,5017,-0.89%
3115474,3102,Norte de Minas,31004,Janaúba,Catuti,MG,,,,5337,5303,5102,2629,2473,2978,2124,-0.45%
3115508,3110,Sul/Sudoeste de Minas,31054,São Lourenço,Caxambu,MG,14315,16867,19491,22129,21009,21719,10532,11187,21266,453,-0.19%
3115607,3106,Central Mineira,31024,Três Marias,Cedro do Abaeté,MG,2282,1495,1402,1289,1203,1212,628,584,1033,179,-0.61%
3115706,3108,Vale do Rio Doce,31038,Mantena,Central de Minas,MG,10566,6975,6443,6548,6590,6774,3302,3472,5596,1178,0.34%
3115805,3105,Triângulo Mineiro/Alto Paranaíba,31018,Uberlândia,Centralina,MG,8281,11239,13783,10236,10219,10270,5252,5018,9316,954,0.03%
3115904,3112,Zona da Mata,31065,Juiz de Fora,Chácara,MG,3514,3062,3257,2370,2613,2792,1410,1382,1903,889,1.65%
3116001,3112,Zona da Mata,31061,Manhuaçu,Chalé,MG,6120,5475,5529,5663,5465,5647,2868,2779,2783,2864,-0.03%
3116100,3103,Jequitinhonha,31011,Capelinha,Chapada do Norte,MG,14073,14758,15790,15225,15449,15165,7422,7743,5702,9463,-0.04%
3116159,3102,Norte de Minas,31003,Januária,Chapada Gaúcha,MG,,,,7270,10266,10792,5624,5168,5751,5041,4.03%
3116209,3112,Zona da Mata,31065,Juiz de Fora,Chiador,MG,4735,3898,2900,2958,2893,2785,1355,1430,1486,1299,-0.60%
3116308,3112,Zona da Mata,31062,Viçosa,Cipotânea,MG,6269,6331,6240,6345,6539,6547,3347,3200,3014,3533,0.31%
3116407,3110,Sul/Sudoeste de Minas,31047,Passos,Claraval,MG,4300,3710,3409,4242,4295,4544,2371,2173,2532,2012,0.69%
3116506,3102,Norte de Minas,31007,Montes Claros,Claro dos Poções,MG,8567,7982,8238,8193,8131,7781,3964,3817,5257,2524,-0.51%
3116605,3109,Oeste de Minas,31043,Divinópolis,Cláudio,MG,13610,16056,18481,22522,24590,25777,13090,12687,21160,4617,1.36%
3116704,3112,Zona da Mata,31062,Viçosa,Coimbra,MG,5090,4738,5477,6523,6886,7054,3548,3506,5156,1898,0.79%
3116803,3108,Vale do Rio Doce,31035,Guanhães,Coluna,MG,11054,9090,10342,9369,9281,9024,4480,4544,3814,5210,-0.37%
3116902,3105,Triângulo Mineiro/Alto Paranaíba,31021,Frutal,Comendador Gomes,MG,3671,3224,2964,2842,3087,2972,1591,1381,1508,1464,0.45%
3117009,3103,Jequitinhonha,31013,Pedra Azul,Comercinho,MG,9767,9308,10240,10204,8720,8309,4231,4078,3555,4754,-2.03%
3117108,3110,Sul/Sudoeste de Minas,31049,Alfenas,Conceição da Aparecida,MG,7520,8246,9158,9372,10215,9814,5008,4806,6201,3613,0.46%
3117207,3110,Sul/Sudoeste de Minas,31053,Santa Rita do Sapucaí,Conceição das Pedras,MG,2384,2139,2493,2714,2726,2749,1468,1281,1509,1240,0.13%
3117306,3105,Triângulo Mineiro/Alto Paranaíba,31022,Uberaba,Conceição das Alagoas,MG,12024,13549,14054,17156,20426,23055,12054,11001,20892,2163,3.00%
3117405,3108,Vale do Rio Doce,31041,Aimorés,Conceição de Ipanema,MG,7420,5613,5163,4377,4396,4467,2248,2219,1534,2933,0.20%
3117504,3107,Metropolitana de Belo Horizonte,31028,Conceição do Mato Dentro,Conceição do Mato Dentro,MG,20609,19766,18721,18637,18070,17914,9004,8910,12274,5640,-0.39%
3117603,3109,Oeste de Minas,31043,Divinópolis,Conceição do Pará,MG,4347,3483,3899,4793,4725,5162,2657,2505,2015,3147,0.74%
3117702,3110,Sul/Sudoeste de Minas,31054,São Lourenço,Conceição do Rio Verde,MG,9444,9900,10472,12273,12708,12950,6519,6431,11450,1500,0.54%
3117801,3110,Sul/Sudoeste de Minas,31053,Santa Rita do Sapucaí,Conceição dos Ouros,MG,6341,6615,7695,8929,10204,10388,5311,5077,8123,2265,1.52%
3117836,3102,Norte de Minas,31003,Januária,Cônego Marinho,MG,,,,6477,6279,7089,3596,3493,1915,5174,0.91%
3117876,3107,Metropolitana de Belo Horizonte,31030,Belo Horizonte,Confins,MG,,,,4880,5680,5943,2929,3014,5943,0,1.99%
3117900,3110,Sul/Sudoeste de Minas,31052,Pouso Alegre,Congonhal,MG,5612,5707,7094,8726,9692,10480,5412,5068,7766,2714,1.85%
3118007,3107,Metropolitana de Belo Horizonte,31034,Conselheiro Lafaiete,Congonhas,MG,20374,30788,35364,41256,45984,48550,23864,24686,47253,1297,1.64%
3118106,3107,Metropolitana de Belo Horizonte,31028,Conceição do Mato Dentro,Congonhas do Norte,MG,3820,4353,4533,4897,5110,4947,2481,2466,2602,2345,0.10%
3118205,3105,Triângulo Mineiro/Alto Paranaíba,31022,Uberaba,Conquista,MG,7682,7244,7048,6101,6580,6527,3313,3214,5672,855,0.68%
3118304,3107,Metropolitana de Belo Horizonte,31034,Conselheiro Lafaiete,Conselheiro Lafaiete,MG,50960,72445,89059,102836,109280,116527,56395,60132,111286,5241,1.26%
3118403,3108,Vale do Rio Doce,31041,Aimorés,Conselheiro Pena,MG,41338,32238,30569,21734,21793,22232,10745,11487,17591,4641,0.23%
3118502,3110,Sul/Sudoeste de Minas,31056,Itajubá,Consolação,MG,2060,1593,1708,1699,1695,1727,888,839,950,777,0.16%
3118601,3107,Metropolitana de Belo Horizonte,31030,Belo Horizonte,Contagem,MG,111235,280470,449588,538017,608650,603048,292628,310420,601009,2039,1.15%
3118700,3110,Sul/Sudoeste de Minas,31050,Varginha,Coqueiral,MG,7223,8137,9214,9612,9466,9287,4632,4655,6586,2701,-0.34%
3118809,3102,Norte de Minas,31007,Montes Claros,Coração de Jesus,MG,30140,30098,32688,25729,26131,26035,13182,12853,14767,11268,0.12%
3118908,3107,Metropolitana de Belo Horizonte,31027,Sete Lagoas,Cordisburgo,MG,8092,7932,8451,8522,9033,8667,4435,4232,5961,2706,0.17%
3119005,3110,Sul/Sudoeste de Minas,31053,Santa Rita do Sapucaí,Cordislândia,MG,2682,2678,3030,3359,3570,3435,1769,1666,2757,678,0.22%
3119104,3106,Central Mineira,31025,Curvelo,Corinto,MG,24238,23894,25096,24546,22741,23901,11756,12145,21191,2710,-0.27%
3119203,3108,Vale do Rio Doce,31037,Governador Valadares,Coroaci,MG,11650,10263,10800,10802,10776,10274,5229,5045,5182,5092,-0.50%
3119302,3105,Triângulo Mineiro/Alto Paranaíba,31019,Patrocínio,Coromandel,MG,20098,20934,24954,27452,27392,27551,13959,13592,21669,5882,0.04%
3119401,3108,Vale do Rio Doce,31039,Ipatinga,Coronel Fabriciano,MG,41120,75701,87439,97451,100805,103797,50066,53731,102498,1299,0.63%
3119500,3103,Jequitinhonha,31012,Araçuaí,Coronel Murta,MG,8247,8322,9191,9134,9120,9117,4657,4460,6693,2424,-0.02%
3119609,3112,Zona da Mata,31065,Juiz de Fora,Coronel Pacheco,MG,3925,3291,3252,2900,2457,2983,1515,1468,2145,838,0.28%
3119708,3111,Campo das Vertentes,31058,São João Del Rei,Coronel Xavier Chaves,MG,2879,3278,2988,3185,3194,3301,1645,1656,1799,1502,0.36%
3119807,3109,Oeste de Minas,31042,Piuí,Córrego Danta,MG,7108,5799,4368,3674,3423,3391,1789,1602,2088,1303,-0.80%
3119906,3110,Sul/Sudoeste de Minas,31052,Pouso Alegre,Córrego do Bom Jesus,MG,4098,3514,3929,3827,3724,3732,1950,1782,2051,1681,-0.25%
3119955,3109,Oeste de Minas,31044,Formiga,Córrego Fundo,MG,,,,5179,5635,5821,3001,2820,4438,1383,1.18%
3120003,3108,Vale do Rio Doce,31040,Caratinga,Córrego Novo,MG,9810,7829,7830,3638,3155,3129,1559,1570,2039,1090,-1.50%
3120102,3103,Jequitinhonha,31010,Diamantina,Couto de Magalhães de Minas,MG,3313,3119,4012,4007,4332,4204,2103,2101,3835,369,0.48%
3120151,3104,Vale do Mucuri,31016,Nanuque,Crisólita,MG,,,,5298,5659,6040,3076,2964,3489,2551,1.32%
3120201,3109,Oeste de Minas,31045,Campo Belo,Cristais,MG,8049,7920,8842,9518,10631,11301,5771,5530,8854,2447,1.73%
3120300,3102,Norte de Minas,31008,Grão Mogol,Cristália,MG,4760,4777,5003,5583,5731,5760,2911,2849,3053,2707,0.31%
3120409,3107,Metropolitana de Belo Horizonte,31034,Conselheiro Lafaiete,Cristiano Otoni,MG,3361,4049,4214,4905,4881,5007,2516,2491,4156,851,0.21%
3120508,3110,Sul/Sudoeste de Minas,31056,Itajubá,Cristina,MG,10124,9306,9997,10339,10955,10214,5226,4988,5961,4253,-0.12%
3120607,3107,Metropolitana de Belo Horizonte,31032,Itaguara,Crucilândia,MG,4917,4306,4579,4477,4593,4749,2421,2328,2976,1773,0.59%
3120706,3105,Triângulo Mineiro/Alto Paranaíba,31019,Patrocínio,Cruzeiro da Fortaleza,MG,2975,2717,3068,3720,3760,3934,2008,1926,3361,573,0.56%
3120805,3110,Sul/Sudoeste de Minas,31055,Andrelândia,Cruzília,MG,9196,10332,11674,13765,14656,14596,7254,7342,13295,1301,0.59%
3120839,3108,Vale do Rio Doce,31041,Aimorés,Cuparaque,MG,,,,4367,4404,4680,2355,2325,3885,795,0.69%
3120870,3102,Norte de Minas,31005,Salinas,Curral de Dentro,MG,,,,5973,6907,6930,3502,3428,5852,1078,1.50%
3120904,3106,Central Mineira,31025,Curvelo,Curvelo,MG,45423,50774,59015,67512,71611,74184,36115,38069,67363,6821,0.95%
3121001,3103,Jequitinhonha,31010,Diamantina,Datas,MG,3993,3519,4702,5040,5418,5210,2548,2662,3092,2118,0.33%
3121100,3110,Sul/Sudoeste de Minas,31056,Itajubá,Delfim Moreira,MG,10017,7297,7860,8032,7834,7971,4187,3784,3025,4946,-0.08%
3121209,3110,Sul/Sudoeste de Minas,31047,Passos,Delfinópolis,MG,7500,6389,6698,6577,6698,6830,3550,3280,4846,1984,0.38%
3121258,3105,Triângulo Mineiro/Alto Paranaíba,31022,Uberaba,Delta,MG,,,,5065,6600,8107,4563,3544,7597,510,4.82%
3121308,3112,Zona da Mata,31065,Juiz de Fora,Descoberto,MG,4464,3895,4083,4531,4876,4757,2401,2356,4069,688,0.49%
3121407,3107,Metropolitana de Belo Horizonte,31034,Conselheiro Lafaiete,Desterro de Entre Rios,MG,7103,7335,6825,6807,6914,7002,3572,3430,3596,3406,0.28%
3121506,3111,Campo das Vertentes,31059,Barbacena,Desterro do Melo,MG,4014,3850,3525,3211,3198,3009,1544,1465,1390,1619,-0.65%
3121605,3103,Jequitinhonha,31010,Diamantina,Diamantina,MG,34672,35925,44299,44259,44746,45884,22251,23633,40062,5822,0.36%
3121704,3107,Metropolitana de Belo Horizonte,31033,Ouro Preto,Diogo de Vasconcelos,MG,4997,4583,4161,3972,3941,3848,1930,1918,1099,2749,-0.32%
3121803,3107,Metropolitana de Belo Horizonte,31031,Itabira,Dionísio,MG,12305,10003,10150,10191,10234,8739,4304,4435,7165,1574,-1.53%
3121902,3112,Zona da Mata,31064,Ubá,Divinésia,MG,4375,3132,3009,3188,3276,3292,1661,1631,2174,1118,0.32%
3122009,3112,Zona da Mata,31063,Muriaé,Divino,MG,18129,21260,21757,18420,19245,19131,9684,9447,10795,8336,0.38%
3122108,3108,Vale do Rio Doce,31037,Governador Valadares,Divino das Laranjeiras,MG,10402,5755,5281,4965,4934,4937,2460,2477,4108,829,-0.06%
3122207,3108,Vale do Rio Doce,31035,Guanhães,Divinolândia de Minas,MG,5024,4848,5790,6434,6724,7036,3483,3553,5772,1264,0.90%
3122306,3109,Oeste de Minas,31043,Divinópolis,Divinópolis,MG,80344,117333,151462,183962,209921,213076,103876,109200,207573,5503,1.48%
3122355,3102,Norte de Minas,31005,Salinas,Divisa Alegre,MG,,,,4815,5793,5884,2905,2979,5693,191,2.03%
3122405,3110,Sul/Sudoeste de Minas,31049,Alfenas,Divisa Nova,MG,3555,3896,4917,5539,5619,5760,2982,2778,4660,1100,0.39%
3122454,3103,Jequitinhonha,31014,Almenara,Divisópolis,MG,,,,6480,7852,8970,4658,4312,6404,2566,3.31%
3122470,3101,Noroeste de Minas,31001,Unaí,Dom Bosco,MG,,,,4055,3781,3817,2024,1793,2052,1765,-0.60%
3122504,3108,Vale do Rio Doce,31040,Caratinga,Dom Cavati,MG,6523,6246,6166,5473,5593,5210,2535,2675,4608,602,-0.49%
3122603,3107,Metropolitana de Belo Horizonte,31028,Conceição do Mato Dentro,Dom Joaquim,MG,7454,6233,4960,4698,4530,4535,2222,2313,2922,1613,-0.35%
3122702,3112,Zona da Mata,31060,Ponte Nova,Dom Silvério,MG,12859,10021,10028,5228,5284,5193,2491,2702,4055,1138,-0.07%
3122801,3110,Sul/Sudoeste de Minas,31056,Itajubá,Dom Viçoso,MG,2821,2670,2870,3034,3020,2994,1544,1450,998,1996,-0.13%
3122900,3112,Zona da Mata,31066,Cataguases,Dona Eusébia,MG,4132,3872,4804,5362,5569,6001,3038,2963,5133,868,1.13%
3123007,3111,Campo das Vertentes,31058,São João Del Rei,Dores de Campos,MG,5594,6384,7255,8349,9276,9303,4616,4687,8461,842,1.09%
3123106,3108,Vale do Rio Doce,31035,Guanhães,Dores de Guanhães,MG,6278,5205,5403,5380,5528,5223,2612,2611,1622,3601,-0.30%
3123205,3106,Central Mineira,31026,Bom Despacho,Dores do Indaiá,MG,15707,15196,13887,14388,13996,13781,6716,7065,12617,1164,-0.43%
3123304,3112,Zona da Mata,31064,Ubá,Dores do Turvo,MG,5335,4841,5043,4799,4572,4439,2299,2140,2023,2416,-0.78%
3123403,3109,Oeste de Minas,31042,Piuí,Doresópolis,MG,1901,1561,1247,1350,1492,1440,747,693,1132,308,0.65%
3123502,3105,Triângulo Mineiro/Alto Paranaíba,31019,Patrocínio,Douradoquara,MG,3194,2125,1583,1785,1846,1841,970,871,1233,608,0.31%
3123528,3112,Zona da Mata,31061,Manhuaçu,Durandé,MG,,,,7005,6932,7402,3761,3641,3530,3872,0.55%
3123601,3110,Sul/Sudoeste de Minas,31050,Varginha,Elói Mendes,MG,14697,16981,19373,21947,24161,25266,12515,12751,20417,4849,1.42%
3123700,3108,Vale do Rio Doce,31037,Governador Valadares,Engenheiro Caldas,MG,10687,8501,8815,9347,10317,10276,4956,5320,8321,1955,0.95%
3123809,3102,Norte de Minas,31009,Bocaiúva,Engenheiro Navarro,MG,5285,6070,7566,7085,7079,7125,3620,3505,4753,2372,0.06%
3123858,3108,Vale do Rio Doce,31040,Caratinga,Entre Folhas,MG,,,,5054,4931,5172,2567,2605,3886,1286,0.23%
3123908,3107,Metropolitana de Belo Horizonte,31034,Conselheiro Lafaiete,Entre Rios de Minas,MG,10316,12943,12255,13114,13887,14262,7084,7178,9871,4391,0.84%
3124005,3112,Zona da Mata,31062,Viçosa,Ervália,MG,13183,13335,15551,17018,18002,17958,9001,8957,9482,8476,0.54%
3124104,3107,Metropolitana de Belo Horizonte,31030,Belo Horizonte,Esmeraldas,MG,15698,16215,24298,47090,55436,60153,30259,29894,56112,4041,2.48%
3124203,3112,Zona da Mata,31063,Muriaé,Espera Feliz,MG,10637,11466,19543,20528,20835,22859,11506,11353,14177,8682,1.08%
3124302,3102,Norte de Minas,31004,Janaúba,Espinosa,MG,29351,32716,37594,30978,31322,31113,15291,15822,18023,13090,0.04%
3124401,3110,Sul/Sudoeste de Minas,31052,Pouso Alegre,Espírito Santo do Dourado,MG,3580,3551,4045,4162,4293,4429,2341,2088,1683,2746,0.62%
3124500,3110,Sul/Sudoeste de Minas,31052,Pouso Alegre,Estiva,MG,10030,10601,9681,10366,10920,10844,5609,5235,4899,5945,0.45%
3124609,3112,Zona da Mata,31066,Cataguases,Estrela Dalva,MG,3328,2671,2617,2674,2497,2470,1232,1238,1781,689,-0.79%
3124708,3106,Central Mineira,31026,Bom Despacho,Estrela do Indaiá,MG,6351,4305,3982,3597,3651,3515,1770,1745,2776,739,-0.23%
3124807,3105,Triângulo Mineiro/Alto Paranaíba,31019,Patrocínio,Estrela do Sul,MG,8524,7350,7233,6883,7136,7457,3911,3546,6058,1399,0.80%
3124906,3112,Zona da Mata,31063,Muriaé,Eugenópolis,MG,10419,9003,9825,9766,10291,10541,5314,5227,7397,3144,0.77%
3125002,3112,Zona da Mata,31065,Juiz de Fora,Ewbank da Câmara,MG,3294,2991,3286,3608,3567,3752,1854,1898,3458,294,0.39%
3125101,3110,Sul/Sudoeste de Minas,31052,Pouso Alegre,Extrema,MG,8910,10781,14314,19219,24886,28564,14407,14157,25992,2572,4.04%
3125200,3110,Sul/Sudoeste de Minas,31049,Alfenas,Fama,MG,2028,1985,2115,2353,2219,2348,1179,1169,1518,830,-0.02%
3125309,3112,Zona da Mata,31063,Muriaé,Faria Lemos,MG,4410,3500,3103,3606,3612,3377,1717,1660,2332,1045,-0.65%
3125408,3103,Jequitinhonha,31010,Diamantina,Felício dos Santos,MG,4679,4600,5802,5729,5685,5137,2564,2573,2229,2908,-1.08%
3125507,3103,Jequitinhonha,31010,Diamantina,São Gonçalo do Rio Preto,MG,2799,2809,2996,2963,3124,3039,1474,1565,1952,1087,0.25%
3125606,3103,Jequitinhonha,31014,Almenara,Felisburgo,MG,4545,5138,6001,6241,6687,6887,3513,3374,5092,1795,0.99%
3125705,3106,Central Mineira,31025,Curvelo,Felixlândia,MG,9870,10654,11926,12784,13618,14121,7046,7075,10922,3199,1.00%
3125804,3108,Vale do Rio Doce,31037,Governador Valadares,Fernandes Tourinho,MG,5870,3608,3277,2563,2612,3033,1550,1483,2016,1017,1.70%
3125903,3107,Metropolitana de Belo Horizonte,31031,Itabira,Ferros,MG,20016,14450,14128,12331,11387,10837,5389,5448,5092,5745,-1.28%
3125952,3112,Zona da Mata,31063,Muriaé,Fervedouro,MG,,,,9671,10261,10351,5330,5021,4764,5587,0.68%
3126000,3107,Metropolitana de Belo Horizonte,31029,Pará de Minas,Florestal,MG,4430,4809,5053,5647,5928,6603,3245,3358,5501,1102,1.58%
3126109,3109,Oeste de Minas,31044,Formiga,Formiga,MG,46864,52394,61755,62907,64585,65064,32089,32975,59452,5612,0.34%
3126208,3101,Noroeste de Minas,31001,Unaí,Formoso,MG,4172,5458,7199,6522,6612,8173,4280,3893,5173,3000,2.28%
3126307,3110,Sul/Sudoeste de Minas,31047,Passos,Fortaleza de Minas,MG,3784,3819,3800,3759,3837,4098,2101,1997,2950,1148,0.87%
3126406,3107,Metropolitana de Belo Horizonte,31027,Sete Lagoas,Fortuna de Minas,MG,2169,1898,2285,2437,2454,2701,1393,1308,1861,840,1.03%
3126505,3103,Jequitinhonha,31011,Capelinha,Francisco Badaró,MG,14491,15569,17177,10309,10269,10244,5275,4969,3194,7050,-0.06%
3126604,3102,Norte de Minas,31009,Bocaiúva,Francisco Dumont,MG,4328,3577,3666,4488,4759,4867,2541,2326,3201,1666,0.81%
3126703,3102,Norte de Minas,31007,Montes Claros,Francisco Sá,MG,26736,24633,24993,23562,24838,24918,12945,11973,14902,10016,0.56%
3126752,3104,Vale do Mucuri,31015,Teófilo Otoni,Franciscópolis,MG,,,,6426,5664,5803,2969,2834,2398,3405,-1.01%
3126802,3104,Vale do Mucuri,31015,Teófilo Otoni,Frei Gaspar,MG,9656,8449,7007,5975,6343,5880,2968,2912,1915,3965,-0.16%
3126901,3108,Vale do Rio Doce,31037,Governador Valadares,Frei Inocêncio,MG,9899,7462,7245,8176,8873,8924,4360,4564,6768,2156,0.88%
3126950,3108,Vale do Rio Doce,31036,Peçanha,Frei Lagonegro,MG,,,,3191,3342,3329,1688,1641,618,2711,0.42%
3127008,3105,Triângulo Mineiro/Alto Paranaíba,31021,Frutal,Fronteira,MG,5322,7050,7902,9024,13983,14047,7233,6814,13101,946,4.52%
3127057,3104,Vale do Mucuri,31016,Nanuque,Fronteira dos Vales,MG,5967,5348,5103,4902,4835,4687,2389,2298,3038,1649,-0.45%
3127073,3102,Norte de Minas,31005,Salinas,Fruta de Leite,MG,,,,6777,6327,5940,3024,2916,2036,3904,-1.31%
3127107,3105,Triângulo Mineiro/Alto Paranaíba,31021,Frutal,Frutal,MG,30669,34271,41424,46566,51766,53474,27074,26400,46095,7379,1.39%
3127206,3107,Metropolitana de Belo Horizonte,31027,Sete Lagoas,Funilândia,MG,2598,2400,2616,3281,3639,3854,1958,1896,2029,1825,1.62%
3127305,3108,Vale do Rio Doce,31037,Governador Valadares,Galiléia,MG,16195,12848,10819,7241,7302,6966,3415,3551,5698,1268,-0.39%
3127339,3102,Norte de Minas,31004,Janaúba,Gameleiras,MG,,,,5263,5226,5139,2624,2515,1413,3726,-0.24%
3127354,3102,Norte de Minas,31007,Montes Claros,Glaucilândia,MG,,,,2767,2932,2964,1498,1466,1048,1916,0.69%
3127370,3108,Vale do Rio Doce,31041,Aimorés,Goiabeira,MG,,,,2715,3052,3054,1487,1567,2474,580,1.18%
3127388,3112,Zona da Mata,31065,Juiz de Fora,Goianá,MG,,,,3323,3643,3659,1845,1814,2969,690,0.97%
3127404,3110,Sul/Sudoeste de Minas,31052,Pouso Alegre,Gonçalves,MG,4715,4249,3877,4123,4270,4220,2192,2028,1164,3056,0.23%
3127503,3108,Vale do Rio Doce,31035,Guanhães,Gonzaga,MG,5366,5511,6163,5713,5620,5919,2927,2992,3239,2680,0.35%
3127602,3103,Jequitinhonha,31010,Diamantina,Gouveia,MG,8556,9326,11457,11689,11569,11687,5660,6027,8234,3453,-0.00%
3127701,3108,Vale do Rio Doce,31037,Governador Valadares,Governador Valadares,MG,162020,196117,230524,247131,260396,263594,125059,138535,253234,10360,0.65%
3127800,3102,Norte de Minas,31008,Grão Mogol,Grão Mogol,MG,20323,22199,20284,14224,14594,15026,7727,7299,5392,9634,0.55%
3127909,3105,Triângulo Mineiro/Alto Paranaíba,31019,Patrocínio,Grupiara,MG,2173,1359,1265,1376,1412,1373,714,659,1173,200,-0.02%
3128006,3108,Vale do Rio Doce,31035,Guanhães,Guanhães,MG,22426,22778,25173,27828,29286,31266,15203,16063,25450,5816,1.17%
3128105,3110,Sul/Sudoeste de Minas,31050,Varginha,Guapé,MG,9746,11338,11852,13620,13152,13838,7278,6560,7176,6662,0.16%
3128204,3112,Zona da Mata,31060,Ponte Nova,Guaraciaba,MG,11685,10573,10541,10262,10428,10223,5174,5049,3218,7005,-0.04%
3128253,3102,Norte de Minas,31009,Bocaiúva,Guaraciama,MG,,,,4469,4554,4719,2378,2341,3027,1692,0.55%
3128303,3110,Sul/Sudoeste de Minas,31048,São Sebastião do Paraíso,Guaranésia,MG,11176,13442,16251,18628,18147,18714,9498,9216,16836,1878,0.05%
3128402,3112,Zona da Mata,31064,Ubá,Guarani,MG,10063,7884,8046,8520,9487,8688,4428,4260,6886,1802,0.20%
3128501,3112,Zona da Mata,31065,Juiz de Fora,Guarará,MG,2868,2847,3814,4166,4017,3932,1952,1980,3490,442,-0.58%
3128600,3101,Noroeste de Minas,31002,Paracatu,Guarda-Mor,MG,4525,5137,5919,6656,6577,6569,3424,3145,3692,2877,-0.13%
3128709,3110,Sul/Sudoeste de Minas,31048,São Sebastião do Paraíso,Guaxupé,MG,24273,30114,39611,47036,47894,49491,24653,24838,46532,2959,0.51%
3128808,3112,Zona da Mata,31064,Ubá,Guidoval,MG,10158,7249,7177,7490,7321,7210,3640,3570,5203,2007,-0.38%
3128907,3105,Triângulo Mineiro/Alto Paranaíba,31020,Patos de Minas,Guimarânia,MG,5417,5447,5739,6384,6946,7290,3712,3578,5960,1330,1.34%
3129004,3112,Zona da Mata,31064,Ubá,Guiricema,MG,13933,10443,10297,9259,8906,8697,4421,4276,4225,4472,-0.62%
3129103,3105,Triângulo Mineiro/Alto Paranaíba,31017,Ituiutaba,Gurinhatã,MG,14120,8908,7640,6883,6194,6137,3237,2900,2692,3445,-1.14%
3129202,3110,Sul/Sudoeste de Minas,31053,Santa Rita do Sapucaí,Heliodora,MG,4928,4773,5256,5657,6005,6120,3116,3004,4430,1690,0.79%
3129301,3108,Vale do Rio Doce,31040,Caratinga,Iapu,MG,16673,14933,14289,9718,10851,10331,5139,5192,7175,3156,0.61%
3129400,3111,Campo das Vertentes,31059,Barbacena,Ibertioga,MG,4458,4634,4854,5140,5057,5029,2535,2494,3459,1570,-0.22%
3129509,3105,Triângulo Mineiro/Alto Paranaíba,31023,Araxá,Ibiá,MG,16782,16107,18317,21044,22069,23265,11872,11393,19695,3570,1.01%
3129608,3102,Norte de Minas,31006,Pirapora,Ibiaí,MG,4088,5550,7097,7251,7571,7839,4032,3807,6004,1835,0.78%
3129657,3102,Norte de Minas,31007,Montes Claros,Ibiracatu,MG,,,,6534,5898,6155,3218,2937,3123,3032,-0.60%
3129707,3110,Sul/Sudoeste de Minas,31047,Passos,Ibiraci,MG,8400,8030,8522,10229,11023,12177,6365,5812,8208,3969,1.76%
3129806,3107,Metropolitana de Belo Horizonte,31030,Belo Horizonte,Ibirité,MG,19508,39967,92675,133044,148535,159026,77875,81151,158662,364,1.80%
3129905,3110,Sul/Sudoeste de Minas,31051,Poços de Caldas,Ibitiúra de Minas,MG,2624,2616,2691,3301,3382,3406,1770,1636,2390,1016,0.31%
3130002,3109,Oeste de Minas,31046,Oliveira,Ibituruna,MG,2632,2588,2572,2755,2825,2866,1448,1418,2485,381,0.40%
3130051,3102,Norte de Minas,31003,Januária,Icaraí de Minas,MG,,,,9315,10331,10737,5556,5181,2985,7752,1.43%
3130101,3107,Metropolitana de Belo Horizonte,31030,Belo Horizonte,Igarapé,MG,7675,16561,27400,24838,31135,34879,17544,17335,32675,2204,3.45%
3130200,3109,Oeste de Minas,31043,Divinópolis,Igaratinga,MG,3762,4140,5986,7355,8477,9265,4771,4494,7677,1588,2.34%
3130309,3109,Oeste de Minas,31042,Piuí,Iguatama,MG,7920,6886,8362,8269,7632,8031,4034,3997,6716,1315,-0.29%
3130408,3111,Campo das Vertentes,31057,Lavras,Ijaci,MG,3442,3622,4473,5064,5687,5863,2965,2898,5609,254,1.48%
3130507,3110,Sul/Sudoeste de Minas,31050,Varginha,Ilicínea,MG,6984,7499,8783,10532,11265,11488,5856,5632,9094,2394,0.87%
3130556,3108,Vale do Rio Doce,31040,Caratinga,Imbé de Minas,MG,,,,5911,6324,6412,3287,3125,2043,4369,0.82%
3130606,3110,Sul/Sudoeste de Minas,31051,Poços de Caldas,Inconfidentes,MG,5217,5653,6221,6479,7253,6904,3517,3387,3681,3223,0.64%
3130655,3102,Norte de Minas,31005,Salinas,Indaiabira,MG,,,,7425,7482,7327,3734,3593,2741,4586,-0.13%
3130705,3105,Triângulo Mineiro/Alto Paranaíba,31018,Uberlândia,Indianópolis,MG,3891,3678,4861,5387,6244,6181,3229,2952,4053,2128,1.38%
3130804,3111,Campo das Vertentes,31057,Lavras,Ingaí,MG,2589,2657,2398,2494,2496,2636,1398,1238,1630,1006,0.56%
3130903,3108,Vale do Rio Doce,31040,Caratinga,Inhapim,MG,40200,32874,33786,24895,24289,24269,12122,12147,13975,10294,-0.25%
3131000,3107,Metropolitana de Belo Horizonte,31027,Sete Lagoas,Inhaúma,MG,3761,3854,4766,5195,5347,5781,2920,2861,4205,1576,1.07%
3131109,3106,Central Mineira,31025,Curvelo,Inimutaba,MG,5140,5213,6032,6116,6420,6729,3331,3398,4748,1981,0.96%
3131158,3108,Vale do Rio Doce,31040,Caratinga,Ipaba,MG,,,,14531,14844,16692,8401,8291,15013,1679,1.40%
3131208,3108,Vale do Rio Doce,31041,Aimorés,Ipanema,MG,20624,17183,18228,16286,17128,18169,8806,9363,14204,3965,1.10%
3131307,3108,Vale do Rio Doce,31039,Ipatinga,Ipatinga,MG,47882,150318,180069,212496,238397,239177,116006,123171,236678,2499,1.19%
3131406,3105,Triângulo Mineiro/Alto Paranaíba,31017,Ituiutaba,Ipiaçu,MG,6865,4254,4122,4026,4191,4106,2097,2009,3740,366,0.20%
3131505,3110,Sul/Sudoeste de Minas,31052,Pouso Alegre,Ipuiúna,MG,6432,6689,7751,8958,9183,9522,4938,4584,7449,2073,0.61%
3131604,3105,Triângulo Mineiro/Alto Paranaíba,31019,Patrocínio,Iraí de Minas,MG,3580,3427,4476,5903,6295,6464,3383,3081,5154,1310,0.91%
3131703,3107,Metropolitana de Belo Horizonte,31031,Itabira,Itabira,MG,56352,71114,85606,98322,105159,109551,52634,56917,102097,7454,1.09%
3131802,3108,Vale do Rio Doce,31038,Mantena,Itabirinha,MG,13336,10931,10210,9809,10338,10692,5321,5371,8370,2322,0.87%
3131901,3107,Metropolitana de Belo Horizonte,31033,Ouro Preto,Itabirito,MG,22470,26967,32091,37901,41522,45484,22349,23135,43603,1881,1.84%
3132008,3102,Norte de Minas,31008,Grão Mogol,Itacambira,MG,8245,8719,6807,4558,5018,4982,2675,2307,1006,3976,0.89%
3132107,3102,Norte de Minas,31003,Januária,Itacarambi,MG,13132,16925,21775,17455,17626,17739,8853,8886,13815,3924,0.16%
3132206,3107,Metropolitana de Belo Horizonte,31032,Itaguara,Itaguara,MG,9030,9763,10671,11302,12292,12371,6268,6103,9530,2841,0.91%
3132305,3104,Vale do Mucuri,31015,Teófilo Otoni,Itaipé,MG,14203,14886,15684,10751,11497,11798,6014,5784,4943,6855,0.93%
3132404,3110,Sul/Sudoeste de Minas,31056,Itajubá,Itajubá,MG,51716,60595,75014,84135,86673,90679,44495,46184,82785,7894,0.75%
3132503,3103,Jequitinhonha,31011,Capelinha,Itamarandiba,MG,27020,28907,32506,29400,31883,32177,16143,16034,21991,10186,0.91%
3132602,3112,Zona da Mata,31066,Cataguases,Itamarati de Minas,MG,3262,2986,3439,3791,4035,4079,2104,1975,3210,869,0.73%
3132701,3108,Vale do Rio Doce,31037,Governador Valadares,Itambacuri,MG,29431,22970,21195,22668,22635,22797,11026,11771,15115,7682,0.06%
3132800,3107,Metropolitana de Belo Horizonte,31028,Conceição do Mato Dentro,Itambé do Mato Dentro,MG,4066,3375,2755,2582,2434,2283,1179,1104,908,1375,-1.22%
3132909,3110,Sul/Sudoeste de Minas,31048,São Sebastião do Paraíso,Itamogi,MG,7326,9007,9263,10723,10828,10349,5306,5043,7759,2590,-0.35%
3133006,3110,Sul/Sudoeste de Minas,31054,São Lourenço,Itamonte,MG,7752,8118,10027,12197,13756,14007,7088,6919,9616,4391,1.39%
3133105,3110,Sul/Sudoeste de Minas,31054,São Lourenço,Itanhandu,MG,9132,9700,11273,12915,14395,14183,6948,7235,11930,2253,0.94%
3133204,3108,Vale do Rio Doce,31037,Governador Valadares,Itanhomi,MG,25585,20682,16958,11572,11880,11850,5796,6054,8564,3286,0.24%
3133303,3103,Jequitinhonha,31013,Pedra Azul,Itaobim,MG,15487,18161,20358,21271,20986,21001,10491,10510,15779,5222,-0.13%
3133402,3105,Triângulo Mineiro/Alto Paranaíba,31021,Frutal,Itapagipe,MG,13644,11477,11203,11832,14019,13669,7145,6524,9560,4109,1.45%
3133501,3109,Oeste de Minas,31044,Formiga,Itapecerica,MG,21825,21751,22356,21235,20653,21377,10603,10774,16495,4882,0.07%
3133600,3110,Sul/Sudoeste de Minas,31052,Pouso Alegre,Itapeva,MG,4480,4729,5529,7361,7722,8673,4505,4168,4518,4155,1.65%
3133709,3107,Metropolitana de Belo Horizonte,31032,Itaguara,Itatiaiuçu,MG,5330,5426,7366,8517,8953,9938,5054,4884,6231,3707,1.55%
3133758,3110,Sul/Sudoeste de Minas,31047,Passos,Itaú de Minas,MG,,,10953,13691,14551,14950,7403,7547,14567,383,0.88%
3133808,3109,Oeste de Minas,31043,Divinópolis,Itaúna,MG,37648,53438,66395,76862,81833,85396,42071,43325,80391,5005,1.06%
3133907,3107,Metropolitana de Belo Horizonte,31034,Conselheiro Lafaiete,Itaverava,MG,6998,6214,6341,6388,5724,5798,2975,2823,2565,3233,-0.96%
3134004,3103,Jequitinhonha,31012,Araçuaí,Itinga,MG,22710,23839,22612,13894,14587,14407,7352,7055,6554,7853,0.36%
3134103,3108,Vale do Rio Doce,31041,Aimorés,Itueta,MG,9646,7049,6452,5641,5830,5836,2967,2869,3305,2531,0.34%
3134202,3105,Triângulo Mineiro/Alto Paranaíba,31017,Ituiutaba,Ituiutaba,MG,64656,74240,84577,89091,92727,97159,47846,49313,93122,4037,0.87%
3134301,3111,Campo das Vertentes,31057,Lavras,Itumirim,MG,4795,5059,6127,6391,6439,6139,3059,3080,4704,1435,-0.40%
3134400,3105,Triângulo Mineiro/Alto Paranaíba,31021,Frutal,Iturama,MG,42644,47564,45699,28814,31495,34440,17289,17151,32593,1847,1.80%
3134509,3111,Campo das Vertentes,31057,Lavras,Itutinga,MG,4539,3926,4305,4140,4051,3913,1995,1918,2756,1157,-0.56%
3134608,3107,Metropolitana de Belo Horizonte,31027,Sete Lagoas,Jaboticatubas,MG,12159,11569,12716,13530,15496,17119,8703,8416,10741,6378,2.38%
3134707,3103,Jequitinhonha,31014,Almenara,Jacinto,MG,14164,11832,12169,12087,12422,12134,6285,5849,9197,2937,0.04%
3134806,3110,Sul/Sudoeste de Minas,31048,São Sebastião do Paraíso,Jacuí,MG,6379,6572,6616,7389,7225,7502,3873,3629,4570,2932,0.15%
3134905,3110,Sul/Sudoeste de Minas,31051,Poços de Caldas,Jacutinga,MG,10519,11686,17535,19004,20389,22797,11347,11450,19101,3696,1.84%
3135001,3108,Vale do Rio Doce,31039,Ipatinga,Jaguaraçu,MG,2477,2051,2745,2855,2782,2982,1505,1477,2139,843,0.44%
3135050,3102,Norte de Minas,31004,Janaúba,Jaíba,MG,,,,27287,30386,33587,17344,16243,17635,15952,2.10%
3135076,3108,Vale do Rio Doce,31037,Governador Valadares,Jampruca,MG,,,,4716,4926,5068,2592,2476,3289,1779,0.72%
3135100,3102,Norte de Minas,31004,Janaúba,Janaúba,MG,31587,43031,53104,61651,65387,66803,32795,34008,60570,6233,0.81%
3135209,3102,Norte de Minas,31003,Januária,Januária,MG,62546,71949,87163,63605,64985,65464,32342,33122,41328,24136,0.29%
3135308,3106,Central Mineira,31026,Bom Despacho,Japaraíba,MG,3217,2853,3315,3473,3688,3950,2014,1936,2553,1397,1.30%
3135357,3102,Norte de Minas,31007,Montes Claros,Japonvar,MG,,,,8121,8232,8305,4206,4099,3049,5256,0.22%
3135407,3107,Metropolitana de Belo Horizonte,31032,Itaguara,Jeceaba,MG,6259,6390,6955,6109,5892,5396,2723,2673,2979,2417,-1.23%
3135456,3103,Jequitinhonha,31011,Capelinha,Jenipapo de Minas,MG,,,,6490,6905,7117,3664,3453,2882,4235,0.93%
3135506,3112,Zona da Mata,31060,Ponte Nova,Jequeri,MG,18194,16514,15126,13658,12965,12845,6474,6371,7293,5552,-0.61%
3135605,3102,Norte de Minas,31006,Pirapora,Jequitaí,MG,8030,8392,9346,8750,8029,8010,4033,3977,5499,2511,-0.88%
3135704,3107,Metropolitana de Belo Horizonte,31027,Sete Lagoas,Jequitibá,MG,5468,4789,5048,5171,5491,5153,2661,2492,1965,3188,-0.03%
3135803,3103,Jequitinhonha,31014,Almenara,Jequitinhonha,MG,22986,23267,22738,22902,23982,24179,12297,11882,17065,7114,0.54%
3135902,3110,Sul/Sudoeste de Minas,31054,São Lourenço,Jesuânia,MG,4036,4287,4345,4823,4821,4768,2469,2299,3094,1674,-0.11%
3136009,3103,Jequitinhonha,31014,Almenara,Joaíma,MG,19124,18747,18304,14555,14881,14930,7489,7441,10275,4655,0.25%
3136108,3108,Vale do Rio Doce,31039,Ipatinga,Joanésia,MG,8234,7269,6941,6617,5628,5427,2695,2732,2062,3365,-1.96%
3136207,3107,Metropolitana de Belo Horizonte,31031,Itabira,João Monlevade,MG,39988,48198,59340,66690,71658,73451,34963,38488,73120,331,0.97%
3136306,3101,Noroeste de Minas,31002,Paracatu,João Pinheiro,MG,41502,45858,49956,41368,43229,45260,23050,22210,36752,8508,0.90%
3136405,3106,Central Mineira,31025,Curvelo,Joaquim Felício,MG,3912,4992,4441,3872,3937,4305,2216,2089,2526,1779,1.07%
3136504,3103,Jequitinhonha,31014,Almenara,Jordânia,MG,10547,8304,9524,9865,10751,10319,5327,4992,7220,3099,0.45%
3136520,3103,Jequitinhonha,31011,Capelinha,José Gonçalves de Minas,MG,,,,4696,4547,4577,2367,2210,1141,3436,-0.26%
3136553,3108,Vale do Rio Doce,31036,Peçanha,José Raydan,MG,,,,3647,4146,4376,2220,2156,1568,2808,1.84%
3136579,3102,Norte de Minas,31008,Grão Mogol,Josenópolis,MG,,,,4253,4440,4566,2346,2220,2444,2122,0.71%
3136603,3107,Metropolitana de Belo Horizonte,31031,Itabira,Nova União,MG,3958,4066,4865,5427,5461,5554,2804,2750,2875,2679,0.23%
3136652,3107,Metropolitana de Belo Horizonte,31030,Belo Horizonte,Juatuba,MG,,,,16389,19528,22221,11235,10986,21846,375,3.09%
3136702,3112,Zona da Mata,31065,Juiz de Fora,Juiz de Fora,MG,238510,307534,385996,456796,513348,517872,244932,272940,511993,5879,1.26%
3136801,3102,Norte de Minas,31007,Montes Claros,Juramento,MG,7797,6883,6389,3901,3960,4110,2053,2057,2268,1842,0.52%
3136900,3110,Sul/Sudoeste de Minas,31048,São Sebastião do Paraíso,Juruaia,MG,5272,5330,6578,7680,8260,9238,4703,4535,4514,4724,1.86%
3136959,3102,Norte de Minas,31003,Januária,Juvenília,MG,,,,7148,6050,5708,2923,2785,4394,1314,-2.22%
3137007,3104,Vale do Mucuri,31015,Teófilo Otoni,Ladainha,MG,17022,16134,16601,15832,16479,16999,8394,8605,4310,12689,0.71%
3137106,3101,Noroeste de Minas,31002,Paracatu,Lagamar,MG,11216,9618,8130,7710,7636,7598,3914,3684,5129,2469,-0.15%
3137205,3106,Central Mineira,31026,Bom Despacho,Lagoa da Prata,MG,18275,24269,30816,38758,44159,45999,22857,23142,44952,1047,1.73%
3137304,3102,Norte de Minas,31006,Pirapora,Lagoa dos Patos,MG,3277,3919,4120,4454,4448,4227,2201,2026,3079,1148,-0.52%
3137403,3111,Campo das Vertentes,31058,São João Del Rei,Lagoa Dourada,MG,7541,8733,10118,11486,11792,12267,6350,5917,6891,5376,0.66%
3137502,3105,Triângulo Mineiro/Alto Paranaíba,31020,Patos de Minas,Lagoa Formosa,MG,19180,17550,15949,16293,16521,17136,8635,8501,12941,4195,0.51%
3137536,3101,Noroeste de Minas,31002,Paracatu,Lagoa Grande,MG,,,,7610,8660,8631,4549,4082,6408,2223,1.27%
3137601,3107,Metropolitana de Belo Horizonte,31030,Belo Horizonte,Lagoa Santa,MG,14053,19499,29824,37872,44922,52526,25778,26748,48953,3573,3.33%
3137700,3112,Zona da Mata,31061,Manhuaçu,Lajinha,MG,15379,16087,17231,19528,17580,19616,9830,9786,12255,7361,0.04%
3137809,3110,Sul/Sudoeste de Minas,31054,São Lourenço,Lambari,MG,13021,14070,16071,18249,18547,19569,9644,9925,14052,5517,0.70%
3137908,3112,Zona da Mata,31062,Viçosa,Lamim,MG,3741,3483,3572,3587,3546,3456,1746,1710,1511,1945,-0.37%
3138005,3112,Zona da Mata,31066,Cataguases,Laranjal,MG,6503,6154,5948,6126,6310,6465,3254,3211,4738,1727,0.54%
3138104,3102,Norte de Minas,31006,Pirapora,Lassance,MG,6367,6440,6639,6554,6458,6490,3330,3160,3886,2604,-0.10%
3138203,3111,Campo das Vertentes,31057,Lavras,Lavras,MG,44449,52710,65893,78772,87421,92171,44715,47456,87835,4336,1.58%
3138302,3106,Central Mineira,31026,Bom Despacho,Leandro Ferreira,MG,4277,2803,2928,3227,2955,3205,1640,1565,2152,1053,-0.07%
3138351,3103,Jequitinhonha,31011,Capelinha,Leme do Prado,MG,,,,4736,4930,4814,2398,2416,1764,3050,0.16%
3138401,3112,Zona da Mata,31066,Cataguases,Leopoldina,MG,41306,42118,46442,50097,49915,51136,24545,26591,45712,5424,0.21%
3138500,3110,Sul/Sudoeste de Minas,31055,Andrelândia,Liberdade,MG,6355,6392,6045,5792,5333,5347,2706,2641,3870,1477,-0.80%
3138609,3112,Zona da Mata,31065,Juiz de Fora,Lima Duarte,MG,14578,14309,14641,15708,15909,16166,8150,8016,12372,3794,0.29%
3138625,3105,Triângulo Mineiro/Alto Paranaíba,31021,Frutal,Limeira do Oeste,MG,,,,6170,6492,6890,3532,3358,5017,1873,1.11%
3138658,3102,Norte de Minas,31007,Montes Claros,Lontra,MG,,,,7640,7979,8401,4372,4029,5645,2756,0.95%
3138674,3112,Zona da Mata,31061,Manhuaçu,Luisburgo,MG,,,,6297,6276,6236,3223,3013,1838,4398,-0.10%
3138682,3102,Norte de Minas,31007,Montes Claros,Luislândia,MG,,,,6121,6432,6405,3298,3107,2985,3420,0.45%
3138708,3111,Campo das Vertentes,31057,Lavras,Luminárias,MG,5503,5363,5193,5482,5374,5425,2812,2613,4169,1256,-0.10%
3138807,3106,Central Mineira,31026,Bom Despacho,Luz,MG,14069,14436,16432,16833,17173,17492,8718,8774,15715,1777,0.38%
3138906,3104,Vale do Mucuri,31016,Nanuque,Machacalis,MG,6071,6322,6870,6917,6855,6974,3607,3367,5747,1227,0.08%
3139003,3110,Sul/Sudoeste de Minas,31049,Alfenas,Machado,MG,21556,26731,30709,34877,37567,38684,19341,19343,32068,6616,1.04%
3139102,3111,Campo das Vertentes,31058,São João Del Rei,Madre de Deus de Minas,MG,3946,6474,3971,4734,4951,4898,2463,2435,3726,1172,0.34%
3139201,3104,Vale do Mucuri,31015,Teófilo Otoni,Malacacheta,MG,42262,36743,35153,19250,17917,18787,9169,9618,11828,6959,-0.24%
3139250,3102,Norte de Minas,31004,Janaúba,Mamonas,MG,,,,6138,6247,6321,3183,3138,2812,3509,0.29%
3139300,3102,Norte de Minas,31003,Januária,Manga,MG,24504,33042,50391,21959,20903,19846,9802,10044,13875,5971,-1.01%
3139409,3112,Zona da Mata,31061,Manhuaçu,Manhuaçu,MG,48230,57729,75259,67123,74297,79635,39214,40421,64866,14769,1.72%
3139508,3112,Zona da Mata,31061,Manhuaçu,Manhumirim,MG,23509,25818,27287,20025,20209,21366,10509,10857,17029,4337,0.65%
3139607,3108,Vale do Rio Doce,31038,Mantena,Mantena,MG,47646,39750,38134,26872,26721,27115,13092,14023,21258,5857,0.09%
3139706,3107,Metropolitana de Belo Horizonte,31027,Sete Lagoas,Maravilhas,MG,4523,4812,5406,6232,6840,7156,3627,3529,4891,2265,1.39%
3139805,3112,Zona da Mata,31065,Juiz de Fora,Mar de Espanha,MG,8901,7903,9710,10567,11139,11758,5716,6042,10757,1001,1.07%
3139904,3110,Sul/Sudoeste de Minas,31056,Itajubá,Maria da Fé,MG,10085,11153,13629,14607,14249,14216,7201,7015,8383,5833,-0.27%
3140001,3107,Metropolitana de Belo Horizonte,31033,Ouro Preto,Mariana,MG,24786,29401,38180,46710,51693,54179,26571,27608,47601,6578,1.49%
3140100,3108,Vale do Rio Doce,31037,Governador Valadares,Marilac,MG,5986,4208,4417,4424,4285,4219,2059,2160,3423,796,-0.47%
3140159,3107,Metropolitana de Belo Horizonte,31030,Belo Horizonte,Mário Campos,MG,,,,10535,11421,13214,6643,6571,12481,733,2.29%
3140209,3112,Zona da Mata,31065,Juiz de Fora,Maripá de Minas,MG,2361,2233,2287,2594,2827,2788,1389,1399,2266,522,0.72%
3140308,3108,Vale do Rio Doce,31039,Ipatinga,Marliéria,MG,4450,4111,3540,4044,3743,4021,2002,2019,2843,1178,-0.06%
3140407,3110,Sul/Sudoeste de Minas,31056,Itajubá,Marmelópolis,MG,3243,2815,2944,3293,3100,2968,1491,1477,1557,1411,-1.03%
3140506,3106,Central Mineira,31026,Bom Despacho,Martinho Campos,MG,11629,9546,11856,11817,12165,12589,6371,6218,10986,1603,0.63%
3140530,3112,Zona da Mata,31061,Manhuaçu,Martins Soares,MG,,,,5685,6338,7173,3655,3518,2924,4249,2.35%
3140555,3103,Jequitinhonha,31014,Almenara,Mata Verde,MG,,,,7085,7458,7880,4143,3737,6392,1488,1.07%
3140605,3108,Vale do Rio Doce,31035,Guanhães,Materlândia,MG,4439,5003,4624,4846,4662,4595,2285,2310,2011,2584,-0.53%
3140704,3107,Metropolitana de Belo Horizonte,31030,Belo Horizonte,Mateus Leme,MG,11929,18659,27033,24144,25627,27856,13798,14058,24676,3180,1.44%
3140803,3112,Zona da Mata,31065,Juiz de Fora,Matias Barbosa,MG,8788,9405,10955,12323,13205,13435,6692,6743,12944,491,0.87%
3140852,3102,Norte de Minas,31003,Januária,Matias Cardoso,MG,,,,8600,10270,9977,5093,4884,5137,4840,1.50%
3140902,3112,Zona da Mata,31061,Manhuaçu,Matipó,MG,11070,11485,14351,16291,16430,17639,8727,8912,13832,3807,0.80%
3141009,3102,Norte de Minas,31004,Janaúba,Mato Verde,MG,13973,16897,19940,13185,12664,12685,6260,6425,9460,3225,-0.39%
3141108,3107,Metropolitana de Belo Horizonte,31027,Sete Lagoas,Matozinhos,MG,8674,16201,23606,30164,33317,32973,16279,16694,29899,3074,0.89%
3141207,3105,Triângulo Mineiro/Alto Paranaíba,31020,Patos de Minas,Matutina,MG,5078,4270,3758,3838,3700,3763,1852,1911,2695,1068,-0.20%
3141306,3109,Oeste de Minas,31042,Piuí,Medeiros,MG,3017,2507,2728,3038,3238,3444,1811,1633,1948,1496,1.26%
3141405,3103,Jequitinhonha,31013,Pedra Azul,Medina,MG,19857,22709,21760,21641,20667,21037,10477,10560,15105,5932,-0.28%
3141504,3108,Vale do Rio Doce,31038,Mantena,Mendes Pimentel,MG,22332,15288,11025,6286,6431,6329,3152,3177,3453,2876,0.07%
3141603,3112,Zona da Mata,31064,Ubá,Mercês,MG,9637,10119,10074,10061,10452,10372,5157,5215,7261,3111,0.30%
3141702,3108,Vale do Rio Doce,31039,Ipatinga,Mesquita,MG,14237,14494,19963,6771,6493,6072,3030,3042,3822,2250,-1.08%
3141801,3103,Jequitinhonha,31011,Capelinha,Minas Novas,MG,25012,27506,33631,30646,30578,30803,15360,15443,12590,18213,0.05%
3141900,3110,Sul/Sudoeste de Minas,31055,Andrelândia,Minduri,MG,3775,4101,3874,3834,3603,3840,1889,1951,3396,444,0.02%
3142007,3102,Norte de Minas,31007,Montes Claros,Mirabela,MG,13137,14573,16893,12552,12769,13043,6629,6414,10029,3014,0.38%
3142106,3112,Zona da Mata,31063,Muriaé,Miradouro,MG,9232,9350,10227,9770,10197,10251,5234,5017,5671,4580,0.48%
3142205,3112,Zona da Mata,31063,Muriaé,Miraí,MG,14269,13970,14700,12479,12949,13800,6940,6860,10395,3405,1.01%
3142254,3102,Norte de Minas,31003,Januária,Miravânia,MG,,,,4187,4708,4561,2291,2270,1079,3482,0.86%
3142304,3107,Metropolitana de Belo Horizonte,31032,Itaguara,Moeda,MG,4668,3952,3885,4469,4506,4700,2348,2352,1793,2907,0.51%
3142403,3106,Central Mineira,31026,Bom Despacho,Moema,MG,4147,5080,5505,6513,6754,7028,3552,3476,6040,988,0.76%
3142502,3106,Central Mineira,31025,Curvelo,Monjolos,MG,4015,3126,2941,2579,2303,2360,1207,1153,1403,957,-0.88%
3142601,3110,Sul/Sudoeste de Minas,31050,Varginha,Monsenhor Paulo,MG,5114,5575,7051,7615,7391,8168,4186,3982,6140,2028,0.70%
3142700,3102,Norte de Minas,31003,Januária,Montalvânia,MG,25566,17874,16553,16031,15961,15859,7998,7861,10243,5616,-0.11%
3142809,3105,Triângulo Mineiro/Alto Paranaíba,31018,Uberlândia,Monte Alegre de Minas,MG,14687,15110,17919,18006,18348,19616,10048,9568,14512,5104,0.86%
3142908,3102,Norte de Minas,31004,Janaúba,Monte Azul,MG,27444,34871,37706,23832,22437,22000,10843,11157,12421,9579,-0.80%
3143005,3110,Sul/Sudoeste de Minas,31048,São Sebastião do Paraíso,Monte Belo,MG,11873,12204,13776,13142,12573,13061,6810,6251,9058,4003,-0.06%
3143104,3105,Triângulo Mineiro/Alto Paranaíba,31019,Patrocínio,Monte Carmelo,MG,20417,26870,34705,43899,44367,45799,23084,22715,40139,5660,0.42%
3143153,3103,Jequitinhonha,31014,Almenara,Monte Formoso,MG,,,,4411,4709,4664,2439,2225,1700,2964,0.56%
3143203,3110,Sul/Sudoeste de Minas,31048,São Sebastião do Paraíso,Monte Santo de Minas,MG,16501,18621,19291,21212,20133,21246,10694,10552,16435,4811,0.02%
3143302,3102,Norte de Minas,31007,Montes Claros,Montes Claros,MG,116486,177302,250062,306947,352384,361971,174281,187690,344479,17492,1.66%
3143401,3110,Sul/Sudoeste de Minas,31051,Poços de Caldas,Monte Sião,MG,8630,10936,17328,18195,19228,21203,10655,10548,16269,4934,1.54%
3143450,3102,Norte de Minas,31005,Salinas,Montezuma,MG,,,,6573,7259,7472,3779,3693,3079,4393,1.29%
3143500,3106,Central Mineira,31024,Três Marias,Morada Nova de Minas,MG,8233,6023,6659,7606,8297,8256,4205,4051,6457,1799,0.82%
3143609,3106,Central Mineira,31025,Curvelo,Morro da Garça,MG,3442,2603,3054,2960,2887,2661,1377,1284,1523,1138,-1.06%
3143708,3107,Metropolitana de Belo Horizonte,31028,Conceição do Mato Dentro,Morro do Pilar,MG,4160,4141,3873,3735,3474,3399,1709,1690,2581,818,-0.94%
3143807,3110,Sul/Sudoeste de Minas,31052,Pouso Alegre,Munhoz,MG,4038,4327,5652,6656,6298,6257,3247,3010,3319,2938,-0.62%
3143906,3112,Zona da Mata,31063,Muriaé,Muriaé,MG,58153,69979,84585,92101,95548,100861,48847,52014,93320,7541,0.91%
3144003,3108,Vale do Rio Doce,31041,Aimorés,Mutum,MG,32910,26036,27039,26693,26331,26672,13477,13195,13798,12874,-0.01%
3144102,3110,Sul/Sudoeste de Minas,31048,São Sebastião do Paraíso,Muzambinho,MG,15206,15631,17887,20589,19925,20432,10267,10165,15731,4701,-0.08%
3144201,3108,Vale do Rio Doce,31037,Governador Valadares,Nacip Raydan,MG,5963,4356,4003,3122,2957,3154,1586,1568,1979,1175,0.10%
3144300,3104,Vale do Mucuri,31016,Nanuque,Nanuque,MG,48903,42734,43090,41619,40307,40816,19975,20841,36765,4051,-0.19%
3144359,3108,Vale do Rio Doce,31039,Ipatinga,Naque,MG,,,,5601,5885,6341,3194,3147,5961,380,1.25%
3144375,3101,Noroeste de Minas,31001,Unaí,Natalândia,MG,,,,3293,3271,3288,1738,1550,2475,813,-0.02%
3144409,3110,Sul/Sudoeste de Minas,31053,Santa Rita do Sapucaí,Natércia,MG,4516,4252,4361,4644,4623,4650,2405,2245,2752,1898,0.01%
3144508,3111,Campo das Vertentes,31058,São João Del Rei,Nazareno,MG,4591,6048,6921,7240,7716,7953,4121,3832,6048,1905,0.94%
3144607,3111,Campo das Vertentes,31057,Lavras,Nepomuceno,MG,19371,21175,24069,24822,24430,25721,12814,12907,19921,5800,0.36%
3144656,3102,Norte de Minas,31005,Salinas,Ninheira,MG,,,,9356,10414,9795,5046,4749,2620,7175,0.46%
3144672,3108,Vale do Rio Doce,31038,Mantena,Nova Belém,MG,,,,4495,3629,3732,1896,1836,1348,2384,-1.84%
3144706,3107,Metropolitana de Belo Horizonte,31031,Itabira,Nova Era,MG,14080,14679,17605,17754,17932,17540,8355,9185,15431,2109,-0.12%
3144805,3107,Metropolitana de Belo Horizonte,31030,Belo Horizonte,Nova Lima,MG,33992,41217,52400,64387,72207,81162,39272,41890,79394,1768,2.34%
3144904,3108,Vale do Rio Doce,31037,Governador Valadares,Nova Módica,MG,8135,5286,4419,4100,3878,3793,1907,1886,2330,1463,-0.78%
3145000,3105,Triângulo Mineiro/Alto Paranaíba,31023,Araxá,Nova Ponte,MG,6261,5325,10147,9492,11586,12823,6730,6093,11001,1822,3.05%
3145059,3102,Norte de Minas,31004,Janaúba,Nova Porteirinha,MG,,,,7389,7358,7398,3787,3611,4069,3329,0.01%
3145109,3110,Sul/Sudoeste de Minas,31048,São Sebastião do Paraíso,Nova Resende,MG,8789,9936,11742,13887,14145,15373,8105,7268,8857,6516,1.02%
3145208,3109,Oeste de Minas,31043,Divinópolis,Nova Serrana,MG,6538,9266,17913,37447,60195,73719,38091,35628,69711,4008,7.01%
3145307,3103,Jequitinhonha,31012,Araçuaí,Novo Cruzeiro,MG,31422,31213,30748,30453,30331,30726,15258,15468,10523,20203,0.09%
3145356,3104,Vale do Mucuri,31015,Teófilo Otoni,Novo Oriente de Minas,MG,,,,9974,10327,10342,5299,5043,4423,5919,0.36%
3145372,3102,Norte de Minas,31005,Salinas,Novorizonte,MG,,,,4610,4899,4953,2485,2468,1717,3236,0.72%
3145406,3112,Zona da Mata,31065,Juiz de Fora,Olaria,MG,2508,2227,2283,2304,2380,1981,1063,918,917,1064,-1.50%
3145455,3102,Norte de Minas,31009,Bocaiúva,Olhos-d'Água,MG,,,,4284,4991,5264,2779,2485,2865,2399,2.08%
3145505,3110,Sul/Sudoeste de Minas,31054,São Lourenço,Olímpio Noronha,MG,2118,2116,1839,2247,2505,2533,1304,1229,2249,284,1.21%
3145604,3109,Oeste de Minas,31046,Oliveira,Oliveira,MG,26502,29588,32222,37250,37805,39469,19306,20163,35188,4281,0.58%
3145703,3112,Zona da Mata,31065,Juiz de Fora,Oliveira Fortes,MG,2866,2184,2183,2145,1939,2123,1080,1043,1177,946,-0.10%
3145802,3107,Metropolitana de Belo Horizonte,31029,Pará de Minas,Onça de Pitangui,MG,2485,2774,3022,2985,3019,3197,1625,1572,1519,1678,0.69%
3145851,3112,Zona da Mata,31060,Ponte Nova,Oratórios,MG,,,,4359,4385,4486,2233,2253,3236,1250,0.29%
3145877,3112,Zona da Mata,31063,Muriaé,Orizânia,MG,,,,6457,6771,7284,3697,3587,2221,5063,1.21%
3145901,3107,Metropolitana de Belo Horizonte,31034,Conselheiro Lafaiete,Ouro Branco,MG,6329,12210,27423,30383,33548,35260,17570,17690,31606,3654,1.50%
3146008,3110,Sul/Sudoeste de Minas,31051,Poços de Caldas,Ouro Fino,MG,19606,22415,30593,29416,31154,31580,15827,15753,23771,7809,0.71%
3146107,3107,Metropolitana de Belo Horizonte,31033,Ouro Preto,Ouro Preto,MG,46165,53413,62514,66277,67048,70227,34272,35955,61082,9145,0.58%
3146206,3104,Vale do Mucuri,31015,Teófilo Otoni,Ouro Verde de Minas,MG,11000,9821,7923,6223,6832,6021,3023,2998,3624,2397,-0.33%
3146255,3102,Norte de Minas,31008,Grão Mogol,Padre Carvalho,MG,,,,5227,5828,5834,2971,2863,3462,2372,1.10%
3146305,3103,Jequitinhonha,31012,Araçuaí,Padre Paraíso,MG,12724,14855,17327,17475,18120,18852,9334,9518,11523,7329,0.76%
3146404,3106,Central Mineira,31024,Três Marias,Paineiras,MG,7553,5890,5235,4895,4594,4631,2332,2299,3598,1033,-0.55%
3146503,3109,Oeste de Minas,31044,Formiga,Pains,MG,9560,8123,8065,7798,8122,8015,4027,3988,6608,1407,0.27%
3146552,3102,Norte de Minas,31004,Janaúba,Pai Pedro,MG,,,,5832,5979,5934,3024,2910,1749,4185,0.17%
3146602,3112,Zona da Mata,31065,Juiz de Fora,Paiva,MG,2143,1654,1416,1622,1630,1560,783,777,1221,339,-0.39%
3146701,3112,Zona da Mata,31066,Cataguases,Palma,MG,9203,7847,7054,6561,6118,6545,3313,3232,5123,1422,-0.02%
3146750,3103,Jequitinhonha,31014,Almenara,Palmópolis,MG,,,,8886,7041,6925,3564,3361,4488,2437,-2.46%
3146909,3107,Metropolitana de Belo Horizonte,31027,Sete Lagoas,Papagaios,MG,6304,6636,10119,12472,14410,14171,7237,6934,11916,2255,1.29%
3147006,3101,Noroeste de Minas,31002,Paracatu,Paracatu,MG,36821,49014,62774,75216,79739,84687,42431,42256,73770,10917,1.19%
3147105,3107,Metropolitana de Belo Horizonte,31029,Pará de Minas,Pará de Minas,MG,30995,44358,61193,73007,79852,84252,41665,42587,79646,4606,1.44%
3147204,3110,Sul/Sudoeste de Minas,31049,Alfenas,Paraguaçu,MG,12390,14488,16498,18942,19603,20241,10176,10065,16680,3561,0.67%
3147303,3110,Sul/Sudoeste de Minas,31056,Itajubá,Paraisópolis,MG,13165,13749,14614,17498,18088,19392,9792,9600,16071,3321,1.03%
3147402,3107,Metropolitana de Belo Horizonte,31027,Sete Lagoas,Paraopeba,MG,9919,10836,17015,20383,22204,22571,11136,11435,19671,2900,1.02%
3147501,3107,Metropolitana de Belo Horizonte,31028,Conceição do Mato Dentro,Passabém,MG,2272,2655,1683,1946,1801,1766,864,902,1011,755,-0.97%
3147600,3110,Sul/Sudoeste de Minas,31054,São Lourenço,Passa Quatro,MG,11365,12046,13408,14855,15285,15584,7728,7856,11985,3599,0.48%
3147709,3109,Oeste de Minas,31046,Oliveira,Passa Tempo,MG,8542,7645,8152,8480,8494,8199,4133,4066,6387,1812,-0.34%
3147808,3110,Sul/Sudoeste de Minas,31055,Andrelândia,Passa-Vinte,MG,3373,3792,2413,2164,2082,2084,1092,992,1305,779,-0.38%
3147907,3110,Sul/Sudoeste de Minas,31047,Passos,Passos,MG,54879,69046,84622,97211,102765,106313,52579,53734,100866,5447,0.90%
3147956,3102,Norte de Minas,31007,Montes Claros,Patis,MG,,,,5164,5346,5594,2921,2673,2304,3290,0.80%
3148004,3105,Triângulo Mineiro/Alto Paranaíba,31020,Patos de Minas,Patos de Minas,MG,76211,86121,102946,123881,133054,138836,67989,70847,127864,10972,1.15%
3148103,3105,Triângulo Mineiro/Alto Paranaíba,31019,Patrocínio,Patrocínio,MG,35578,44376,60753,73130,81589,82541,41979,40562,72822,9719,1.22%
3148202,3112,Zona da Mata,31063,Muriaé,Patrocínio do Muriaé,MG,5240,4335,4449,4861,5319,5298,2657,2641,4322,976,0.86%
3148301,3112,Zona da Mata,31062,Viçosa,Paula Cândido,MG,8051,8200,8295,9037,9086,9269,4695,4574,4935,4334,0.25%
3148400,3108,Vale do Rio Doce,31035,Guanhães,Paulistas,MG,5847,5515,5764,5113,4893,4918,2385,2533,2303,2615,-0.39%
3148509,3104,Vale do Mucuri,31015,Teófilo Otoni,Pavão,MG,14794,10964,14973,8912,8868,8589,4345,4244,5204,3385,-0.37%
3148608,3108,Vale do Rio Doce,31036,Peçanha,Peçanha,MG,25104,22464,20915,17183,17157,17270,8530,8740,9105,8165,0.05%
3148707,3103,Jequitinhonha,31013,Pedra Azul,Pedra Azul,MG,18838,20166,22068,23608,24851,23843,11749,12094,20997,2846,0.10%
3148756,3112,Zona da Mata,31061,Manhuaçu,Pedra Bonita,MG,,,,6237,6474,6673,3455,3218,1807,4866,0.68%
3148806,3112,Zona da Mata,31062,Viçosa,Pedra do Anta,MG,5502,4122,4160,3925,3672,3365,1681,1684,2192,1173,-1.53%
3148905,3109,Oeste de Minas,31044,Formiga,Pedra do Indaiá,MG,4749,4565,3986,3814,3921,3878,1987,1891,2056,1822,0.17%
3149002,3112,Zona da Mata,31063,Muriaé,Pedra Dourada,MG,1562,1222,1628,1822,2100,2187,1136,1051,1297,890,1.84%
3149101,3110,Sul/Sudoeste de Minas,31053,Santa Rita do Sapucaí,Pedralva,MG,9821,9883,10999,12009,11184,11467,5858,5609,5563,5904,-0.46%
3149150,3102,Norte de Minas,31003,Januária,Pedras de Maria da Cruz,MG,,,,8871,10976,10310,5291,5019,6323,3987,1.51%
3149200,3105,Triângulo Mineiro/Alto Paranaíba,31023,Araxá,Pedrinópolis,MG,2472,3670,4391,3361,3448,3490,1798,1692,2927,563,0.38%
3149309,3107,Metropolitana de Belo Horizonte,31030,Belo Horizonte,Pedro Leopoldo,MG,20670,30007,41594,53957,56518,58696,28729,29967,49939,8757,0.85%
3149408,3112,Zona da Mata,31065,Juiz de Fora,Pedro Teixeira,MG,1802,1540,1593,1787,1658,1789,951,838,965,824,0.01%
3149507,3112,Zona da Mata,31065,Juiz de Fora,Pequeri,MG,2699,2680,2716,3016,2997,3165,1563,1602,2916,249,0.48%
3149606,3107,Metropolitana de Belo Horizonte,31027,Sete Lagoas,Pequi,MG,3083,2959,3187,3717,4232,4075,2042,2033,2953,1122,0.92%
3149705,3109,Oeste de Minas,31043,Divinópolis,Perdigão,MG,4733,4381,4546,5707,7310,8912,4555,4357,7862,1050,4.56%
3149804,3105,Triângulo Mineiro/Alto Paranaíba,31023,Araxá,Perdizes,MG,9973,9238,10735,12364,13924,14391,7530,6861,9955,4436,1.53%
3149903,3109,Oeste de Minas,31045,Campo Belo,Perdões,MG,12956,14105,16300,18736,19407,20140,9898,10242,17817,2323,0.73%
3149952,3108,Vale do Rio Doce,31039,Ipatinga,Periquito,MG,,,,7445,7030,7030,3450,3580,5283,1747,-0.57%
3150000,3108,Vale do Rio Doce,31037,Governador Valadares,Pescador,MG,5139,4245,4349,4037,4056,4129,2047,2082,3260,869,0.23%
3150109,3112,Zona da Mata,31065,Juiz de Fora,Piau,MG,3931,3427,3022,3008,2973,2844,1490,1354,1673,1171,-0.56%
3150158,3108,Vale do Rio Doce,31040,Caratinga,Piedade de Caratinga,MG,,,,5347,6444,7101,3644,3457,4601,2500,2.88%
3150208,3112,Zona da Mata,31060,Ponte Nova,Piedade de Ponte Nova,MG,4306,4619,4374,4029,4113,4063,1992,2071,3179,884,0.08%
3150307,3111,Campo das Vertentes,31058,São João Del Rei,Piedade do Rio Grande,MG,5540,5202,5035,5063,4781,4709,2386,2323,3477,1232,-0.72%
3150406,3107,Metropolitana de Belo Horizonte,31032,Itaguara,Piedade dos Gerais,MG,4558,3810,4226,4274,4542,4645,2418,2227,2122,2523,0.84%
3150505,3109,Oeste de Minas,31044,Formiga,Pimenta,MG,5209,5602,6733,7824,8164,8236,4243,3993,6945,1291,0.51%
3150539,3108,Vale do Rio Doce,31040,Caratinga,Pingo-d'Água,MG,,,,3820,4016,4420,2199,2221,4035,385,1.47%
3150570,3102,Norte de Minas,31003,Januária,Pintópolis,MG,,,,6949,7727,7215,3780,3435,2536,4679,0.38%
3150604,3109,Oeste de Minas,31046,Oliveira,Piracema,MG,7080,6321,6060,6509,6554,6406,3233,3173,3034,3372,-0.16%
3150703,3105,Triângulo Mineiro/Alto Paranaíba,31021,Frutal,Pirajuba,MG,2151,2984,3112,2741,3694,4664,2549,2115,4139,525,5.46%
3150802,3112,Zona da Mata,31062,Viçosa,Piranga,MG,16575,15928,16332,17010,17208,17230,8647,8583,5957,11273,0.13%
3150901,3110,Sul/Sudoeste de Minas,31056,Itajubá,Piranguçu,MG,5136,4718,4581,4974,5113,5219,2703,2516,1772,3447,0.48%
3151008,3110,Sul/Sudoeste de Minas,31056,Itajubá,Piranguinho,MG,5544,5542,6370,7399,7849,8016,4066,3950,4953,3063,0.80%
3151107,3112,Zona da Mata,31066,Cataguases,Pirapetinga,MG,7309,7357,8991,10034,10240,10366,5107,5259,9105,1261,0.33%
3151206,3102,Norte de Minas,31006,Pirapora,Pirapora,MG,20282,32672,46351,50300,51636,53379,26158,27221,52396,983,0.60%
3151305,3112,Zona da Mata,31064,Ubá,Piraúba,MG,10274,10251,9142,11140,10686,10866,5440,5426,8818,2048,-0.25%
3151404,3107,Metropolitana de Belo Horizonte,31029,Pará de Minas,Pitangui,MG,13983,16335,20173,22269,24618,25339,12553,12786,22638,2701,1.30%
3151503,3109,Oeste de Minas,31042,Piuí,Piumhi,MG,17141,20926,24938,28783,30984,31885,15850,16035,28566,3319,1.03%
3151602,3105,Triângulo Mineiro/Alto Paranaíba,31021,Frutal,Planura,MG,7372,8168,7309,8297,10289,10393,5458,4935,10100,293,2.28%
3151701,3110,Sul/Sudoeste de Minas,31049,Alfenas,Poço Fundo,MG,12752,12414,13817,15148,15350,15961,8215,7746,9285,6676,0.52%
3151800,3110,Sul/Sudoeste de Minas,31051,Poços de Caldas,Poços de Caldas,MG,57565,86971,110123,135627,144386,152496,73681,78815,148785,3711,1.18%
3151909,3108,Vale do Rio Doce,31041,Aimorés,Pocrane,MG,16832,12227,11200,9851,8769,8998,4520,4478,5408,3590,-0.90%
3152006,3106,Central Mineira,31024,Três Marias,Pompéu,MG,17037,17151,20350,26089,28393,29083,14625,14458,25744,3339,1.09%
3152105,3112,Zona da Mata,31060,Ponte Nova,Ponte Nova,MG,45694,50084,56678,55303,55687,57361,27487,29874,51152,6209,0.37%
3152131,3102,Norte de Minas,31007,Montes Claros,Ponto Chique,MG,,,,3651,4046,3966,2019,1947,2581,1385,0.83%
3152170,3103,Jequitinhonha,31012,Araçuaí,Ponto dos Volantes,MG,,,,10529,10976,11345,5797,5548,4031,7314,0.75%
3152204,3102,Norte de Minas,31004,Janaúba,Porteirinha,MG,41741,46052,53906,37890,36864,37638,18832,18806,19349,18289,-0.07%
3152303,3112,Zona da Mata,31062,Viçosa,Porto Firme,MG,9746,9107,9439,9474,10404,10410,5303,5107,4832,5578,0.95%
3152402,3104,Vale do Mucuri,31015,Teófilo Otoni,Poté,MG,15666,15915,14676,14780,14749,15668,7724,7944,9326,6342,0.59%
3152501,3110,Sul/Sudoeste de Minas,31052,Pouso Alegre,Pouso Alegre,MG,38072,57362,81836,106776,120467,130586,64461,66125,119602,10984,2.03%
3152600,3110,Sul/Sudoeste de Minas,31054,São Lourenço,Pouso Alto,MG,6353,5219,5883,6669,6359,6213,3134,3079,3658,2555,-0.71%
3152709,3111,Campo das Vertentes,31058,São João Del Rei,Prados,MG,6514,7078,7371,7703,8168,8395,4217,4178,5938,2457,0.86%
3152808,3105,Triângulo Mineiro/Alto Paranaíba,31018,Uberlândia,Prata,MG,18501,19559,24638,23576,25511,25805,13264,12541,19380,6425,0.91%
3152907,3110,Sul/Sudoeste de Minas,31047,Passos,Pratápolis,MG,17199,18225,9395,9217,8653,8808,4456,4352,7794,1014,-0.45%
3153004,3105,Triângulo Mineiro/Alto Paranaíba,31023,Araxá,Pratinha,MG,3359,2472,2503,2883,3236,3285,1707,1578,1779,1506,1.31%
3153103,3112,Zona da Mata,31062,Viçosa,Presidente Bernardes,MG,8071,6928,6420,5847,5699,5537,2780,2757,1642,3895,-0.54%
3153202,3106,Central Mineira,31025,Curvelo,Presidente Juscelino,MG,6173,5602,4292,4319,4257,3907,1995,1912,1846,2061,-1.00%
3153301,3103,Jequitinhonha,31010,Diamantina,Presidente Kubitschek,MG,2395,2414,2932,2951,2978,2959,1493,1466,2017,942,0.03%
3153400,3101,Noroeste de Minas,31002,Paracatu,Presidente Olegário,MG,27250,24241,23145,17781,18256,18546,9524,9022,13126,5420,0.42%
3153509,3112,Zona da Mata,31061,Manhuaçu,Alto Jequitibá,MG,6055,6677,7435,8458,7976,8323,4252,4071,4302,4021,-0.16%
3153608,3107,Metropolitana de Belo Horizonte,31027,Sete Lagoas,Prudente de Morais,MG,3578,4247,6819,8232,8874,9576,4726,4850,9198,378,1.52%
3153707,3106,Central Mineira,31026,Bom Despacho,Quartel Geral,MG,4056,3151,2952,3022,3200,3315,1686,1629,2778,537,0.93%
3153806,3107,Metropolitana de Belo Horizonte,31034,Conselheiro Lafaiete,Queluzito,MG,2395,1910,1728,1791,1826,1866,957,909,853,1013,0.41%
3153905,3107,Metropolitana de Belo Horizonte,31030,Belo Horizonte,Raposos,MG,10133,11801,14242,14289,14874,15345,7387,7958,14555,790,0.72%
3154002,3112,Zona da Mata,31060,Ponte Nova,Raul Soares,MG,38858,32264,29496,24287,23901,23818,11732,12086,15483,8335,-0.19%
3154101,3112,Zona da Mata,31066,Cataguases,Recreio,MG,12531,10762,10578,10188,10194,10301,5001,5300,9075,1226,0.11%
3154150,3112,Zona da Mata,31061,Manhuaçu,Reduto,MG,,,,5923,6344,6561,3359,3202,3640,2921,1.03%
3154200,3111,Campo das Vertentes,31058,São João Del Rei,Resende Costa,MG,8686,8539,9706,10336,10537,10918,5372,5546,8782,2136,0.55%
3154309,3108,Vale do Rio Doce,31041,Aimorés,Resplendor,MG,27013,19433,17499,16975,17024,17099,8380,8719,12834,4265,0.07%
3154408,3111,Campo das Vertentes,31059,Barbacena,Ressaquinha,MG,8867,9053,9380,4557,4574,4686,2338,2348,3021,1665,0.28%
3154457,3102,Norte de Minas,31006,Pirapora,Riachinho,MG,,,,7973,8126,8007,4182,3825,4435,3572,0.04%
3154507,3102,Norte de Minas,31004,Janaúba,Riacho dos Machados,MG,9676,8981,10201,9358,9392,9360,4754,4606,4499,4861,0.00%
3154606,3107,Metropolitana de Belo Horizonte,31030,Belo Horizonte,Ribeirão das Neves,MG,9707,67249,143853,246846,329112,296376,147044,149332,294211,2165,1.85%
3154705,3111,Campo das Vertentes,31057,Lavras,Ribeirão Vermelho,MG,4101,3568,3614,3621,3773,3826,1842,1984,3543,283,0.55%
3154804,3107,Metropolitana de Belo Horizonte,31030,Belo Horizonte,Rio Acima,MG,5118,5073,7066,7658,8257,9095,4474,4621,7949,1146,1.73%
3154903,3112,Zona da Mata,31060,Ponte Nova,Rio Casca,MG,18389,15789,15367,15260,14496,14198,6846,7352,11334,2864,-0.72%
3155009,3112,Zona da Mata,31060,Ponte Nova,Rio Doce,MG,4033,2777,2629,2318,2520,2468,1230,1238,1653,815,0.63%
3155108,3103,Jequitinhonha,31014,Almenara,Rio do Prado,MG,15852,13428,13401,5390,4489,5213,2679,2534,2726,2487,-0.33%
3155207,3112,Zona da Mata,31062,Viçosa,Rio Espera,MG,8683,7718,7461,6942,6594,6078,3070,3008,2411,3667,-1.32%
3155306,3107,Metropolitana de Belo Horizonte,31032,Itaguara,Rio Manso,MG,5214,4445,4461,4646,5007,5267,2757,2510,2833,2434,1.26%
3155405,3112,Zona da Mata,31065,Juiz de Fora,Rio Novo,MG,11039,9588,11179,8550,8910,8715,4369,4346,7539,1176,0.19%
3155504,3105,Triângulo Mineiro/Alto Paranaíba,31020,Patos de Minas,Rio Paranaíba,MG,7590,10768,9453,11528,10809,11898,6097,5801,7301,4597,0.32%
3155603,3102,Norte de Minas,31005,Salinas,Rio Pardo de Minas,MG,37559,42749,48807,27237,28633,29075,14822,14253,11701,17374,0.66%
3155702,3107,Metropolitana de Belo Horizonte,31031,Itabira,Rio Piracicaba,MG,13232,12613,13676,14138,14319,14167,6908,7259,11284,2883,0.02%
3155801,3112,Zona da Mata,31064,Ubá,Rio Pomba,MG,14588,14057,14884,16359,16709,17123,8506,8617,14445,2678,0.46%
3155900,3112,Zona da Mata,31065,Juiz de Fora,Rio Preto,MG,9034,8282,7271,5142,5388,5292,2671,2621,4451,841,0.29%
3156007,3107,Metropolitana de Belo Horizonte,31028,Conceição do Mato Dentro,Rio Vermelho,MG,16238,15089,15862,14905,14856,13648,6722,6926,5484,8164,-0.88%
3156106,3111,Campo das Vertentes,31058,São João Del Rei,Ritápolis,MG,5656,5806,5753,5423,5068,4931,2439,2492,3415,1516,-0.95%
3156205,3112,Zona da Mata,31065,Juiz de Fora,Rochedo de Minas,MG,1825,1526,1546,1907,2036,2116,1086,1030,1914,202,1.05%
3156304,3112,Zona da Mata,31064,Ubá,Rodeiro,MG,4308,3244,3749,5375,6178,6863,3450,3413,5551,1312,2.47%
3156403,3105,Triângulo Mineiro/Alto Paranaíba,31019,Patrocínio,Romaria,MG,1963,2832,3392,3737,3561,3601,1869,1732,2720,881,-0.37%
3156452,3112,Zona da Mata,31063,Muriaé,Rosário da Limeira,MG,,,,3869,4151,4242,2183,2059,2294,1948,0.92%
3156502,3102,Norte de Minas,31005,Salinas,Rubelita,MG,14752,10667,10006,10199,8299,7777,4000,3777,2516,5261,-2.67%
3156601,3103,Jequitinhonha,31014,Almenara,Rubim,MG,13708,12235,10772,9666,9561,9908,5044,4864,7700,2208,0.25%
3156700,3107,Metropolitana de Belo Horizonte,31030,Belo Horizonte,Sabará,MG,45149,64210,89740,115352,120770,126219,60772,65447,123042,3177,0.90%
3156809,3108,Vale do Rio Doce,31035,Guanhães,Sabinópolis,MG,15761,14899,16054,16269,15889,15707,7775,7932,10134,5573,-0.35%
3156908,3105,Triângulo Mineiro/Alto Paranaíba,31023,Araxá,Sacramento,MG,22811,18792,20406,21334,22159,23880,12121,11759,19278,4602,1.13%
3157005,3102,Norte de Minas,31005,Salinas,Salinas,MG,45925,48808,50849,36720,37370,39182,19270,19912,30718,8464,0.65%
3157104,3103,Jequitinhonha,31014,Almenara,Salto da Divisa,MG,10188,8401,7788,6779,6896,6862,3509,3353,5751,1111,0.12%
3157203,3107,Metropolitana de Belo Horizonte,31031,Itabira,Santa Bárbara,MG,16246,18057,25931,24180,26185,27850,13663,14187,24771,3079,1.42%
3157252,3108,Vale do Rio Doce,31040,Caratinga,Santa Bárbara do Leste,MG,,,,7208,7451,7679,3920,3759,3974,3705,0.63%
3157278,3112,Zona da Mata,31065,Juiz de Fora,Santa Bárbara do Monte Verde,MG,,,,2366,2796,2789,1450,1339,1620,1169,1.66%
3157302,3111,Campo das Vertentes,31059,Barbacena,Santa Bárbara do Tugúrio,MG,4641,5419,5289,4827,4504,4603,2337,2266,2195,2408,-0.47%
3157336,3111,Campo das Vertentes,31058,São João Del Rei,Santa Cruz de Minas,MG,,,,7042,7347,7870,3856,4014,7870,0,1.12%
3157377,3102,Norte de Minas,31005,Salinas,Santa Cruz de Salinas,MG,,,,4801,5192,4397,2274,2123,1152,3245,-0.88%
3157401,3112,Zona da Mata,31060,Ponte Nova,Santa Cruz do Escalvado,MG,10666,7571,6426,5378,5193,4996,2510,2486,1734,3262,-0.73%
3157500,3108,Vale do Rio Doce,31035,Guanhães,Santa Efigênia de Minas,MG,4363,4506,4987,4924,4519,4610,2274,2336,3056,1554,-0.66%
3157609,3102,Norte de Minas,31006,Pirapora,Santa Fé de Minas,MG,5282,3744,4573,4192,4034,3979,2096,1883,2302,1677,-0.52%
3157658,3104,Vale do Mucuri,31016,Nanuque,Santa Helena de Minas,MG,,,,5753,5892,6055,3055,3000,3769,2286,0.51%
3157708,3105,Triângulo Mineiro/Alto Paranaíba,31023,Araxá,Santa Juliana,MG,5508,6031,7820,8078,10582,11343,5846,5497,9797,1546,3.45%
3157807,3107,Metropolitana de Belo Horizonte,31030,Belo Horizonte,Santa Luzia,MG,25301,59893,137825,184903,222507,203184,98644,104540,202620,564,0.95%
3157906,3112,Zona da Mata,31061,Manhuaçu,Santa Margarida,MG,9907,11123,12805,13713,14205,15011,7583,7428,7626,7385,0.91%
3158003,3107,Metropolitana de Belo Horizonte,31031,Itabira,Santa Maria de Itabira,MG,10198,9491,10433,10346,10445,10561,5241,5320,6345,4216,0.21%
3158102,3103,Jequitinhonha,31014,Almenara,Santa Maria do Salto,MG,5409,4634,5312,5438,5724,5293,2723,2570,3749,1544,-0.27%
3158201,3108,Vale do Rio Doce,31036,Peçanha,Santa Maria do Suaçuí,MG,26482,19986,18306,14350,14427,14399,7151,7248,10726,3673,0.03%
3158300,3110,Sul/Sudoeste de Minas,31050,Varginha,Santana da Vargem,MG,5309,6346,6846,7521,7092,7239,3627,3612,5280,1959,-0.38%
3158409,3112,Zona da Mata,31066,Cataguases,Santana de Cataguases,MG,4298,3204,3531,3360,3603,3622,1818,1804,2917,705,0.75%
3158508,3107,Metropolitana de Belo Horizonte,31027,Sete Lagoas,Santana de Pirapama,MG,12731,10060,9212,8616,8549,8004,4124,3880,3326,4678,-0.73%
3158607,3112,Zona da Mata,31065,Juiz de Fora,Santana do Deserto,MG,3586,3260,3417,3774,3833,3854,1943,1911,1405,2449,0.21%
3158706,3111,Campo das Vertentes,31058,São João Del Rei,Santana do Garambéu,MG,1677,1639,1755,1982,2104,2235,1170,1065,1653,582,1.21%
3158805,3109,Oeste de Minas,31045,Campo Belo,Santana do Jacaré,MG,3396,3590,3836,4408,4532,4613,2321,2292,4434,179,0.46%
3158904,3112,Zona da Mata,31061,Manhuaçu,Santana do Manhuaçu,MG,7481,7750,9156,8607,8185,8603,4403,4200,4154,4449,-0.00%
3158953,3108,Vale do Rio Doce,31039,Ipatinga,Santana do Paraíso,MG,,,,18155,22765,27258,13678,13580,25239,2019,4.15%
3159001,3107,Metropolitana de Belo Horizonte,31027,Sete Lagoas,Santana do Riacho,MG,4179,3191,3404,3739,4159,4023,2017,2006,2279,1744,0.73%
3159100,3107,Metropolitana de Belo Horizonte,31034,Conselheiro Lafaiete,Santana dos Montes,MG,4785,4294,4144,3944,3989,3822,1961,1861,2292,1530,-0.31%
3159209,3110,Sul/Sudoeste de Minas,31051,Poços de Caldas,Santa Rita de Caldas,MG,9654,9079,9258,9278,9078,9031,4606,4425,5659,3372,-0.27%
3159308,3112,Zona da Mata,31065,Juiz de Fora,Santa Rita de Jacutinga,MG,5408,7542,5122,5218,5588,4996,2537,2459,3757,1239,-0.43%
3159357,3108,Vale do Rio Doce,31040,Caratinga,Santa Rita de Minas,MG,,,,5795,5787,6552,3302,3250,4778,1774,1.24%
3159407,3112,Zona da Mata,31065,Juiz de Fora,Santa Rita de Ibitipoca,MG,5050,5367,4064,3847,3747,3583,1846,1737,2233,1350,-0.71%
3159506,3108,Vale do Rio Doce,31041,Aimorés,Santa Rita do Itueto,MG,8284,6937,6095,6061,5652,5700,2931,2769,2313,3387,-0.61%
3159605,3110,Sul/Sudoeste de Minas,31053,Santa Rita do Sapucaí,Santa Rita do Sapucaí,MG,18920,22228,26317,31264,34246,37784,18878,18906,32488,5296,1.91%
3159704,3105,Triângulo Mineiro/Alto Paranaíba,31020,Patos de Minas,Santa Rosa da Serra,MG,4957,2757,2867,3114,3261,3224,1691,1533,1973,1251,0.35%
3159803,3105,Triângulo Mineiro/Alto Paranaíba,31017,Ituiutaba,Santa Vitória,MG,19635,17385,16583,16365,15492,18157,9408,8749,14945,3212,1.04%
3159902,3109,Oeste de Minas,31046,Oliveira,Santo Antônio do Amparo,MG,9060,11785,13753,16109,17255,17349,8590,8759,15186,2163,0.74%
3160009,3112,Zona da Mata,31066,Cataguases,Santo Antônio do Aventureiro,MG,4676,3988,3490,3514,3489,3534,1805,1729,2376,1158,0.06%
3160108,3112,Zona da Mata,31060,Ponte Nova,Santo Antônio do Grama,MG,5062,4803,4587,4377,4241,4090,2034,2056,3365,725,-0.68%
3160207,3107,Metropolitana de Belo Horizonte,31028,Conceição do Mato Dentro,Santo Antônio do Itambé,MG,5029,5356,4447,4588,4517,4135,2068,2067,1230,2905,-1.03%
3160306,3103,Jequitinhonha,31014,Almenara,Santo Antônio do Jacinto,MG,13385,12715,12093,12144,11294,11780,6029,5751,6366,5414,-0.30%
3160405,3109,Oeste de Minas,31043,Divinópolis,Santo Antônio do Monte,MG,16560,14912,17979,23473,24746,25989,13205,12784,22205,3784,1.02%
3160454,3102,Norte de Minas,31005,Salinas,Santo Antônio do Retiro,MG,,,,6655,6817,6938,3512,3426,1590,5348,0.42%
3160504,3107,Metropolitana de Belo Horizonte,31028,Conceição do Mato Dentro,Santo Antônio do Rio Abaixo,MG,2284,2707,2101,1823,1753,1777,889,888,888,889,-0.26%
3160603,3106,Central Mineira,31025,Curvelo,Santo Hipólito,MG,4136,3647,3705,3488,3541,3240,1624,1616,2246,994,-0.73%
3160702,3112,Zona da Mata,31065,Juiz de Fora,Santos Dumont,MG,37985,40005,44965,46789,45922,46289,22493,23796,41330,4959,-0.11%
3160801,3110,Sul/Sudoeste de Minas,31050,Varginha,São Bento Abade,MG,1491,1782,2556,3737,4400,4577,2385,2192,4238,339,2.05%
3160900,3107,Metropolitana de Belo Horizonte,31034,Conselheiro Lafaiete,São Brás do Suaçuí,MG,2492,2978,3198,3282,3488,3512,1730,1782,3128,384,0.68%
3160959,3108,Vale do Rio Doce,31040,Caratinga,São Domingos das Dores,MG,,,,5192,5232,5396,2744,2652,2568,2828,0.39%
3161007,3107,Metropolitana de Belo Horizonte,31031,Itabira,São Domingos do Prata,MG,21161,17742,18742,17642,17349,17352,8438,8914,10506,6846,-0.17%
3161056,3108,Vale do Rio Doce,31038,Mantena,São Félix de Minas,MG,,,,3454,3387,3382,1730,1652,2089,1293,-0.21%
3161106,3102,Norte de Minas,31003,Januária,São Francisco,MG,58254,61886,72481,51497,52985,53898,27313,26585,34235,19663,0.46%
3161205,3109,Oeste de Minas,31046,Oliveira,São Francisco de Paula,MG,4985,5451,6152,6533,6246,6487,3282,3205,4655,1832,-0.07%
3161304,3105,Triângulo Mineiro/Alto Paranaíba,31021,Frutal,São Francisco de Sales,MG,6774,4441,4941,5274,5167,5800,2980,2820,4338,1462,0.96%
3161403,3112,Zona da Mata,31063,Muriaé,São Francisco do Glória,MG,5356,5522,6365,5696,5539,5184,2650,2534,3138,2046,-0.94%
3161502,3112,Zona da Mata,31064,Ubá,São Geraldo,MG,9758,7521,7860,7716,9171,10246,5199,5047,7287,2959,2.88%
3161601,3108,Vale do Rio Doce,31037,Governador Valadares,São Geraldo da Piedade,MG,4410,4631,5063,5015,4768,4389,2136,2253,1054,3335,-1.32%
3161650,3108,Vale do Rio Doce,31037,Governador Valadares,São Geraldo do Baixio,MG,,,,2864,3253,3487,1762,1725,2440,1047,1.99%
3161700,3101,Noroeste de Minas,31002,Paracatu,São Gonçalo do Abaeté,MG,11966,10875,9745,5432,6156,6252,3234,3018,4174,2078,1.42%
3161809,3109,Oeste de Minas,31043,Divinópolis,São Gonçalo do Pará,MG,6329,6227,7541,7969,10308,10405,5235,5170,7969,2436,2.70%
3161908,3107,Metropolitana de Belo Horizonte,31031,Itabira,São Gonçalo do Rio Abaixo,MG,7865,10093,8322,8462,9233,9782,4876,4906,4654,5128,1.46%
3162005,3110,Sul/Sudoeste de Minas,31053,Santa Rita do Sapucaí,São Gonçalo do Sapucaí,MG,16067,17498,19611,22308,22751,23909,11929,11980,19745,4164,0.70%
3162104,3105,Triângulo Mineiro/Alto Paranaíba,31020,Patos de Minas,São Gotardo,MG,18223,17320,19697,27631,30757,31807,16075,15732,30050,1757,1.42%
3162203,3110,Sul/Sudoeste de Minas,31047,Passos,São João Batista do Glória,MG,4980,4862,5352,6271,6828,6890,3559,3331,5610,1280,0.95%
3162252,3102,Norte de Minas,31007,Montes Claros,São João da Lagoa,MG,,,,4400,4729,4659,2439,2220,2435,2224,0.57%
3162302,3110,Sul/Sudoeste de Minas,31053,Santa Rita do Sapucaí,São João da Mata,MG,2151,2051,2541,2752,2858,2732,1400,1332,1752,980,-0.07%
3162401,3102,Norte de Minas,31007,Montes Claros,São João da Ponte,MG,33394,33162,32476,26028,26091,25362,13123,12239,8642,16720,-0.26%
3162450,3102,Norte de Minas,31003,Januária,São João das Missões,MG,,,,10230,10769,11715,6048,5667,2446,9269,1.36%
3162500,3111,Campo das Vertentes,31058,São João Del Rei,São João del Rei,MG,55230,64691,72747,78616,81918,84404,40494,43910,79790,4614,0.71%
3162559,3112,Zona da Mata,31061,Manhuaçu,São João do Manhuaçu,MG,,,,8716,9394,10245,5214,5031,4806,5439,1.63%
3162575,3108,Vale do Rio Doce,31038,Mantena,São João do Manteninha,MG,,,,4406,4855,5183,2557,2626,2905,2278,1.64%
3162609,3108,Vale do Rio Doce,31040,Caratinga,São João do Oriente,MG,8024,11993,8166,8492,7988,7874,3907,3967,6325,1549,-0.75%
3162658,3102,Norte de Minas,31007,Montes Claros,São João do Pacuí,MG,,,,3664,4003,4066,2095,1971,1921,2145,1.05%
3162708,3102,Norte de Minas,31005,Salinas,São João do Paraíso,MG,22727,23731,28919,21010,21839,22334,11173,11161,10239,12095,0.61%
3162807,3108,Vale do Rio Doce,31035,Guanhães,São João Evangelista,MG,15706,15230,15375,15526,15686,15538,7599,7939,10108,5430,0.01%
3162906,3112,Zona da Mata,31065,Juiz de Fora,São João Nepomuceno,MG,18156,17614,21432,23786,25011,25062,12184,12878,23840,1222,0.52%
3162922,3107,Metropolitana de Belo Horizonte,31030,Belo Horizonte,São Joaquim de Bicas,MG,,,,18152,22214,25619,13756,11863,18652,6967,3.51%
3162948,3110,Sul/Sudoeste de Minas,31047,Passos,São José da Barra,MG,,,,6053,6701,6778,3509,3269,4894,1884,1.14%
3162955,3107,Metropolitana de Belo Horizonte,31030,Belo Horizonte,São José da Lapa,MG,,,,15000,17900,19801,9825,9976,11395,8406,2.82%
3163003,3108,Vale do Rio Doce,31037,Governador Valadares,São José da Safira,MG,5584,3852,3701,3894,3929,4075,2025,2050,2945,1130,0.46%
3163102,3107,Metropolitana de Belo Horizonte,31029,Pará de Minas,São José da Varginha,MG,2355,2030,2690,3225,3797,4201,2134,2067,2375,1826,2.68%
3163201,3110,Sul/Sudoeste de Minas,31053,Santa Rita do Sapucaí,São José do Alegre,MG,3318,2985,3320,3802,3908,3996,1976,2020,2901,1095,0.50%
3163300,3108,Vale do Rio Doce,31037,Governador Valadares,São José do Divino,MG,7733,5327,4245,3863,3776,3837,1890,1947,2728,1109,-0.07%
3163409,3107,Metropolitana de Belo Horizonte,31031,Itabira,São José do Goiabal,MG,9795,6474,6170,6009,5646,5636,2732,2904,3689,1947,-0.64%
3163508,3108,Vale do Rio Doce,31036,Peçanha,São José do Jacuri,MG,11230,11363,10976,6789,6958,6553,3331,3222,2006,4547,-0.35%
3163607,3112,Zona da Mata,31061,Manhuaçu,São José do Mantimento,MG,2522,2692,2224,2379,2472,2592,1289,1303,1445,1147,0.86%
3163706,3110,Sul/Sudoeste de Minas,31054,São Lourenço,São Lourenço,MG,19269,24021,29870,36927,40441,41664,19764,21900,41664,0,1.21%
3163805,3112,Zona da Mata,31062,Viçosa,São Miguel do Anta,MG,6088,5499,6315,6641,6820,6750,3433,3317,3742,3008,0.16%
3163904,3110,Sul/Sudoeste de Minas,31048,São Sebastião do Paraíso,São Pedro da União,MG,4904,4773,5072,5618,5291,5040,2647,2393,2781,2259,-1.08%
3164001,3112,Zona da Mata,31060,Ponte Nova,São Pedro dos Ferros,MG,13958,11473,10273,9239,8880,8353,4125,4228,6780,1573,-1.00%
3164100,3108,Vale do Rio Doce,31036,Peçanha,São Pedro do Suaçuí,MG,9525,9111,9286,6081,5801,5570,2746,2824,2302,3268,-0.87%
3164209,3102,Norte de Minas,31006,Pirapora,São Romão,MG,11648,12073,14562,7783,9080,10285,5236,5049,6476,3809,2.83%
3164308,3109,Oeste de Minas,31042,Piuí,São Roque de Minas,MG,7143,6434,6323,6325,6141,6686,3483,3203,4222,2464,0.56%
3164407,3110,Sul/Sudoeste de Minas,31053,Santa Rita do Sapucaí,São Sebastião da Bela Vista,MG,3004,3164,3866,4311,4884,4948,2578,2370,2889,2059,1.39%
3164431,3112,Zona da Mata,31063,Muriaé,São Sebastião da Vargem Alegre,MG,,,,2573,2743,2798,1459,1339,1603,1195,0.84%
3164472,3108,Vale do Rio Doce,31040,Caratinga,São Sebastião do Anta,MG,,,,4779,5388,5739,2926,2813,4209,1530,1.85%
3164506,3108,Vale do Rio Doce,31036,Peçanha,São Sebastião do Maranhão,MG,15082,12809,12820,11604,11686,10647,5371,5276,3250,7397,-0.86%
3164605,3109,Oeste de Minas,31043,Divinópolis,São Sebastião do Oeste,MG,6170,5007,5057,4648,5336,5805,3030,2775,3247,2558,2.25%
3164704,3110,Sul/Sudoeste de Minas,31048,São Sebastião do Paraíso,São Sebastião do Paraíso,MG,28538,39565,49053,58335,61838,65034,32207,32827,59994,5040,1.09%
3164803,3107,Metropolitana de Belo Horizonte,31028,Conceição do Mato Dentro,São Sebastião do Rio Preto,MG,2743,2743,2116,1779,1700,1616,774,842,876,740,-0.96%
3164902,3110,Sul/Sudoeste de Minas,31054,São Lourenço,São Sebastião do Rio Verde,MG,2496,1681,1803,1976,2170,2110,1048,1062,1321,789,0.66%
3165008,3111,Campo das Vertentes,31058,São João Del Rei,São Tiago,MG,9400,8967,9642,10245,10289,10553,5291,5262,8467,2086,0.30%
3165107,3110,Sul/Sudoeste de Minas,31048,São Sebastião do Paraíso,São Tomás de Aquino,MG,6879,7323,6945,7303,6934,7093,3558,3535,5522,1571,-0.29%
3165206,3110,Sul/Sudoeste de Minas,31050,Varginha,São Thomé das Letras,MG,6796,5292,5700,6204,6617,6655,3539,3116,3857,2798,0.70%
3165305,3110,Sul/Sudoeste de Minas,31055,Andrelândia,São Vicente de Minas,MG,5545,5569,5407,6163,6283,7008,3394,3614,5940,1068,1.29%
3165404,3110,Sul/Sudoeste de Minas,31052,Pouso Alegre,Sapucaí-Mirim,MG,4398,3701,4274,5455,5772,6241,3203,3038,3783,2458,1.36%
3165503,3108,Vale do Rio Doce,31035,Guanhães,Sardoá,MG,3581,3724,4269,4775,5196,5597,2813,2784,2000,3597,1.60%
3165537,3107,Metropolitana de Belo Horizonte,31030,Belo Horizonte,Sarzedo,MG,,,,17274,23282,25798,12869,12929,25516,282,4.09%
3165552,3104,Vale do Mucuri,31015,Teófilo Otoni,Setubinha,MG,,,,9291,10834,10885,5350,5535,2802,8083,1.60%
3165560,3112,Zona da Mata,31060,Ponte Nova,Sem-Peixe,MG,,,,3170,2950,2847,1404,1443,1507,1340,-1.07%
3165578,3110,Sul/Sudoeste de Minas,31052,Pouso Alegre,Senador Amaral,MG,,,,5128,5051,5225,2779,2446,3107,2118,0.19%
3165602,3112,Zona da Mata,31065,Juiz de Fora,Senador Cortes,MG,2096,1764,1847,2000,2011,1980,980,1000,1512,468,-0.10%
3165701,3112,Zona da Mata,31064,Ubá,Senador Firmino,MG,6754,6757,6241,6598,7019,7230,3653,3577,4683,2547,0.92%
3165800,3110,Sul/Sudoeste de Minas,31052,Pouso Alegre,Senador José Bento,MG,2424,2129,2013,2371,1908,1868,1005,863,683,1185,-2.36%
3165909,3103,Jequitinhonha,31010,Diamantina,Senador Modestino Gonçalves,MG,5613,5656,5309,5190,4988,4574,2315,2259,1803,2771,-1.26%
3166006,3112,Zona da Mata,31062,Viçosa,Senhora de Oliveira,MG,4739,4812,5089,5643,5675,5689,2852,2837,3262,2427,0.08%
3166105,3108,Vale do Rio Doce,31035,Guanhães,Senhora do Porto,MG,5766,4640,3702,3520,3517,3493,1766,1727,1284,2209,-0.08%
3166204,3111,Campo das Vertentes,31059,Barbacena,Senhora dos Remédios,MG,8873,9069,9725,10024,10201,10202,5155,5047,3435,6767,0.18%
3166303,3112,Zona da Mata,31060,Ponte Nova,Sericita,MG,4778,5413,6382,6990,7083,7125,3644,3481,3718,3407,0.19%
3166402,3110,Sul/Sudoeste de Minas,31055,Andrelândia,Seritinga,MG,1835,1675,1723,1738,1755,1790,917,873,1483,307,0.30%
3166501,3107,Metropolitana de Belo Horizonte,31028,Conceição do Mato Dentro,Serra Azul de Minas,MG,3676,3847,3874,4197,4307,4220,2121,2099,1710,2510,0.05%
3166600,3106,Central Mineira,31026,Bom Despacho,Serra da Saudade,MG,2160,1020,852,873,863,815,431,384,527,288,-0.69%
3166709,3104,Vale do Mucuri,31016,Nanuque,Serra dos Aimorés,MG,10424,8096,10224,8182,8345,8419,4174,4245,6780,1639,0.29%
3166808,3105,Triângulo Mineiro/Alto Paranaíba,31019,Patrocínio,Serra do Salitre,MG,5660,6299,7984,9390,10224,10541,5412,5129,7751,2790,1.16%
3166907,3110,Sul/Sudoeste de Minas,31049,Alfenas,Serrania,MG,4544,5729,6975,7504,7370,7540,3803,3737,6574,966,0.05%
3166956,3102,Norte de Minas,31004,Janaúba,Serranópolis de Minas,MG,,,,4038,4515,4425,2231,2194,1728,2697,0.92%
3167004,3110,Sul/Sudoeste de Minas,31055,Andrelândia,Serranos,MG,2386,2155,2036,2071,2063,1996,1001,995,1543,453,-0.37%
3167103,3107,Metropolitana de Belo Horizonte,31028,Conceição do Mato Dentro,Serro,MG,17579,17369,19341,21012,20862,20833,10367,10466,12895,7938,-0.09%
3167202,3107,Metropolitana de Belo Horizonte,31027,Sete Lagoas,Sete Lagoas,MG,66585,100618,144014,184871,217506,214071,103912,110159,208879,5192,1.48%
3167301,3112,Zona da Mata,31064,Ubá,Silveirânia,MG,2699,2075,2047,2138,2125,2192,1148,1044,1429,763,0.25%
3167400,3110,Sul/Sudoeste de Minas,31053,Santa Rita do Sapucaí,Silvianópolis,MG,6927,5746,5825,5855,6018,6029,3129,2900,3647,2382,0.29%
3167509,3112,Zona da Mata,31065,Juiz de Fora,Simão Pereira,MG,2830,2371,2414,2479,2503,2537,1247,1290,1496,1041,0.23%
3167608,3112,Zona da Mata,31061,Manhuaçu,Simonésia,MG,12865,14443,16302,16875,17257,18302,9460,8842,7114,11188,0.82%
3167707,3108,Vale do Rio Doce,31037,Governador Valadares,Sobrália,MG,10217,7613,6838,6284,5990,5828,2855,2973,4126,1702,-0.75%
3167806,3110,Sul/Sudoeste de Minas,31054,São Lourenço,Soledade de Minas,MG,5978,4815,4929,5155,5518,5678,2842,2836,3765,1913,0.97%
3167905,3112,Zona da Mata,31064,Ubá,Tabuleiro,MG,5356,4791,4361,4572,4061,4076,2045,2031,2701,1375,-1.14%
3168002,3102,Norte de Minas,31005,Salinas,Taiobeiras,MG,14023,19125,26673,27347,29732,30894,15108,15786,25042,5852,1.23%
3168051,3108,Vale do Rio Doce,31041,Aimorés,Taparuba,MG,,,,3225,3243,3137,1616,1521,1405,1732,-0.28%
3168101,3105,Triângulo Mineiro/Alto Paranaíba,31023,Araxá,Tapira,MG,3206,2723,2973,3327,3575,4102,2205,1897,2744,1358,2.12%
3168200,3109,Oeste de Minas,31042,Piuí,Tapiraí,MG,3443,2387,2240,1900,1841,1873,1002,871,1085,788,-0.14%
3168309,3107,Metropolitana de Belo Horizonte,31031,Itabira,Taquaraçu de Minas,MG,4034,3455,3383,3491,3757,3792,2026,1766,1753,2039,0.83%
3168408,3108,Vale do Rio Doce,31040,Caratinga,Tarumirim,MG,31881,23851,18056,14488,14185,14294,7102,7192,8019,6275,-0.13%
3168507,3112,Zona da Mata,31062,Viçosa,Teixeiras,MG,8709,8586,10024,11149,11665,11346,5538,5808,7605,3741,0.18%
3168606,3104,Vale do Mucuri,31015,Teófilo Otoni,Teófilo Otoni,MG,133017,128826,140833,129424,126895,134733,64447,70286,110059,24674,0.40%
3168705,3108,Vale do Rio Doce,31039,Ipatinga,Timóteo,MG,32760,50601,58298,71478,76092,81119,39129,41990,81003,116,1.27%
3168804,3111,Campo das Vertentes,31058,São João Del Rei,Tiradentes,MG,5518,7644,10236,5759,6547,7002,3458,3544,5404,1598,1.97%
3168903,3105,Triângulo Mineiro/Alto Paranaíba,31020,Patos de Minas,Tiros,MG,12844,9842,8647,7571,7416,6906,3537,3369,4815,2091,-0.92%
3169000,3112,Zona da Mata,31064,Ubá,Tocantins,MG,14346,13159,12836,15005,15704,15839,7906,7933,12926,2913,0.54%
3169059,3110,Sul/Sudoeste de Minas,31052,Pouso Alegre,Tocos do Moji,MG,,,,3821,3926,3950,2145,1805,1018,2932,0.33%
3169109,3110,Sul/Sudoeste de Minas,31052,Pouso Alegre,Toledo,MG,4394,4006,4664,5222,5720,5761,3039,2722,2190,3571,0.99%
3169208,3112,Zona da Mata,31063,Muriaé,Tombos,MG,10181,9198,9767,11652,9194,9542,4786,4756,7607,1935,-1.98%
3169307,3110,Sul/Sudoeste de Minas,31050,Varginha,Três Corações,MG,35180,44382,57045,65291,71737,72796,36115,36681,65851,6945,1.09%
3169356,3106,Central Mineira,31024,Três Marias,Três Marias,MG,9789,17624,21399,23568,26431,28315,14074,14241,26838,1477,1.85%
3169406,3110,Sul/Sudoeste de Minas,31050,Varginha,Três Pontas,MG,27514,37729,45832,51024,52121,53825,26688,27137,46242,7583,0.54%
3169505,3108,Vale do Rio Doce,31037,Governador Valadares,Tumiritinga,MG,8343,5848,5412,5831,5964,6291,3196,3095,4323,1968,0.76%
3169604,3105,Triângulo Mineiro/Alto Paranaíba,31018,Uberlândia,Tupaciguara,MG,25127,25241,26527,23117,23076,24185,12083,12102,22045,2140,0.45%
3169703,3103,Jequitinhonha,31011,Capelinha,Turmalina,MG,16490,17339,19409,15655,17219,18046,9161,8885,12913,5133,1.43%
3169802,3110,Sul/Sudoeste de Minas,31053,Santa Rita do Sapucaí,Turvolândia,MG,2930,3440,3660,4243,4737,4658,2410,2248,2910,1748,0.94%
3169901,3112,Zona da Mata,31064,Ubá,Ubá,MG,44503,53306,66511,85065,94228,101466,50246,51220,97599,3867,1.78%
3170008,3102,Norte de Minas,31007,Montes Claros,Ubaí,MG,12621,12303,13978,10774,11834,11677,5978,5699,5665,6012,0.81%
3170057,3108,Vale do Rio Doce,31040,Caratinga,Ubaporanga,MG,,,,11682,12060,12040,6085,5955,6434,5606,0.30%
3170107,3105,Triângulo Mineiro/Alto Paranaíba,31022,Uberaba,Uberaba,MG,124490,199208,211824,252051,287760,296000,144473,151527,289408,6592,1.62%
3170206,3105,Triângulo Mineiro/Alto Paranaíba,31018,Uberlândia,Uberlândia,MG,124706,240967,367061,501214,608369,600285,293115,307170,583879,16406,1.82%
3170305,3104,Vale do Mucuri,31016,Nanuque,Umburatiba,MG,4524,2821,2945,2872,2776,2700,1394,1306,1552,1148,-0.62%
3170404,3101,Noroeste de Minas,31001,Unaí,Unaí,MG,52303,67885,69612,70033,74495,77590,39305,38285,62364,15226,1.03%
3170438,3105,Triângulo Mineiro/Alto Paranaíba,31021,Frutal,União de Minas,MG,,,,4638,4593,4424,2415,2009,2731,1693,-0.47%
3170479,3101,Noroeste de Minas,31001,Unaí,Uruana de Minas,MG,,,,3263,2777,3238,1627,1611,1821,1417,-0.08%
3170503,3112,Zona da Mata,31060,Ponte Nova,Urucânia,MG,7668,9036,10513,10375,10203,10291,5085,5206,7946,2345,-0.08%
3170529,3102,Norte de Minas,31003,Januária,Urucuia,MG,,,,9615,11376,13605,7031,6574,6166,7439,3.53%
3170578,3108,Vale do Rio Doce,31040,Caratinga,Vargem Alegre,MG,,,,6544,6594,6457,3290,3167,4769,1688,-0.13%
3170602,3109,Oeste de Minas,31042,Piuí,Vargem Bonita,MG,2566,2510,2317,2212,2098,2163,1145,1018,1142,1021,-0.22%
3170651,3102,Norte de Minas,31005,Salinas,Vargem Grande do Rio Pardo,MG,,,,4457,4703,4733,2428,2305,2421,2312,0.60%
3170701,3110,Sul/Sudoeste de Minas,31050,Varginha,Varginha,MG,43628,64904,88022,108998,116093,123120,59975,63145,119099,4021,1.23%
3170750,3101,Noroeste de Minas,31002,Paracatu,Varjão de Minas,MG,,,,4701,5993,6065,3181,2884,5030,1035,2.58%
3170800,3102,Norte de Minas,31006,Pirapora,Várzea da Palma,MG,13358,18528,29523,31641,34448,35804,18144,17660,31317,4487,1.24%
3170909,3102,Norte de Minas,31007,Montes Claros,Varzelândia,MG,27204,23181,27081,19169,19137,19126,9769,9357,8906,10220,-0.02%
3171006,3101,Noroeste de Minas,31002,Paracatu,Vazante,MG,10014,14944,18799,18928,19300,19721,9928,9793,15924,3797,0.41%
3171030,3102,Norte de Minas,31007,Montes Claros,Verdelândia,MG,,,,7179,8029,8350,4276,4074,4764,3586,1.52%
3171071,3103,Jequitinhonha,31011,Capelinha,Veredinha,MG,,,,5257,5732,5533,2879,2654,3757,1776,0.51%
3171105,3105,Triângulo Mineiro/Alto Paranaíba,31022,Uberaba,Veríssimo,MG,4110,3414,3057,2874,3667,3466,1776,1690,2037,1429,1.89%
3171154,3112,Zona da Mata,31060,Ponte Nova,Vermelho Novo,MG,,,,4572,4551,4689,2428,2261,1852,2837,0.25%
3171204,3107,Metropolitana de Belo Horizonte,31030,Belo Horizonte,Vespasiano,MG,12429,25046,54868,76422,94191,104612,51095,53517,104612,0,3.19%
3171303,3112,Zona da Mata,31062,Viçosa,Viçosa,MG,25777,38626,51658,64854,70404,72244,34988,37256,67337,4907,1.08%
3171402,3112,Zona da Mata,31063,Muriaé,Vieiras,MG,4572,4114,3796,3952,3808,3732,1897,1835,1854,1878,-0.57%
3171501,3108,Vale do Rio Doce,31037,Governador Valadares,Mathias Lobato,MG,3339,3053,3658,3642,3457,3371,1676,1695,3058,313,-0.77%
3171600,3103,Jequitinhonha,31012,Araçuaí,Virgem da Lapa,MG,13612,13829,13925,13672,14103,13625,6757,6868,6842,6783,-0.03%
3171709,3110,Sul/Sudoeste de Minas,31056,Itajubá,Virgínia,MG,8534,8166,8540,8699,8351,8626,4308,4318,3936,4690,-0.08%
3171808,3108,Vale do Rio Doce,31035,Guanhães,Virginópolis,MG,10349,9926,12089,10827,10891,10572,5212,5360,6210,4362,-0.24%
3171907,3108,Vale do Rio Doce,31037,Governador Valadares,Virgolândia,MG,10558,9111,6822,6112,5724,5659,2790,2869,3400,2259,-0.77%
3172004,3112,Zona da Mata,31064,Ubá,Visconde do Rio Branco,MG,25206,26257,28451,32598,35346,37952,18702,19250,31397,6555,1.53%
3172103,3112,Zona da Mata,31066,Cataguases,Volta Grande,MG,4920,4765,4531,4919,5166,5063,2470,2593,3802,1261,0.29%
3172202,3110,Sul/Sudoeste de Minas,31056,Itajubá,Wenceslau Braz,MG,3116,2528,2487,2596,2509,2553,1288,1265,1270,1283,-0.17%
5000203,5003,Leste de Mato Grosso do Sul,50007,Três Lagoas,Água Clara,MS,3187,4807,6539,11015,13183,14429,7552,6877,9598,4831,2.74%
5000252,5002,Centro Norte de Mato Grosso do Sul,50003,Alto Taquari,Alcinópolis,MS,,,,3679,4299,4570,2433,2137,3138,1432,2.19%
5000609,5004,Sudoeste de Mato Grosso do Sul,50010,Dourados,Amambai,MS,22667,58534,25951,29484,33426,34739,17379,17360,22383,12356,1.65%
5000708,5001,Pantanais Sul Mato-grossense,50002,Aquidauana,Anastácio,MS,15371,21939,19940,22477,22364,23846,11915,11931,19681,4165,0.59%
5000807,5003,Leste de Mato Grosso do Sul,50008,Nova Andradina,Anaurilândia,MS,6029,7222,7270,7955,8380,8494,4308,4186,4322,4172,0.66%
5000856,5004,Sudoeste de Mato Grosso do Sul,50011,Iguatemi,Angélica,MS,,10535,8834,7356,7253,9170,4707,4463,7680,1490,2.23%
5000906,5004,Sudoeste de Mato Grosso do Sul,50010,Dourados,Antônio João,MS,5080,5668,6636,7408,8350,8215,4111,4104,6836,1379,1.04%
5001003,5003,Leste de Mato Grosso do Sul,50006,Paranaíba,Aparecida do Taboado,MS,14701,14027,15172,18402,19819,22305,11152,11153,20094,2211,1.94%
5001102,5001,Pantanais Sul Mato-grossense,50002,Aquidauana,Aquidauana,MS,28725,34493,39342,43440,44920,45623,22855,22768,35954,9669,0.49%
5001243,5004,Sudoeste de Mato Grosso do Sul,50010,Dourados,Aral Moreira,MS,,10121,8064,8055,9236,10255,5269,4986,5361,4894,2.44%
5001508,5002,Centro Norte de Mato Grosso do Sul,50004,Campo Grande,Bandeirantes,MS,5690,6808,6169,6425,5888,6598,3455,3143,4520,2078,0.27%
5001904,5003,Leste de Mato Grosso do Sul,50008,Nova Andradina,Bataguassu,MS,9656,9202,11450,16197,18687,19825,10089,9736,15234,4591,2.04%
5002001,5003,Leste de Mato Grosso do Sul,50008,Nova Andradina,Batayporã,MS,14930,14144,7971,10625,10564,10938,5405,5533,8331,2607,0.29%
5002100,5004,Sudoeste de Mato Grosso do Sul,50009,Bodoquena,Bela Vista,MS,15028,15601,19135,21764,22868,23175,11720,11455,18924,4251,0.63%
5002159,5004,Sudoeste de Mato Grosso do Sul,50009,Bodoquena,Bodoquena,MS,,,8120,8367,8168,7986,4112,3874,5778,2208,-0.46%
5002209,5004,Sudoeste de Mato Grosso do Sul,50009,Bodoquena,Bonito,MS,7913,11002,15543,16956,17275,19598,9890,9708,16161,3437,1.46%
5002308,5003,Leste de Mato Grosso do Sul,50007,Três Lagoas,Brasilândia,MS,10400,12622,10349,11956,12136,11804,6040,5764,8005,3799,-0.13%
5002407,5004,Sudoeste de Mato Grosso do Sul,50010,Dourados,Caarapó,MS,26007,27307,22492,20706,22723,25763,12913,12850,18305,7458,2.21%
5002605,5002,Centro Norte de Mato Grosso do Sul,50003,Alto Taquari,Camapuã,MS,15829,22654,15501,16446,13192,13648,7071,6577,9822,3826,-1.85%
5002704,5002,Centro Norte de Mato Grosso do Sul,50004,Campo Grande,Campo Grande,MS,140233,291777,526126,663621,724524,787204,381544,405660,776654,10550,1.72%
5002803,5004,Sudoeste de Mato Grosso do Sul,50009,Bodoquena,Caracol,MS,4025,3819,3930,4592,5095,5400,2766,2634,3240,2160,1.63%
5002902,5003,Leste de Mato Grosso do Sul,50005,Cassilândia,Cassilândia,MS,12476,17030,17861,20087,20916,20932,10434,10498,18970,1962,0.41%
5002951,5003,Leste de Mato Grosso do Sul,50005,Cassilândia,Chapadão do Sul,MS,,,5383,11658,16193,19654,10291,9363,16805,2849,5.36%
5003108,5002,Centro Norte de Mato Grosso do Sul,50004,Campo Grande,Corguinho,MS,3791,3731,3679,3592,4165,4862,2629,2233,1872,2990,3.07%
5003157,5004,Sudoeste de Mato Grosso do Sul,50011,Iguatemi,Coronel Sapucaia,MS,,,11609,12810,13979,14064,6954,7110,10208,3856,0.94%
5003207,5001,Pantanais Sul Mato-grossense,50001,Baixo Pantanal,Corumbá,MS,81887,81129,88411,95701,96373,103772,52304,51468,93510,10262,0.81%
5003256,5003,Leste de Mato Grosso do Sul,50005,Cassilândia,Costa Rica,MS,,,13973,15488,18277,19689,10239,9450,16840,2849,2.43%
5003306,5002,Centro Norte de Mato Grosso do Sul,50003,Alto Taquari,Coxim,MS,18537,27628,33549,30866,31816,32180,16150,16030,29160,3020,0.42%
5003454,5004,Sudoeste de Mato Grosso do Sul,50011,Iguatemi,Deodápolis,MS,,18078,13713,11350,11261,12131,6126,6005,10042,2089,0.67%
5003488,5001,Pantanais Sul Mato-grossense,50002,Aquidauana,Dois Irmãos do Buriti,MS,,,8749,9335,9350,10362,5531,4831,4706,5656,1.05%
5003504,5004,Sudoeste de Mato Grosso do Sul,50010,Dourados,Douradina,MS,,,4741,4732,4900,5365,2722,2643,3286,2079,1.26%
5003702,5004,Sudoeste de Mato Grosso do Sul,50010,Dourados,Dourados,MS,79186,106500,135984,164949,181869,196068,96342,99726,181086,14982,1.74%
5003751,5004,Sudoeste de Mato Grosso do Sul,50011,Iguatemi,Eldorado,MS,,15315,11025,11059,11934,11680,5789,5891,9333,2347,0.55%
5003801,5004,Sudoeste de Mato Grosso do Sul,50010,Dourados,Fátima do Sul,MS,40913,33318,22155,19111,18789,19024,9360,9664,16956,2068,-0.05%
5003900,5002,Centro Norte de Mato Grosso do Sul,50003,Alto Taquari,Figueirão,MS,,,,,3280,2927,1550,1377,1530,1397,-
5004007,5004,Sudoeste de Mato Grosso do Sul,50011,Iguatemi,Glória de Dourados,MS,41072,16195,11889,10035,9644,9928,4895,5033,7671,2257,-0.11%
5004106,5004,Sudoeste de Mato Grosso do Sul,50009,Bodoquena,Guia Lopes da Laguna,MS,5733,7757,9167,11115,10208,10368,5209,5159,8787,1581,-0.69%
5004304,5004,Sudoeste de Mato Grosso do Sul,50011,Iguatemi,Iguatemi,MS,25456,24096,11100,13617,14632,14887,7430,7457,11020,3867,0.90%
5004403,5003,Leste de Mato Grosso do Sul,50006,Paranaíba,Inocência,MS,6040,5894,6279,7872,7342,7686,3975,3711,4888,2798,-0.24%
5004502,5004,Sudoeste de Mato Grosso do Sul,50010,Dourados,Itaporã,MS,20283,14417,15935,17045,18605,20879,10411,10468,13302,7577,2.05%
5004601,5004,Sudoeste de Mato Grosso do Sul,50011,Iguatemi,Itaquiraí,MS,,,13090,15770,16924,18618,9706,8912,7603,11015,1.67%
5004700,5004,Sudoeste de Mato Grosso do Sul,50011,Iguatemi,Ivinhema,MS,14093,23616,32426,21643,20567,22355,11272,11083,17284,5071,0.32%
5004809,5004,Sudoeste de Mato Grosso do Sul,50011,Iguatemi,Japorã,MS,,,,6140,7362,7645,3869,3776,1410,6235,2.22%
5004908,5002,Centro Norte de Mato Grosso do Sul,50004,Campo Grande,Jaraguari,MS,4508,4711,4496,5389,5577,6341,3405,2936,1786,4555,1.64%
5005004,5004,Sudoeste de Mato Grosso do Sul,50009,Bodoquena,Jardim,MS,10460,13817,19325,22542,23341,24363,12134,12229,22758,1605,0.78%
5005103,5004,Sudoeste de Mato Grosso do Sul,50011,Iguatemi,Jateí,MS,12115,6778,4986,4054,3808,4017,2094,1923,1871,2146,-0.09%
5005152,5004,Sudoeste de Mato Grosso do Sul,50010,Dourados,Juti,MS,,,5273,4981,5353,5900,3010,2890,3925,1975,1.71%
5005202,5001,Pantanais Sul Mato-grossense,50001,Baixo Pantanal,Ladário,MS,7750,8792,11981,15313,17906,19653,9852,9801,18601,1052,2.53%
5005251,5004,Sudoeste de Mato Grosso do Sul,50010,Dourados,Laguna Carapã,MS,,,,5531,5813,6493,3295,3198,2739,3754,1.62%
5005400,5004,Sudoeste de Mato Grosso do Sul,50010,Dourados,Maracaju,MS,7319,13601,22999,26219,30912,37407,19389,18018,32225,5182,3.62%
5005608,5001,Pantanais Sul Mato-grossense,50002,Aquidauana,Miranda,MS,18634,24122,20176,23007,23965,25615,13230,12385,15586,10029,1.08%
5005681,5004,Sudoeste de Mato Grosso do Sul,50011,Iguatemi,Mundo Novo,MS,,31156,22417,15669,15968,17035,8261,8774,15273,1762,0.84%
5005707,5004,Sudoeste de Mato Grosso do Sul,50011,Iguatemi,Naviraí,MS,23117,28567,30670,36662,43391,46355,23203,23152,42782,3573,2.37%
5005806,5004,Sudoeste de Mato Grosso do Sul,50009,Bodoquena,Nioaque,MS,7118,9057,11057,15086,15203,14396,7547,6849,7059,7337,-0.47%
5006002,5004,Sudoeste de Mato Grosso do Sul,50010,Dourados,Nova Alvorada do Sul,MS,,,,9956,12026,16433,8480,7953,12297,4136,5.14%
5006200,5003,Leste de Mato Grosso do Sul,50008,Nova Andradina,Nova Andradina,MS,12625,21673,29848,35381,43495,45599,22748,22851,38793,6806,2.57%
5006259,5004,Sudoeste de Mato Grosso do Sul,50011,Iguatemi,Novo Horizonte do Sul,MS,,,,6415,4967,4944,2518,2426,2667,2277,-2.57%
5006309,5003,Leste de Mato Grosso do Sul,50006,Paranaíba,Paranaíba,MS,31038,36894,37654,38406,38969,40174,19965,20209,35731,4443,0.45%
5006358,5004,Sudoeste de Mato Grosso do Sul,50011,Iguatemi,Paranhos,MS,,,9481,10215,11092,12355,6263,6092,6263,6092,1.92%
5006408,5002,Centro Norte de Mato Grosso do Sul,50003,Alto Taquari,Pedro Gomes,MS,9145,11821,8319,8535,8307,7967,4149,3818,6148,1819,-0.69%
5006606,5004,Sudoeste de Mato Grosso do Sul,50010,Dourados,Ponta Porã,MS,33798,38062,55541,60916,72207,77866,38480,39386,62054,15812,2.49%
5006903,5001,Pantanais Sul Mato-grossense,50001,Baixo Pantanal,Porto Murtinho,MS,11627,11682,12808,13316,14861,15369,8232,7137,10059,5310,1.44%
5007109,5003,Leste de Mato Grosso do Sul,50007,Três Lagoas,Ribas do Rio Pardo,MS,3530,11310,13423,16721,19159,20967,10989,9978,12973,7994,2.29%
5007208,5004,Sudoeste de Mato Grosso do Sul,50010,Dourados,Rio Brilhante,MS,10269,15567,22509,22640,26560,30647,15699,14948,24540,6107,3.07%
5007307,5002,Centro Norte de Mato Grosso do Sul,50004,Campo Grande,Rio Negro,MS,8089,6621,5604,5432,4961,5040,2606,2434,3669,1371,-0.75%
5007406,5002,Centro Norte de Mato Grosso do Sul,50003,Alto Taquari,Rio Verde de Mato Grosso,MS,14132,15864,15075,18138,18579,18892,9486,9406,16296,2596,0.41%
5007505,5002,Centro Norte de Mato Grosso do Sul,50004,Campo Grande,Rochedo,MS,4642,3658,3522,4358,4346,4922,2570,2352,2884,2038,1.22%
5007554,5003,Leste de Mato Grosso do Sul,50007,Três Lagoas,Santa Rita do Pardo,MS,,,5534,6640,7162,7254,3805,3449,3534,3720,0.89%
5007695,5002,Centro Norte de Mato Grosso do Sul,50003,Alto Taquari,São Gabriel do Oeste,MS,,,12034,16821,20524,22164,11173,10991,19274,2890,2.80%
5007703,5004,Sudoeste de Mato Grosso do Sul,50011,Iguatemi,Sete Quedas,MS,,,14994,10936,10659,10780,5484,5296,8974,1806,-0.14%
5007802,5003,Leste de Mato Grosso do Sul,50006,Paranaíba,Selvíria,MS,,,5967,6085,6413,6277,3209,3068,4771,1506,0.31%
5007901,5002,Centro Norte de Mato Grosso do Sul,50004,Campo Grande,Sidrolândia,MS,9589,12846,16340,23483,38147,42076,21508,20568,27723,14353,6.01%
5007935,5002,Centro Norte de Mato Grosso do Sul,50003,Alto Taquari,Sonora,MS,,,5879,9543,12548,14867,7865,7002,13434,1433,4.53%
5007950,5004,Sudoeste de Mato Grosso do Sul,50011,Iguatemi,Tacuru,MS,,,7233,8717,9203,10215,5274,4941,3767,6448,1.60%
5007976,5003,Leste de Mato Grosso do Sul,50008,Nova Andradina,Taquarussu,MS,,,4533,3493,3117,3512,1805,1707,2448,1064,0.05%
5008008,5002,Centro Norte de Mato Grosso do Sul,50004,Campo Grande,Terenos,MS,8204,8289,9998,11662,14458,17162,9146,8016,7284,9878,3.94%
5008305,5003,Leste de Mato Grosso do Sul,50007,Três Lagoas,Três Lagoas,MS,55513,57895,68162,79059,85914,101722,50468,51254,96995,4727,2.55%
5008404,5004,Sudoeste de Mato Grosso do Sul,50010,Dourados,Vicentina,MS,,,7283,5779,5627,5901,2959,2942,4243,1658,0.21%
5100102,5104,Centro-Sul Mato-grossense,51016,Rosário Oeste,Acorizal,MT,8854,8609,5308,5817,5530,5516,2900,2616,2927,2589,-0.53%
5100201,5102,Nordeste Mato-grossense,51010,Canarana,Água Boa,MT,,4041,16561,16737,18991,20844,10915,9929,16725,4119,2.22%
5100250,5101,Norte Mato-grossense,51002,Alta Floresta,Alta Floresta,MT,,22999,66926,46982,49140,49233,25022,24211,42787,6446,0.47%
5100300,5105,Sudeste Mato-grossense,51022,Alto Araguaia,Alto Araguaia,MT,7547,11230,10770,11410,13790,15670,8069,7601,13856,1814,3.22%
5100359,5102,Nordeste Mato-grossense,51009,Norte Araguaia,Alto Boa Vista,MT,,,,6206,5025,5249,2731,2518,3180,2069,-1.66%
5100409,5105,Sudeste Mato-grossense,51022,Alto Araguaia,Alto Garças,MT,5890,6705,8306,8335,9132,10321,5402,4919,9425,896,2.16%
5100508,5104,Centro-Sul Mato-grossense,51015,Alto Paraguai,Alto Paraguai,MT,11353,10659,13854,8605,8144,9951,5302,4649,6411,3540,1.46%
5100607,5105,Sudeste Mato-grossense,51022,Alto Araguaia,Alto Taquari,MT,,,3014,4476,6058,8100,4284,3816,7346,754,6.11%
5100805,5101,Norte Mato-grossense,51002,Alta Floresta,Apiacás,MT,,,7361,6665,7926,8538,4633,3905,6357,2181,2.51%
5101001,5102,Nordeste Mato-grossense,51011,Médio Araguaia,Araguaiana,MT,,,3386,3426,2974,3221,1648,1573,2190,1031,-0.62%
5101209,5105,Sudeste Mato-grossense,51020,Tesouro,Araguainha,MT,1718,1435,1416,1352,1117,1095,585,510,944,151,-2.09%
5101258,5103,Sudoeste Mato-grossense,51014,Jauru,Araputanga,MT,,17155,12560,13675,15335,15387,7610,7777,12206,3181,1.19%
5101308,5104,Centro-Sul Mato-grossense,51015,Alto Paraguai,Arenápolis,MT,10486,13533,19617,11605,9869,10355,5218,5137,9784,571,-1.13%
5101407,5101,Norte Mato-grossense,51001,Aripuanã,Aripuanã,MT,2235,13961,13614,27560,19100,18581,10032,8549,11674,6907,-3.87%
5101605,5104,Centro-Sul Mato-grossense,51018,Alto Pantanal,Barão de Melgaço,MT,9719,8255,9858,7682,7619,7591,4134,3457,3422,4169,-0.12%
5101704,5103,Sudoeste Mato-grossense,51013,Tangará da Serra,Barra do Bugres,MT,22250,23646,22264,27460,32490,31058,16134,14924,25912,5146,1.24%
5101803,5102,Nordeste Mato-grossense,51011,Médio Araguaia,Barra do Garças,MT,26570,43601,45651,52092,53243,56423,28123,28300,50930,5493,0.80%
5101852,5102,Nordeste Mato-grossense,51009,Norte Araguaia,Bom Jesus do Araguaia,MT,,,,,4520,5231,2806,2425,2632,2599,-
5101902,5101,Norte Mato-grossense,51001,Aripuanã,Brasnorte,MT,,,6622,9815,13975,15280,8244,7036,9990,5290,4.53%
5102504,5104,Centro-Sul Mato-grossense,51018,Alto Pantanal,Cáceres,MT,85699,59067,77540,85857,84175,87912,44040,43872,76558,11354,0.24%
5102603,5102,Nordeste Mato-grossense,51010,Canarana,Campinápolis,MT,,,11818,12419,13666,14222,7365,6857,4816,9406,1.36%
5102637,5101,Norte Mato-grossense,51004,Parecis,Campo Novo do Parecis,MT,,,6311,17638,22322,27574,14483,13091,25581,1993,4.57%
5102678,5105,Sudeste Mato-grossense,51019,Primavera do Leste,Campo Verde,MT,,,5975,17221,25924,31612,16293,15319,25512,6100,6.26%
5102686,5101,Norte Mato-grossense,51004,Parecis,Campos de Júlio,MT,,,,2895,4770,5019,2589,2430,3991,1028,5.66%
5102694,5102,Nordeste Mato-grossense,51009,Norte Araguaia,Canabrava do Norte,MT,,,,4989,5337,4767,2542,2225,2673,2094,-0.45%
5102702,5102,Nordeste Mato-grossense,51010,Canarana,Canarana,MT,,8757,11909,15408,17183,18701,9636,9065,14813,3888,1.96%
5102793,5101,Norte Mato-grossense,51002,Alta Floresta,Carlinda,MT,,,,12296,12108,10985,5818,5167,4569,6416,-1.12%
5102850,5101,Norte Mato-grossense,51001,Aripuanã,Castanheira,MT,,,8362,7790,7808,8231,4346,3885,3921,4310,0.55%
5103007,5104,Centro-Sul Mato-grossense,51017,Cuiabá,Chapada dos Guimarães,MT,16356,9370,12888,15755,17377,17799,9293,8506,10988,6811,1.23%
5103056,5101,Norte Mato-grossense,51007,Sinop,Cláudia,MT,,,9099,10249,10670,10972,5692,5280,8457,2515,0.68%
5103106,5102,Nordeste Mato-grossense,51011,Médio Araguaia,Cocalinho,MT,,,5457,5504,5841,5498,2901,2597,3647,1851,-0.01%
5103205,5101,Norte Mato-grossense,51003,Colíder,Colíder,MT,,34503,31160,28051,30695,30864,15624,15240,25065,5799,0.96%
5103254,5101,Norte Mato-grossense,51001,Aripuanã,Colniza,MT,,,,,27882,26390,14085,12305,15011,11379,-
5103304,5101,Norte Mato-grossense,51004,Parecis,Comodoro,MT,,,9278,15046,17939,18157,9365,8792,12568,5589,1.90%
5103353,5102,Nordeste Mato-grossense,51009,Norte Araguaia,Confresa,MT,,,,17841,21361,25127,13345,11782,16224,8903,3.48%
5103361,5103,Sudoeste Mato-grossense,51012,Alto Guaporé,Conquista D'Oeste,MT,,,,,3106,3388,1789,1599,2053,1335,-
5103379,5101,Norte Mato-grossense,51001,Aripuanã,Cotriguaçu,MT,,,,8474,13740,14987,7979,7008,5132,9855,5.87%
5103403,5104,Centro-Sul Mato-grossense,51017,Cuiabá,Cuiabá,MT,100860,212980,402813,483346,526830,551350,269397,281953,541002,10348,1.33%
5103437,5104,Centro-Sul Mato-grossense,51018,Alto Pantanal,Curvelândia,MT,,,,,4835,4898,2550,2348,2914,1984,-
5103452,5103,Sudoeste Mato-grossense,51013,Tangará da Serra,Denise,MT,,,4785,7463,10349,8494,4382,4112,7259,1235,1.30%
5103502,5101,Norte Mato-grossense,51004,Parecis,Diamantino,MT,5076,14144,16620,18580,18428,20420,10549,9871,15920,4500,0.95%
5103601,5105,Sudeste Mato-grossense,51021,Rondonópolis,Dom Aquino,MT,16383,11753,8934,8418,8261,8131,4194,3937,6542,1589,-0.35%
5103700,5101,Norte Mato-grossense,51007,Sinop,Feliz Natal,MT,,,,6769,10279,10933,5580,5353,8123,2810,4.91%
5103809,5103,Sudoeste Mato-grossense,51014,Jauru,Figueirópolis D'Oeste,MT,,,5413,4315,3648,3805,1943,1862,2014,1791,-1.25%
5103858,5101,Norte Mato-grossense,51008,Paranatinga,Gaúcha do Norte,MT,,,,4605,5816,6287,3435,2852,2199,4088,3.16%
5103908,5105,Sudeste Mato-grossense,51020,Tesouro,General Carneiro,MT,3498,3981,4307,4349,4803,5018,2638,2380,2356,2662,1.44%
5103957,5103,Sudoeste Mato-grossense,51014,Jauru,Glória D'Oeste,MT,,,,3361,3124,3125,1581,1544,2129,996,-0.73%
5104104,5101,Norte Mato-grossense,51003,Colíder,Guarantã do Norte,MT,,,23825,28200,30754,32150,16479,15671,23917,8233,1.32%
5104203,5105,Sudeste Mato-grossense,51020,Tesouro,Guiratinga,MT,14939,13585,14798,12645,13883,13867,7237,6630,11434,2433,0.93%
5104500,5103,Sudoeste Mato-grossense,51014,Jauru,Indiavaí,MT,,,2023,2056,2524,2407,1248,1159,1778,629,1.59%
5104526,5101,Norte Mato-grossense,51006,Alto Teles Pires,Ipiranga do Norte,MT,,,,,4129,5123,2795,2328,3475,1648,-
5104542,5101,Norte Mato-grossense,51006,Alto Teles Pires,Itanhangá,MT,,,,,4703,5260,2869,2391,3165,2095,-
5104559,5101,Norte Mato-grossense,51007,Sinop,Itaúba,MT,,,7143,8565,4625,4570,2394,2176,3710,860,-6.09%
5104609,5105,Sudeste Mato-grossense,51021,Rondonópolis,Itiquira,MT,3621,6997,8005,9200,12159,11493,6234,5259,4447,7046,2.25%
5104807,5105,Sudeste Mato-grossense,51021,Rondonópolis,Jaciara,MT,32132,14438,21917,23796,24945,25666,12993,12673,23642,2024,0.76%
5104906,5104,Centro-Sul Mato-grossense,51016,Rosário Oeste,Jangada,MT,,,5227,7134,8058,7696,3963,3733,2946,4750,0.76%
5105002,5103,Sudoeste Mato-grossense,51014,Jauru,Jauru,MT,,16696,13247,12764,10774,10461,5265,5196,6171,4290,-1.97%
5105101,5101,Norte Mato-grossense,51005,Arinos,Juara,MT,,,21712,30748,32023,32769,16948,15821,26031,6738,0.64%
5105150,5101,Norte Mato-grossense,51001,Aripuanã,Juína,MT,,,36581,38017,38422,39260,20133,19127,33969,5291,0.32%
5105176,5101,Norte Mato-grossense,51001,Aripuanã,Juruena,MT,,,5956,5448,8731,11269,5849,5420,6801,4468,7.54%
5105200,5105,Sudeste Mato-grossense,51021,Rondonópolis,Juscimeira,MT,,12757,10948,12063,11830,11434,5959,5475,8500,2934,-0.53%
5105234,5103,Sudoeste Mato-grossense,51014,Jauru,Lambari D'Oeste,MT,,,,4690,4870,5438,2856,2582,2898,2540,1.49%
5105259,5101,Norte Mato-grossense,51006,Alto Teles Pires,Lucas do Rio Verde,MT,,,6693,19316,30741,45545,24005,21540,42438,3107,8.96%
5105309,5102,Nordeste Mato-grossense,51009,Norte Araguaia,Luciara,MT,5008,8185,5604,2494,2405,2229,1150,1079,2034,195,-1.12%
5105507,5103,Sudoeste Mato-grossense,51012,Alto Guaporé,Vila Bela da Santíssima Trindade,MT,9576,8935,13693,12665,13886,14491,7559,6932,5175,9316,1.36%
5105580,5101,Norte Mato-grossense,51007,Sinop,Marcelândia,MT,,,8889,14448,14084,11994,6354,5640,7418,4576,-1.84%
5105606,5101,Norte Mato-grossense,51003,Colíder,Matupá,MT,,,10221,11289,14243,14172,7355,6817,10929,3243,2.30%
5105622,5103,Sudoeste Mato-grossense,51014,Jauru,Mirassol d'Oeste,MT,,18600,25864,22997,24538,25331,12699,12632,21465,3866,0.97%
5105903,5101,Norte Mato-grossense,51006,Alto Teles Pires,Nobres,MT,5692,13441,15174,14983,14862,15011,7834,7177,12461,2550,0.02%
5106000,5104,Centro-Sul Mato-grossense,51015,Alto Paraguai,Nortelândia,MT,5938,10451,10068,7246,6237,6438,3309,3129,5276,1162,-1.18%
5106109,5104,Centro-Sul Mato-grossense,51017,Cuiabá,Nossa Senhora do Livramento,MT,11768,10274,10472,12141,12386,11592,6256,5336,4247,7345,-0.46%
5106158,5101,Norte Mato-grossense,51002,Alta Floresta,Nova Bandeirantes,MT,,,,6951,12742,11630,6373,5257,4060,7570,5.28%
5106174,5102,Nordeste Mato-grossense,51010,Canarana,Nova Nazaré,MT,,,,,2745,3021,1553,1468,1112,1909,-
5106182,5103,Sudoeste Mato-grossense,51012,Alto Guaporé,Nova Lacerda,MT,,,,4045,4949,5469,2934,2535,2996,2473,3.06%
5106190,5101,Norte Mato-grossense,51007,Sinop,Nova Santa Helena,MT,,,,,3347,3475,1818,1657,2000,1475,-
5106208,5101,Norte Mato-grossense,51008,Paranatinga,Nova Brasilândia,MT,,11493,9612,5786,4891,4593,2403,2190,3663,930,-2.28%
5106216,5101,Norte Mato-grossense,51003,Colíder,Nova Canaã do Norte,MT,,,14033,11516,12652,12132,6452,5680,6817,5315,0.52%
5106224,5101,Norte Mato-grossense,51006,Alto Teles Pires,Nova Mutum,MT,,,5542,14818,24368,31633,16798,14835,25858,5775,7.88%
5106232,5103,Sudoeste Mato-grossense,51013,Tangará da Serra,Nova Olímpia,MT,,,7030,14186,19474,17529,9064,8465,15843,1686,2.14%
5106240,5101,Norte Mato-grossense,51006,Alto Teles Pires,Nova Ubiratã,MT,,,,5654,7782,9245,5153,4092,5935,3310,5.04%
5106257,5102,Nordeste Mato-grossense,51010,Canarana,Nova Xavantina,MT,,20273,18509,17832,18670,19475,9936,9539,15731,3744,0.89%
5106265,5101,Norte Mato-grossense,51003,Colíder,Novo Mundo,MT,,,,4997,6725,7069,3802,3267,2636,4433,3.53%
5106273,5101,Norte Mato-grossense,51005,Arinos,Novo Horizonte do Norte,MT,,,4267,3511,3802,3746,1934,1812,1777,1969,0.65%
5106281,5102,Nordeste Mato-grossense,51010,Canarana,Novo São Joaquim,MT,,,7170,9464,6880,6043,3144,2899,3717,2326,-4.39%
5106299,5101,Norte Mato-grossense,51002,Alta Floresta,Paranaíta,MT,,,12173,10254,11540,10690,5745,4945,5654,5036,0.42%
5106307,5101,Norte Mato-grossense,51008,Paranatinga,Paranatinga,MT,,11767,18383,15342,20033,19280,10305,8975,14812,4468,2.31%
5106315,5102,Nordeste Mato-grossense,51009,Norte Araguaia,Novo Santo Antônio,MT,,,,,2110,2005,1105,900,1346,659,-
5106372,5105,Sudeste Mato-grossense,51021,Rondonópolis,Pedra Preta,MT,,12343,11225,13611,15638,15693,8111,7582,11381,4312,1.43%
5106422,5101,Norte Mato-grossense,51003,Colíder,Peixoto de Azevedo,MT,,,37240,26156,28987,30762,15925,14837,19799,10963,1.64%
5106455,5101,Norte Mato-grossense,51008,Paranatinga,Planalto da Serra,MT,,,,2881,2734,2726,1400,1326,2054,672,-0.55%
5106505,5104,Centro-Sul Mato-grossense,51018,Alto Pantanal,Poconé,MT,18832,23351,29856,30773,31118,31778,16521,15257,23062,8716,0.32%
5106653,5105,Sudeste Mato-grossense,51020,Tesouro,Pontal do Araguaia,MT,,,,3736,4966,5427,2796,2631,4484,943,3.80%
5106703,5105,Sudeste Mato-grossense,51020,Tesouro,Ponte Branca,MT,3438,3492,3724,2087,1794,1783,922,861,1516,267,-1.56%
5106752,5103,Sudoeste Mato-grossense,51012,Alto Guaporé,Pontes e Lacerda,MT,,14406,34603,43012,37910,41386,20914,20472,34629,6757,-0.38%
5106778,5102,Nordeste Mato-grossense,51009,Norte Araguaia,Porto Alegre do Norte,MT,,,10151,8623,9639,10754,5739,5015,5179,5575,2.23%
5106802,5101,Norte Mato-grossense,51005,Arinos,Porto dos Gaúchos,MT,1192,15065,6558,5665,6116,5448,2858,2590,2767,2681,-0.39%
5106828,5103,Sudoeste Mato-grossense,51014,Jauru,Porto Esperidião,MT,,,8586,9996,9607,10950,5859,5091,4172,6778,0.92%
5106851,5103,Sudoeste Mato-grossense,51013,Tangará da Serra,Porto Estrela,MT,,,,4707,4011,3639,1900,1739,1466,2173,-2.54%
5107008,5105,Sudeste Mato-grossense,51020,Tesouro,Poxoréo,MT,27431,28054,23878,20030,17592,17602,9254,8348,11924,5678,-1.28%
5107040,5105,Sudeste Mato-grossense,51019,Primavera do Leste,Primavera do Leste,MT,,,12523,39857,44729,52114,26522,25592,49308,2806,2.72%
5107065,5102,Nordeste Mato-grossense,51010,Canarana,Querência,MT,,,,7274,10682,13021,6922,6099,5972,7049,6.00%
5107107,5103,Sudoeste Mato-grossense,51014,Jauru,São José dos Quatro Marcos,MT,,18202,22011,19693,19001,18963,9488,9475,14506,4457,-0.38%
5107156,5103,Sudoeste Mato-grossense,51014,Jauru,Reserva do Cabaçal,MT,,,3186,2418,2505,2578,1326,1252,1622,956,0.64%
5107180,5102,Nordeste Mato-grossense,51009,Norte Araguaia,Ribeirão Cascalheira,MT,,,8610,8866,8677,8880,4607,4273,5560,3320,0.02%
5107198,5105,Sudeste Mato-grossense,51020,Tesouro,Ribeirãozinho,MT,,,,1980,2107,2199,1126,1073,1554,645,1.05%
5107206,5103,Sudoeste Mato-grossense,51014,Jauru,Rio Branco,MT,,17583,11845,5092,5053,5061,2537,2524,4144,917,-0.06%
5107248,5101,Norte Mato-grossense,51007,Sinop,Santa Carmem,MT,,,,3599,4319,4075,2132,1943,3071,1004,1.25%
5107263,5104,Centro-Sul Mato-grossense,51015,Alto Paraguai,Santo Afonso,MT,,,,3098,2855,2974,1610,1364,1538,1436,-0.41%
5107297,5105,Sudeste Mato-grossense,51021,Rondonópolis,São José do Povo,MT,,,,3056,3305,3601,1934,1667,1758,1843,1.65%
5107305,5101,Norte Mato-grossense,51005,Arinos,São José do Rio Claro,MT,,7208,16333,12740,17345,17128,9173,7955,13170,3958,3.00%
5107354,5102,Nordeste Mato-grossense,51009,Norte Araguaia,São José do Xingu,MT,,,,5944,4198,5267,2827,2440,3791,1476,-1.20%
5107404,5105,Sudeste Mato-grossense,51021,Rondonópolis,São Pedro da Cipa,MT,,,,3495,4028,4142,2143,1999,3694,448,1.71%
5107578,5101,Norte Mato-grossense,51001,Aripuanã,Rondolândia,MT,,,,,3348,3538,1860,1678,950,2588,-
5107602,5105,Sudeste Mato-grossense,51021,Rondonópolis,Rondonópolis,MT,62086,81375,126627,150227,172783,195550,98217,97333,188119,7431,2.67%
5107701,5104,Centro-Sul Mato-grossense,51016,Rosário Oeste,Rosário Oeste,MT,18044,19757,20050,18755,18031,17682,9419,8263,10656,7026,-0.59%
5107743,5102,Nordeste Mato-grossense,51009,Norte Araguaia,Santa Cruz do Xingu,MT,,,,,2116,1899,1046,853,1251,648,-
5107750,5103,Sudoeste Mato-grossense,51014,Jauru,Salto do Céu,MT,,11249,7410,4675,3650,3903,2014,1889,2185,1718,-1.79%
5107768,5101,Norte Mato-grossense,51006,Alto Teles Pires,Santa Rita do Trivelato,MT,,,,,2478,2466,1352,1114,1365,1101,-
5107776,5102,Nordeste Mato-grossense,51009,Norte Araguaia,Santa Terezinha,MT,,6107,8902,6270,7293,7399,3936,3463,2976,4423,1.67%
5107792,5102,Nordeste Mato-grossense,51010,Canarana,Santo Antônio do Leste,MT,,,,,3249,3757,2029,1728,2119,1638,-
5107800,5104,Centro-Sul Mato-grossense,51017,Cuiabá,Santo Antônio do Leverger,MT,14509,11738,15389,15435,19197,18409,9843,8566,7148,11261,1.78%
5107859,5102,Nordeste Mato-grossense,51009,Norte Araguaia,São Félix do Araguaia,MT,,11063,14810,10687,10713,10531,5510,5021,6164,4367,-0.15%
5107875,5101,Norte Mato-grossense,51004,Parecis,Sapezal,MT,,,,7866,14254,18080,9777,8303,15120,2960,8.68%
5107883,5102,Nordeste Mato-grossense,51009,Norte Araguaia,Serra Nova Dourada,MT,,,,,1349,1365,743,622,813,552,-
5107909,5101,Norte Mato-grossense,51007,Sinop,Sinop,MT,,19891,38374,74831,105762,113082,57561,55521,93735,19347,4.22%
5107925,5101,Norte Mato-grossense,51006,Alto Teles Pires,Sorriso,MT,,,16107,35605,55134,66506,34282,32224,58363,8143,6.45%
5107941,5101,Norte Mato-grossense,51005,Arinos,Tabaporã,MT,,,,10842,10484,9917,5290,4627,5279,4638,-0.89%
5107958,5103,Sudoeste Mato-grossense,51013,Tangará da Serra,Tangará da Serra,MT,,31293,39848,58840,76657,84076,42335,41741,75883,8193,3.63%
5108006,5101,Norte Mato-grossense,51006,Alto Teles Pires,Tapurah,MT,,,7323,11561,10478,10390,6057,4333,6526,3864,-1.06%
5108055,5101,Norte Mato-grossense,51003,Colíder,Terra Nova do Norte,MT,,,22448,13694,14584,11302,5885,5417,5060,6242,-1.90%
5108105,5105,Sudeste Mato-grossense,51020,Tesouro,Tesouro,MT,5796,3693,4548,3130,3109,3437,1908,1529,2398,1039,0.94%
5108204,5105,Sudeste Mato-grossense,51020,Tesouro,Torixoréu,MT,6300,8094,8352,4832,4101,4036,2098,1938,3117,919,-1.78%
5108303,5101,Norte Mato-grossense,51007,Sinop,União do Sul,MT,,,,4196,3998,3767,2049,1718,2339,1428,-1.07%
5108352,5103,Sudoeste Mato-grossense,51012,Alto Guaporé,Vale de São Domingos,MT,,,,,2873,3058,1646,1412,713,2345,-
5108402,5104,Centro-Sul Mato-grossense,51017,Cuiabá,Várzea Grande,MT,18053,76678,161958,215298,230307,252709,125358,127351,248829,3880,1.62%
5108501,5101,Norte Mato-grossense,51007,Sinop,Vera,MT,,,10759,9055,9188,10235,5304,4931,7349,2886,1.23%
5108600,5102,Nordeste Mato-grossense,51009,Norte Araguaia,Vila Rica,MT,,,9461,15583,18934,21403,11203,10200,13977,7426,3.22%
5108808,5101,Norte Mato-grossense,51003,Colíder,Nova Guarita,MT,,,,5651,4877,4929,2581,2348,1937,2992,-1.36%
5108857,5104,Centro-Sul Mato-grossense,51015,Alto Paraguai,Nova Marilândia,MT,,,,2354,2315,2925,1575,1350,1933,992,2.20%
5108907,5101,Norte Mato-grossense,51005,Arinos,Nova Maringá,MT,,,,3950,5554,6590,3599,2991,3421,3169,5.25%
5108956,5101,Norte Mato-grossense,51002,Alta Floresta,Nova Monte Verde,MT,,,,6827,8133,8088,4383,3705,3973,4115,1.71%
1500107,1504,Nordeste Paraense,15011,Cametá,Abaetetuba,PA,57520,74541,99989,119152,132222,141054,71612,69442,82950,58104,1.70%
1500131,1506,Sudeste Paraense,15017,Paragominas,Abel Figueiredo,PA,,,,5957,6592,6792,3542,3250,6046,746,1.32%
1500206,1504,Nordeste Paraense,15012,Tomé-Açu,Acará,PA,24487,35264,37184,52126,47923,53605,28139,25466,12625,40980,0.28%
1500305,1502,Marajó,15005,Furos de Breves,Afuá,PA,17826,23335,20008,29505,31183,35017,18449,16568,9478,25539,1.73%
1500347,1506,Sudeste Paraense,15019,Parauapebas,Água Azul do Norte,PA,,,,22084,28658,25061,13618,11443,4876,20185,1.27%
1500404,1501,Baixo Amazonas,15002,Santarém,Alenquer,PA,35021,44535,52856,41784,52661,52714,27086,25628,27774,24940,2.35%
1500503,1501,Baixo Amazonas,15003,Almeirim,Almeirim,PA,11889,33077,33442,33957,30903,33665,17502,16163,19972,13693,-0.09%
1500602,1505,Sudoeste Paraense,15015,Altamira,Altamira,PA,15345,46496,72408,77439,92105,105030,52814,52216,90068,14962,3.09%
1500701,1502,Marajó,15005,Furos de Breves,Anajás,PA,10092,11788,14284,18322,24942,24771,12968,11803,9492,15279,3.06%
1500800,1503,Metropolitana de Belém,15007,Belém,Ananindeua,PA,22527,65878,88151,393569,484278,471744,226537,245207,470590,1154,1.83%
1500859,1505,Sudoeste Paraense,15015,Altamira,Anapu,PA,,,,9407,17787,20493,10965,9528,9840,10653,8.10%
1500909,1504,Nordeste Paraense,15010,Bragantina,Augusto Corrêa,PA,18331,26404,30323,33011,37086,40499,20994,19505,18237,22262,2.07%
1500958,1504,Nordeste Paraense,15013,Guamá,Aurora do Pará,PA,,,,19728,21239,26579,13630,12949,8174,18405,3.03%
1501006,1505,Sudoeste Paraense,15014,Itaituba,Aveiro,PA,8819,12749,10876,15518,18830,15767,8319,7448,3182,12585,0.16%
1501105,1502,Marajó,15004,Portel,Bagre,PA,4405,8304,13844,13708,18580,23855,12136,11719,10652,13203,5.70%
1501204,1504,Nordeste Paraense,15011,Cametá,Baião,PA,12134,16258,20072,21119,26190,36907,19450,17457,18555,18352,5.74%
1501253,1506,Sudeste Paraense,15018,São Félix do Xingu,Bannach,PA,,,,3780,3812,3434,1849,1585,1284,2150,-0.96%
1501303,1503,Metropolitana de Belém,15007,Belém,Barcarena,PA,17498,20015,45946,63268,84560,99800,50379,49421,36357,63443,4.66%
1501402,1503,Metropolitana de Belém,15007,Belém,Belém,PA,633374,933280,1244689,1280614,1408847,1392031,658188,733843,1380836,11195,0.84%
1501451,1501,Baixo Amazonas,15002,Santarém,Belterra,PA,,,,14594,12707,16324,8483,7841,6853,9471,1.13%
1501501,1503,Metropolitana de Belém,15007,Belém,Benevides,PA,13867,22315,68465,35546,43282,51663,25824,25839,28907,22756,3.81%
1501576,1506,Sudeste Paraense,15017,Paragominas,Bom Jesus do Tocantins,PA,,,15952,13106,13145,15246,8028,7218,8160,7086,1.52%
1501600,1504,Nordeste Paraense,15010,Bragantina,Bonito,PA,6084,8488,8532,9814,11279,13630,7114,6516,3827,9803,3.34%
1501709,1504,Nordeste Paraense,15010,Bragantina,Bragança,PA,61934,85086,97149,93779,101728,113165,57244,55921,72595,40570,1.90%
1501725,1505,Sudoeste Paraense,15015,Altamira,Brasil Novo,PA,,,,17193,18749,17960,9627,8333,6912,11048,0.44%
1501758,1506,Sudeste Paraense,15020,Marabá,Brejo Grande do Araguaia,PA,,,11939,7464,7444,7324,3836,3488,4320,3004,-0.19%
1501782,1506,Sudeste Paraense,15016,Tucuruí,Breu Branco,PA,,,,32446,47069,52497,27090,25407,29303,23194,4.93%
1501808,1502,Marajó,15005,Furos de Breves,Breves,PA,38201,55739,72140,80158,94458,92865,47780,45085,46561,46304,1.48%
1501907,1503,Metropolitana de Belém,15008,Castanhal,Bujaru,PA,15735,25992,14117,21032,22535,25700,13338,12362,8099,17601,2.02%
1501956,1504,Nordeste Paraense,15013,Guamá,Cachoeira do Piriá,PA,,,,15437,17649,26476,13710,12766,5523,20953,5.54%
1502004,1502,Marajó,15006,Arari,Cachoeira do Arari,PA,10386,11402,13246,15783,18995,20460,10552,9908,7365,13095,2.63%
1502103,1504,Nordeste Paraense,15011,Cametá,Cametá,PA,59754,79320,85187,97624,110323,120904,62023,58881,52846,68058,2.16%
1502152,1506,Sudeste Paraense,15019,Parauapebas,Canaã dos Carajás,PA,,,,10922,23757,26727,13589,13138,20738,5989,9.36%
1502202,1504,Nordeste Paraense,15010,Bragantina,Capanema,PA,26650,40102,51166,57119,61350,63628,31496,32132,50736,12892,1.09%
1502301,1504,Nordeste Paraense,15013,Guamá,Capitão Poço,PA,25565,32774,45452,49769,50839,51899,26618,25281,21447,30452,0.42%
1502400,1503,Metropolitana de Belém,15008,Castanhal,Castanhal,PA,37910,65246,102071,134496,152126,173096,84421,88675,153321,19775,2.56%
1502509,1502,Marajó,15006,Arari,Chaves,PA,20764,15436,17400,17350,19368,21138,11216,9922,2500,18638,1.99%
1502608,1504,Nordeste Paraense,15009,Salgado,Colares,PA,6339,7094,8338,10632,10981,11382,5881,5501,3662,7720,0.68%
1502707,1506,Sudeste Paraense,15022,Conceição do Araguaia,Conceição do Araguaia,PA,28953,111332,54900,43386,45267,45530,23313,22217,32452,13078,0.48%
1502756,1504,Nordeste Paraense,15012,Tomé-Açu,Concórdia do Pará,PA,,,15247,20956,21422,28221,14591,13630,15091,13130,3.02%
1502764,1506,Sudeste Paraense,15018,São Félix do Xingu,Cumaru do Norte,PA,,,,5978,10452,10478,6087,4391,2737,7741,5.77%
1502772,1506,Sudeste Paraense,15019,Parauapebas,Curionópolis,PA,,,38672,19486,17769,18295,9672,8623,12528,5767,-0.63%
1502806,1502,Marajó,15005,Furos de Breves,Curralinho,PA,10572,12688,15204,20016,25388,28582,15073,13509,10938,17644,3.63%
1502855,1501,Baixo Amazonas,15002,Santarém,Curuá,PA,,,,9224,11928,12262,6456,5806,5781,6481,2.89%
1502905,1504,Nordeste Paraense,15009,Salgado,Curuçá,PA,22537,24403,25776,26160,33768,34490,17647,16843,12210,22280,2.80%
1502939,1506,Sudeste Paraense,15017,Paragominas,Dom Eliseu,PA,,,24362,39529,38150,51318,26629,24689,32517,18801,2.64%
1502954,1506,Sudeste Paraense,15019,Parauapebas,Eldorado dos Carajás,PA,,,,29608,28554,31745,16800,14945,16589,15156,0.70%
1503002,1501,Baixo Amazonas,15001,Óbidos,Faro,PA,10054,12598,13574,10037,17253,8181,4240,3941,6140,2041,-2.02%
1503044,1506,Sudeste Paraense,15022,Conceição do Araguaia,Floresta do Araguaia,PA,,,,14284,14964,17825,9549,8276,8736,9089,2.24%
1503077,1504,Nordeste Paraense,15013,Guamá,Garrafão do Norte,PA,,,20473,24221,24619,25051,13112,11939,8614,16437,0.34%
1503093,1506,Sudeste Paraense,15017,Paragominas,Goianésia do Pará,PA,,,,22685,27166,30437,15750,14687,21083,9354,2.98%
1503101,1502,Marajó,15004,Portel,Gurupá,PA,13971,15583,18969,23098,24384,29060,15402,13658,9580,19480,2.32%
1503200,1504,Nordeste Paraense,15010,Bragantina,Igarapé-Açu,PA,15966,23005,27307,32400,33778,35843,18082,17761,21210,14633,1.02%
1503309,1504,Nordeste Paraense,15011,Cametá,Igarapé-Miri,PA,31228,39270,41843,52604,54673,58023,29661,28362,26209,31814,0.99%
1503408,1503,Metropolitana de Belém,15008,Castanhal,Inhangapi,PA,6610,7333,6668,7681,9592,10064,5190,4874,2769,7295,2.74%
1503457,1504,Nordeste Paraense,15013,Guamá,Ipixuna do Pará,PA,,,,25138,39563,51383,26944,24439,12228,39155,7.41%
1503507,1504,Nordeste Paraense,15013,Guamá,Irituia,PA,33393,44964,31110,30518,29746,31382,16288,15094,6509,24873,0.28%
1503606,1505,Sudoeste Paraense,15014,Itaituba,Itaituba,PA,12690,38573,116402,94750,118194,97343,49612,47731,70602,26741,0.27%
1503705,1506,Sudeste Paraense,15016,Tucuruí,Itupiranga,PA,5346,15651,37011,49655,42002,51258,27033,24225,20478,30780,0.32%
1503754,1505,Sudoeste Paraense,15014,Itaituba,Jacareacanga,PA,,,,24024,37073,14040,8009,6031,4933,9107,-5.23%
1503804,1506,Sudeste Paraense,15016,Tucuruí,Jacundá,PA,2219,14860,43012,40546,51511,51375,25770,25605,45702,5673,2.40%
1503903,1501,Baixo Amazonas,15001,Óbidos,Juruti,PA,18684,22602,23262,31198,33775,47123,24615,22508,15843,31280,4.21%
1504000,1504,Nordeste Paraense,15011,Cametá,Limoeiro do Ajuru,PA,10074,13756,16475,19564,23284,25028,13119,11909,6198,18830,2.49%
1504059,1504,Nordeste Paraense,15013,Guamá,Mãe do Rio,PA,,,29100,25351,27614,27892,13741,14151,23036,4856,0.96%
1504109,1504,Nordeste Paraense,15009,Salgado,Magalhães Barata,PA,5058,5996,7331,7693,7650,8115,4258,3857,3795,4320,0.54%
1504208,1506,Sudeste Paraense,15020,Marabá,Marabá,PA,24474,59881,123668,168020,196468,233462,118148,115314,186122,47340,3.34%
1504307,1504,Nordeste Paraense,15009,Salgado,Maracanã,PA,18089,21116,25575,27571,28296,28376,14694,13682,11659,16717,0.29%
1504406,1504,Nordeste Paraense,15009,Salgado,Marapanim,PA,16922,17721,20087,24718,26651,26605,13864,12741,11711,14894,0.74%
1504422,1503,Metropolitana de Belém,15007,Belém,Marituba,PA,,,,74429,93416,108251,53880,54371,107129,1122,3.82%
1504455,1505,Sudoeste Paraense,15015,Altamira,Medicilândia,PA,,,29728,21379,22624,27442,14966,12476,9622,17820,2.53%
1504505,1502,Marajó,15004,Portel,Melgaço,PA,6103,10632,14538,21064,17845,24789,13208,11581,5499,19290,1.64%
1504604,1504,Nordeste Paraense,15011,Cametá,Mocajuba,PA,9087,12801,18496,20542,23258,26745,13756,12989,18297,8448,2.67%
1504703,1504,Nordeste Paraense,15012,Tomé-Açu,Moju,PA,18035,28644,44424,52941,63821,69921,36624,33297,25118,44803,2.82%
1504802,1501,Baixo Amazonas,15002,Santarém,Monte Alegre,PA,28379,37904,46951,61334,61350,55459,28487,26972,24575,30884,-1.00%
1504901,1502,Marajó,15006,Arari,Muaná,PA,14985,18704,22367,25467,28796,34237,17916,16321,14523,19714,3.00%
1504950,1504,Nordeste Paraense,15013,Guamá,Nova Esperança do Piriá,PA,,,,18893,22447,20159,10645,9514,7972,12187,0.65%
1504976,1506,Sudeste Paraense,15016,Tucuruí,Nova Ipixuna,PA,,,,11866,14086,14645,7729,6916,7724,6921,2.13%
1505007,1504,Nordeste Paraense,15010,Bragantina,Nova Timboteua,PA,8235,9969,9427,11406,12103,13660,7080,6580,5517,8143,1.82%
1505031,1505,Sudoeste Paraense,15014,Itaituba,Novo Progresso,PA,,,,24948,21598,25106,13413,11693,17705,7401,0.06%
1505064,1506,Sudeste Paraense,15016,Tucuruí,Novo Repartimento,PA,,,,41817,51645,62124,32768,29356,28065,34059,4.04%
1505106,1501,Baixo Amazonas,15001,Óbidos,Óbidos,PA,26426,38009,42307,46490,46793,49254,25500,23754,25414,23840,0.58%
1505205,1504,Nordeste Paraense,15011,Cametá,Oeiras do Pará,PA,10768,12469,18792,23255,25420,28595,15017,13578,11432,17163,2.09%
1505304,1501,Baixo Amazonas,15001,Óbidos,Oriximiná,PA,18994,29593,41154,48332,55175,62963,31794,31169,40182,22781,2.68%
1505403,1504,Nordeste Paraense,15013,Guamá,Ourém,PA,27644,38359,30995,14397,15152,16296,8440,7856,7438,8858,1.25%
1505437,1506,Sudeste Paraense,15018,São Félix do Xingu,Ourilândia do Norte,PA,,,28718,19471,20415,27564,14379,13185,19931,7633,3.54%
1505486,1505,Sudoeste Paraense,15015,Altamira,Pacajá,PA,,,30777,28888,38365,40052,21599,18453,13752,26300,3.32%
1505494,1506,Sudeste Paraense,15020,Marabá,Palestina do Pará,PA,,,,7544,7156,7487,3883,3604,4572,2915,-0.08%
1505502,1506,Sudeste Paraense,15017,Paragominas,Paragominas,PA,14697,48112,67075,76450,90819,97788,49263,48525,76478,21310,2.49%
1505536,1506,Sudeste Paraense,15019,Parauapebas,Parauapebas,PA,,,53335,71568,133298,153942,77866,76076,138769,15173,7.96%
1505551,1506,Sudeste Paraense,15021,Redenção,Pau D'Arco,PA,,,,7124,6466,6029,3176,2853,3641,2388,-1.66%
1505601,1504,Nordeste Paraense,15010,Bragantina,Peixe-Boi,PA,6136,7256,5966,7760,7679,7868,4047,3821,4184,3684,0.14%
1505635,1506,Sudeste Paraense,15021,Redenção,Piçarra,PA,,,,12671,12707,12703,6778,5925,3581,9122,0.03%
1505650,1501,Baixo Amazonas,15002,Santarém,Placas,PA,,,,13394,17898,23930,12562,11368,4856,19074,5.97%
1505700,1502,Marajó,15006,Arari,Ponta de Pedras,PA,10998,12874,16500,18694,24276,25989,13379,12610,12429,13560,3.35%
1505809,1502,Marajó,15004,Portel,Portel,PA,16411,43158,29452,38043,45586,52166,26817,25349,24846,27320,3.21%
1505908,1501,Baixo Amazonas,15003,Almeirim,Porto de Moz,PA,7523,11805,15407,23545,26489,33951,17612,16339,14586,19365,3.73%
1506005,1501,Baixo Amazonas,15002,Santarém,Prainha,PA,12304,45354,26782,27301,26436,29265,15475,13790,8954,20311,0.70%
1506104,1504,Nordeste Paraense,15010,Bragantina,Primavera,PA,21512,26479,17132,9718,10463,10268,5303,4965,6395,3873,0.55%
1506112,1504,Nordeste Paraense,15010,Bragantina,Quatipuru,PA,,,,10905,12620,12411,6461,5950,5313,7098,1.30%
1506138,1506,Sudeste Paraense,15021,Redenção,Redenção,PA,,,55968,63251,64583,75505,37944,37561,69994,5511,1.79%
1506161,1506,Sudeste Paraense,15021,Redenção,Rio Maria,PA,,,26536,17498,16993,17722,9174,8548,13536,4186,0.13%
1506187,1506,Sudeste Paraense,15017,Paragominas,Rondon do Pará,PA,,,40879,39870,45016,46974,24276,22698,34704,12270,1.65%
1506195,1505,Sudoeste Paraense,15014,Itaituba,Rurópolis,PA,,,19468,24660,32950,40068,20870,19198,15275,24793,4.97%
1506203,1504,Nordeste Paraense,15009,Salgado,Salinópolis,PA,9651,14349,22670,33449,37066,37430,19097,18333,33400,4030,1.13%
1506302,1502,Marajó,15006,Arari,Salvaterra,PA,9127,10008,11889,15118,17077,20184,10292,9892,12681,7503,2.93%
1506351,1503,Metropolitana de Belém,15007,Belém,Santa Bárbara do Pará,PA,,,,11378,13714,17154,8763,8391,5456,11698,4.19%
1506401,1502,Marajó,15006,Arari,Santa Cruz do Arari,PA,5258,4706,4774,5255,5921,8163,4145,4018,4001,4162,4.50%
1506500,1503,Metropolitana de Belém,15008,Castanhal,Santa Isabel do Pará,PA,15848,24044,33329,43227,51763,59476,31174,28302,42996,16480,3.24%
1506559,1504,Nordeste Paraense,15013,Guamá,Santa Luzia do Pará,PA,,,,19400,18123,19422,9882,9540,8691,10731,0.01%
1506583,1506,Sudeste Paraense,15022,Conceição do Araguaia,Santa Maria das Barreiras,PA,,,7228,10955,16012,17198,9489,7709,6351,10847,4.61%
1506609,1504,Nordeste Paraense,15010,Bragantina,Santa Maria do Pará,PA,9927,14345,17946,20850,22147,23033,11493,11540,13335,9698,1.00%
1506708,1506,Sudeste Paraense,15022,Conceição do Araguaia,Santana do Araguaia,PA,9085,12605,15923,31218,49053,56132,29743,26389,29651,26481,6.04%
1506807,1501,Baixo Amazonas,15002,Santarém,Santarém,PA,135215,191945,265062,262538,274285,294774,145651,149123,215947,78827,1.16%
1506906,1504,Nordeste Paraense,15010,Bragantina,Santarém Novo,PA,3991,4772,4486,5434,6007,6145,3214,2931,1813,4332,1.24%
1507003,1503,Metropolitana de Belém,15008,Castanhal,Santo Antônio do Tauá,PA,10919,11460,17128,19835,24814,26673,13440,13233,14873,11800,3.01%
1507102,1504,Nordeste Paraense,15009,Salgado,São Caetano de Odivelas,PA,14229,20926,21126,15595,16179,16891,8806,8085,6958,9933,0.80%
1507151,1506,Sudeste Paraense,15020,Marabá,São Domingos do Araguaia,PA,,,,20005,21094,23140,11922,11218,15262,7878,1.47%
1507201,1504,Nordeste Paraense,15013,Guamá,São Domingos do Capim,PA,29786,63548,42526,27405,27094,29827,15738,14089,6599,23228,0.85%
1507300,1506,Sudeste Paraense,15018,São Félix do Xingu,São Félix do Xingu,PA,2332,4954,24891,34621,59238,91293,48650,42643,45134,46159,10.18%
1507409,1504,Nordeste Paraense,15010,Bragantina,São Francisco do Pará,PA,6827,10522,11619,14245,11913,15196,7847,7349,5206,9990,0.65%
1507458,1506,Sudeste Paraense,15021,Redenção,São Geraldo do Araguaia,PA,,,38540,27646,24872,25584,13077,12507,13601,11983,-0.77%
1507466,1504,Nordeste Paraense,15009,Salgado,São João da Ponta,PA,,,,4035,4715,5265,2739,2526,1031,4234,2.70%
1507474,1504,Nordeste Paraense,15009,Salgado,São João de Pirabas,PA,,,16259,17484,18919,20644,10763,9881,10486,10158,1.68%
1507508,1506,Sudeste Paraense,15020,Marabá,São João do Araguaia,PA,15322,35774,19824,12247,11673,13149,7132,6017,2583,10566,0.71%
1507607,1504,Nordeste Paraense,15013,Guamá,São Miguel do Guamá,PA,17452,26675,32933,41366,42987,51527,25996,25531,31852,19675,2.22%
1507706,1502,Marajó,15005,Furos de Breves,São Sebastião da Boa Vista,PA,11409,12617,14926,17664,20500,22890,11831,11059,9907,12983,2.63%
1507755,1506,Sudeste Paraense,15021,Redenção,Sapucaia,PA,,,,3796,5117,5047,2710,2337,3325,1722,2.89%
1507805,1505,Sudoeste Paraense,15015,Altamira,Senador José Porfírio,PA,2971,6391,39010,15721,14302,12998,6968,6030,6475,6523,-1.88%
1507904,1502,Marajó,15006,Arari,Soure,PA,13787,16055,17481,19958,21395,22995,11477,11518,21009,1986,1.43%
1507953,1504,Nordeste Paraense,15012,Tomé-Açu,Tailândia,PA,,,17707,38435,64281,79299,40991,38308,58715,20584,7.51%
1507961,1504,Nordeste Paraense,15009,Salgado,Terra Alta,PA,,,,8261,9861,10254,5272,4982,4334,5920,2.18%
1507979,1501,Baixo Amazonas,15001,Óbidos,Terra Santa,PA,,,,14592,15316,16952,8794,8158,10340,6612,1.51%
1508001,1504,Nordeste Paraense,15012,Tomé-Açu,Tomé-Açu,PA,24132,40473,41403,47273,47081,56514,29327,27187,31646,24868,1.80%
1508035,1504,Nordeste Paraense,15010,Bragantina,Tracuateua,PA,,,,22743,26129,27466,14329,13137,7266,20200,1.90%
1508050,1505,Sudoeste Paraense,15014,Itaituba,Trairão,PA,,,,14042,16097,16885,9154,7731,5687,11198,1.86%
1508084,1506,Sudeste Paraense,15018,São Félix do Xingu,Tucumã,PA,,,31375,25309,26513,33651,17448,16203,26862,6789,2.89%
1508100,1506,Sudeste Paraense,15016,Tucuruí,Tucuruí,PA,9921,61123,81623,73798,89264,97109,48381,48728,92433,4676,2.78%
1508126,1506,Sudeste Paraense,15017,Paragominas,Ulianópolis,PA,,,,19254,31881,43345,22208,21137,28529,14816,8.45%
1508159,1505,Sudoeste Paraense,15015,Altamira,Uruará,PA,,,25339,45201,35076,44720,23604,21116,24405,20315,-0.11%
1508209,1504,Nordeste Paraense,15009,Salgado,Vigia,PA,19261,24825,37418,40176,43847,47902,24555,23347,32362,15540,1.77%
1508308,1504,Nordeste Paraense,15013,Guamá,Viseu,PA,33014,57009,63173,51090,53217,56681,29794,26887,18392,38289,1.04%
1508357,1505,Sudoeste Paraense,15015,Altamira,Vitória do Xingu,PA,,,,11142,9693,13480,7294,6186,5361,8119,1.92%
1508407,1506,Sudeste Paraense,15021,Redenção,Xinguara,PA,,,48024,35220,38457,40573,20572,20001,31492,9081,1.42%
2500106,2501,Sertão Paraibano,25007,Serra do Teixeira,Água Branca,PB,6457,7769,8203,8377,9224,9449,4720,4729,4061,5388,1.21%
2500205,2501,Sertão Paraibano,25005,Piancó,Aguiar,PB,12444,7782,7259,5638,5629,5530,2706,2824,2701,2829,-0.19%
2500304,2503,Agreste Paraibano,25015,Brejo Paraibano,Alagoa Grande,PB,31635,30451,30128,29169,27448,28482,13862,14620,17532,10950,-0.24%
2500403,2503,Agreste Paraibano,25015,Brejo Paraibano,Alagoa Nova,PB,21942,21192,22337,18575,19163,19686,9764,9922,9797,9889,0.58%
2500502,2503,Agreste Paraibano,25016,Guarabira,Alagoinha,PB,9779,12180,11075,11833,13025,13577,6706,6871,9033,4544,1.38%
2500536,2502,Borborema,25011,Cariri Oriental,Alcantil,PB,,,,4958,5068,5239,2626,2613,2064,3175,0.55%
2500577,2503,Agreste Paraibano,25012,Curimataú Ocidental,Algodão de Jandaíra,PB,,,,2209,2342,2366,1218,1148,1231,1135,0.69%
2500601,2504,Mata Paraibana,25023,Litoral Sul,Alhandra,PB,11534,9179,13270,15914,18183,18001,8863,9138,11146,6855,1.24%
2500700,2501,Sertão Paraibano,25002,Cajazeiras,São João do Rio do Peixe,PB,18694,21115,21551,17661,17773,18201,8940,9261,6885,11316,0.30%
2500734,2502,Borborema,25010,Cariri Ocidental,Amparo,PB,,,,1886,2007,2088,1047,1041,1062,1026,1.02%
2500775,2501,Sertão Paraibano,25003,Sousa,Aparecida,PB,,,,5894,7323,7676,3796,3880,3638,4038,2.68%
2500809,2503,Agreste Paraibano,25016,Guarabira,Araçagi,PB,18474,18816,18369,18095,17376,17224,8574,8650,6804,10420,-0.49%
2500908,2503,Agreste Paraibano,25012,Curimataú Ocidental,Arara,PB,7704,8493,9654,11530,12356,12653,6074,6579,8924,3729,0.93%
2501005,2503,Agreste Paraibano,25013,Curimataú Oriental,Araruna,PB,18885,19023,17896,16605,19191,18886,9328,9558,9330,9556,1.30%
2501104,2503,Agreste Paraibano,25015,Brejo Paraibano,Areia,PB,29975,27880,28130,26131,24992,23837,11668,12169,14602,9235,-0.91%
2501153,2501,Sertão Paraibano,25004,Patos,Areia de Baraúnas,PB,,,,2104,2096,1927,963,964,1017,910,-0.87%
2501203,2503,Agreste Paraibano,25014,Esperança,Areial,PB,4936,5255,6075,6039,6234,6470,3060,3410,4600,1870,0.69%
2501302,2503,Agreste Paraibano,25019,Umbuzeiro,Aroeiras,PB,25106,27068,28799,19520,19174,19089,9227,9862,9538,9551,-0.22%
2501351,2502,Borborema,25010,Cariri Ocidental,Assunção,PB,,,,2960,3336,3522,1779,1743,2846,676,1.75%
2501401,2504,Mata Paraibana,25020,Litoral Norte,Baía da Traição,PB,3346,4316,5358,6483,7630,8007,4035,3972,3091,4916,2.13%
2501500,2503,Agreste Paraibano,25015,Brejo Paraibano,Bananeiras,PB,27469,25009,23157,21810,21670,21854,10786,11068,8667,13187,0.02%
2501534,2502,Borborema,25009,Seridó Oriental Paraibano,Baraúna,PB,,,,3169,3864,4222,2111,2111,3189,1033,2.91%
2501575,2502,Borborema,25011,Cariri Oriental,Barra de Santana,PB,,,,8311,8619,8205,4146,4059,731,7474,-0.13%
2501609,2503,Agreste Paraibano,25012,Curimataú Ocidental,Barra de Santa Rosa,PB,14409,15890,17020,13127,12848,14160,7087,7073,7959,6201,0.76%
2501708,2502,Borborema,25011,Cariri Oriental,Barra de São Miguel,PB,4616,4744,5045,5162,5435,5611,2918,2693,2364,3247,0.84%
2501807,2504,Mata Paraibana,25022,João Pessoa,Bayeux,PB,35464,58921,77491,87561,92891,99758,47753,52005,98834,924,1.31%
2501906,2503,Agreste Paraibano,25016,Guarabira,Belém,PB,12021,13766,15645,16605,17173,17083,8344,8739,14102,2981,0.28%
2502003,2501,Sertão Paraibano,25001,Catolé do Rocha,Belém do Brejo do Cruz,PB,8609,8711,8141,7011,7040,7143,3607,3536,5260,1883,0.19%
2502052,2501,Sertão Paraibano,25002,Cajazeiras,Bernardino Batista,PB,,,,2559,3164,3075,1476,1599,858,2217,1.85%
2502102,2501,Sertão Paraibano,25006,Itaporanga,Boa Ventura,PB,6686,5506,5970,6588,5800,5751,2899,2852,3522,2229,-1.35%
2502151,2503,Agreste Paraibano,25017,Campina Grande,Boa Vista,PB,,,,4983,5673,6224,3084,3140,3205,3019,2.25%
2502201,2501,Sertão Paraibano,25002,Cajazeiras,Bom Jesus,PB,1244,1302,1735,2193,2233,2399,1221,1178,991,1408,0.90%
2502300,2501,Sertão Paraibano,25001,Catolé do Rocha,Bom Sucesso,PB,6596,7348,6277,5285,5152,5037,2477,2560,2030,3007,-0.48%
2502409,2501,Sertão Paraibano,25002,Cajazeiras,Bonito de Santa Fé,PB,7066,7742,9043,9230,10253,10806,5351,5455,7401,3405,1.59%
2502508,2502,Borborema,25011,Cariri Oriental,Boqueirão,PB,26383,30253,33255,15867,15877,16889,8325,8564,12008,4881,0.63%
2502607,2501,Sertão Paraibano,25005,Piancó,Igaracy,PB,5450,5966,5754,6307,6334,6156,3018,3138,4121,2035,-0.24%
2502706,2503,Agreste Paraibano,25015,Brejo Paraibano,Borborema,PB,5111,4376,4184,4730,5009,5111,2558,2553,3732,1379,0.78%
2502805,2501,Sertão Paraibano,25001,Catolé do Rocha,Brejo do Cruz,PB,11979,14012,13884,11868,12424,13123,6510,6613,9898,3225,1.01%
2502904,2501,Sertão Paraibano,25001,Catolé do Rocha,Brejo dos Santos,PB,5875,6579,6233,5948,5743,6197,3091,3106,4631,1566,0.41%
2503001,2504,Mata Paraibana,25023,Litoral Sul,Caaporã,PB,8303,9997,15007,18441,19388,20363,10091,10272,17549,2814,1.00%
2503100,2502,Borborema,25011,Cariri Oriental,Cabaceiras,PB,6254,6133,6180,4290,4907,5035,2495,2540,2217,2818,1.61%
2503209,2504,Mata Paraibana,25022,João Pessoa,Cabedelo,PB,15830,18973,29052,42832,49728,57926,27623,30303,57918,8,3.06%
2503308,2501,Sertão Paraibano,25002,Cajazeiras,Cachoeira dos Índios,PB,6835,8521,7315,7834,8388,9546,4820,4726,3403,6143,2.00%
2503407,2501,Sertão Paraibano,25004,Patos,Cacimba de Areia,PB,3155,2841,2906,3577,3485,3557,1779,1778,1674,1883,-0.06%
2503506,2503,Agreste Paraibano,25013,Curimataú Oriental,Cacimba de Dentro,PB,14135,16769,17672,16817,17108,16755,8219,8536,9164,7591,-0.04%
2503555,2501,Sertão Paraibano,25007,Serra do Teixeira,Cacimbas,PB,,,,6979,6787,6814,3284,3530,1641,5173,-0.24%
2503605,2503,Agreste Paraibano,25016,Guarabira,Caiçara,PB,10541,11021,10529,7325,7314,7220,3619,3601,5190,2030,-0.14%
2503704,2501,Sertão Paraibano,25002,Cajazeiras,Cajazeiras,PB,41693,46448,51273,54715,56051,58437,27930,30507,47489,10948,0.66%
2503753,2501,Sertão Paraibano,25003,Sousa,Cajazeirinhas,PB,,,,2848,3057,3033,1548,1485,1000,2033,0.63%
2503803,2503,Agreste Paraibano,25018,Itabaiana,Caldas Brandão,PB,3462,4470,4522,5155,5363,5637,2803,2834,3224,2413,0.90%
2503902,2502,Borborema,25010,Cariri Ocidental,Camalaú,PB,4843,5071,5549,5516,5761,5749,2841,2908,2887,2862,0.41%
2504009,2503,Agreste Paraibano,25017,Campina Grande,Campina Grande,PB,195303,247827,326307,355331,371060,385276,182249,203027,367278,17998,0.81%
2504033,2504,Mata Paraibana,25020,Litoral Norte,Capim,PB,,,,4180,5207,5601,2815,2786,4106,1495,2.97%
2504074,2502,Borborema,25011,Cariri Oriental,Caraúbas,PB,,,,3401,3824,3899,1972,1927,1517,2382,1.38%
2504108,2501,Sertão Paraibano,25002,Cajazeiras,Carrapateira,PB,1455,1451,1872,2160,2389,2378,1247,1131,1713,665,0.97%
2504157,2503,Agreste Paraibano,25013,Curimataú Oriental,Casserengue,PB,,,,6568,6762,7058,3549,3509,3458,3600,0.72%
2504207,2501,Sertão Paraibano,25005,Piancó,Catingueira,PB,5209,5848,5199,4748,4849,4812,2413,2399,2884,1928,0.13%
2504306,2501,Sertão Paraibano,25001,Catolé do Rocha,Catolé do Rocha,PB,23500,25855,25220,26641,27548,28766,14038,14728,21327,7439,0.77%
2504355,2502,Borborema,25011,Cariri Oriental,Caturité,PB,,,,4183,4467,4546,2301,2245,1025,3521,0.84%
2504405,2501,Sertão Paraibano,25006,Itaporanga,Conceição,PB,18789,22718,23216,17931,17496,18366,9121,9245,11436,6930,0.24%
2504504,2501,Sertão Paraibano,25003,Sousa,Condado,PB,7157,8590,7399,6495,6702,6587,3217,3370,4564,2023,0.14%
2504603,2504,Mata Paraibana,25022,João Pessoa,Conde,PB,4911,6379,10391,16413,19925,21418,10773,10645,14495,6923,2.70%
2504702,2502,Borborema,25010,Cariri Ocidental,Congo,PB,3879,6043,4367,4602,4770,4692,2380,2312,2944,1748,0.19%
2504801,2501,Sertão Paraibano,25005,Piancó,Coremas,PB,12696,13578,14485,15130,15236,15149,7419,7730,11419,3730,0.01%
2504850,2502,Borborema,25010,Cariri Ocidental,Coxixola,PB,,,,1422,1705,1771,916,855,782,989,2.22%
2504900,2504,Mata Paraibana,25021,Sapé,Cruz do Espírito Santo,PB,13620,13192,12651,14081,15281,16257,8093,8164,7440,8817,1.45%
2505006,2502,Borborema,25009,Seridó Oriental Paraibano,Cubati,PB,5506,6534,6279,6388,6356,6868,3392,3476,4772,2096,0.73%
2505105,2503,Agreste Paraibano,25012,Curimataú Ocidental,Cuité,PB,18249,22312,23153,19946,20197,19950,9818,10132,13462,6488,0.00%
2505204,2503,Agreste Paraibano,25016,Guarabira,Cuitegi,PB,3963,5119,6989,7254,7047,6889,3389,3500,5608,1281,-0.51%
2505238,2504,Mata Paraibana,25020,Litoral Norte,Cuité de Mamanguape,PB,,,,6124,6505,6198,3099,3099,2065,4133,0.12%
2505279,2504,Mata Paraibana,25020,Litoral Norte,Curral de Cima,PB,,,,5323,5469,5214,2632,2582,473,4741,-0.21%
2505303,2501,Sertão Paraibano,25006,Itaporanga,Curral Velho,PB,2247,2518,2537,2558,2781,2505,1305,1200,1410,1095,-0.21%
2505352,2503,Agreste Paraibano,25012,Curimataú Ocidental,Damião,PB,,,,3645,4807,4900,2460,2440,2278,2622,3.00%
2505402,2501,Sertão Paraibano,25007,Serra do Teixeira,Desterro,PB,10085,12110,12771,7701,7929,7991,3893,4098,4889,3102,0.37%
2505501,2501,Sertão Paraibano,25003,Sousa,Vista Serrana,PB,2124,2301,3052,3121,3253,3508,1819,1689,1586,1922,1.18%
2505600,2501,Sertão Paraibano,25006,Itaporanga,Diamante,PB,5283,6513,7356,6920,6582,6616,3331,3285,3818,2798,-0.45%
2505709,2503,Agreste Paraibano,25013,Curimataú Oriental,Dona Inês,PB,9035,10044,9842,10227,10832,10517,5277,5240,4655,5862,0.28%
2505808,2503,Agreste Paraibano,25016,Guarabira,Duas Estradas,PB,7239,7656,7357,3818,3748,3640,1790,1850,2841,799,-0.48%
2505907,2501,Sertão Paraibano,25005,Piancó,Emas,PB,2644,2894,3129,3061,3257,3317,1673,1644,2132,1185,0.81%
2506004,2503,Agreste Paraibano,25014,Esperança,Esperança,PB,20971,23802,27594,28166,29801,31095,15154,15941,21631,9464,0.99%
2506103,2503,Agreste Paraibano,25017,Campina Grande,Fagundes,PB,12782,12526,13195,11892,11830,11409,5609,5800,5467,5942,-0.41%
2506202,2502,Borborema,25009,Seridó Oriental Paraibano,Frei Martinho,PB,2710,2735,2684,2923,2935,2933,1468,1465,1807,1126,0.03%
2506251,2503,Agreste Paraibano,25019,Umbuzeiro,Gado Bravo,PB,,,,8521,8236,8376,4133,4243,908,7468,-0.17%
2506301,2503,Agreste Paraibano,25016,Guarabira,Guarabira,PB,34732,41808,48654,51482,54200,55340,26699,28641,48974,6366,0.73%
2506400,2503,Agreste Paraibano,25018,Itabaiana,Gurinhém,PB,12424,13185,13136,13182,13209,13872,6920,6952,5795,8077,0.51%
2506509,2502,Borborema,25011,Cariri Oriental,Gurjão,PB,5260,5693,6072,2789,2985,3159,1550,1609,2128,1031,1.25%
2506608,2501,Sertão Paraibano,25006,Itaporanga,Ibiara,PB,6227,6597,6583,6383,6139,6031,3035,2996,3686,2345,-0.57%
2506707,2501,Sertão Paraibano,25007,Serra do Teixeira,Imaculada,PB,8425,10123,10223,11577,11451,11352,5707,5645,5063,6289,-0.20%
2506806,2503,Agreste Paraibano,25018,Itabaiana,Ingá,PB,17272,19498,21721,17473,18168,18180,8838,9342,11599,6581,0.40%
2506905,2503,Agreste Paraibano,25018,Itabaiana,Itabaiana,PB,24681,26510,26464,25207,24752,24483,11850,12633,19733,4750,-0.29%
2507002,2501,Sertão Paraibano,25006,Itaporanga,Itaporanga,PB,17426,18353,19814,21123,22425,23195,11392,11803,17632,5563,0.94%
2507101,2504,Mata Paraibana,25020,Litoral Norte,Itapororoca,PB,11751,12498,13435,14633,15966,16998,8561,8437,10857,6141,1.51%
2507200,2503,Agreste Paraibano,25018,Itabaiana,Itatuba,PB,8156,9098,9141,9374,9841,10201,5049,5152,5955,4246,0.85%
2507309,2504,Mata Paraibana,25020,Litoral Norte,Jacaraú,PB,17350,17861,18344,14117,13708,13952,6924,7028,8042,5910,-0.12%
2507408,2501,Sertão Paraibano,25001,Catolé do Rocha,Jericó,PB,6467,8177,9458,7416,7825,7538,3693,3845,4729,2809,0.16%
2507507,2504,Mata Paraibana,25022,João Pessoa,João Pessoa,PB,221546,329945,497600,597934,674762,723514,337745,385769,720789,2725,1.92%
2507606,2503,Agreste Paraibano,25018,Itabaiana,Juarez Távora,PB,4581,5778,7219,7081,7618,7459,3641,3818,5852,1607,0.52%
2507705,2502,Borborema,25009,Seridó Oriental Paraibano,Juazeirinho,PB,12446,15003,17341,14873,15899,16776,8366,8410,9124,7652,1.21%
2507804,2502,Borborema,25008,Seridó Ocidental Paraibano,Junco do Seridó,PB,4644,4619,5768,5968,6486,6643,3308,3335,4369,2274,1.08%
2507903,2504,Mata Paraibana,25021,Sapé,Juripiranga,PB,7163,8040,9405,9647,10240,10240,5131,5109,9589,651,0.60%
2508000,2501,Sertão Paraibano,25007,Serra do Teixeira,Juru,PB,8170,9439,10523,10045,10222,9826,4897,4929,4359,5467,-0.22%
2508109,2501,Sertão Paraibano,25001,Catolé do Rocha,Lagoa,PB,4923,6005,5756,4844,4807,4681,2305,2376,2304,2377,-0.34%
2508208,2503,Agreste Paraibano,25016,Guarabira,Lagoa de Dentro,PB,6839,8595,7322,7086,7258,7370,3626,3744,3975,3395,0.39%
2508307,2503,Agreste Paraibano,25017,Campina Grande,Lagoa Seca,PB,18332,18915,21660,24154,24937,25911,12743,13168,10585,15326,0.70%
2508406,2501,Sertão Paraibano,25003,Sousa,Lastro,PB,3243,3038,3278,3118,2834,2841,1438,1403,1335,1506,-0.93%
2508505,2502,Borborema,25010,Cariri Ocidental,Livramento,PB,5627,5903,7029,7605,7105,7164,3523,3641,3752,3412,-0.60%
2508554,2503,Agreste Paraibano,25016,Guarabira,Logradouro,PB,,,,3389,3816,3942,1938,2004,1723,2219,1.52%
2508604,2504,Mata Paraibana,25022,João Pessoa,Lucena,PB,4747,6353,7699,9755,10943,11730,5826,5904,10152,1578,1.86%
2508703,2501,Sertão Paraibano,25004,Patos,Mãe d'Água,PB,4727,5526,4719,3459,4017,4019,1964,2055,1569,2450,1.51%
2508802,2501,Sertão Paraibano,25003,Sousa,Malta,PB,5262,6080,6023,5692,5634,5612,2702,2910,4904,708,-0.14%
2508901,2504,Mata Paraibana,25020,Litoral Norte,Mamanguape,PB,37058,41087,49887,38772,40283,42330,20807,21523,34248,8082,0.88%
2509008,2501,Sertão Paraibano,25007,Serra do Teixeira,Manaíra,PB,7696,10606,11375,10473,10986,10759,5400,5359,6027,4732,0.27%
2509057,2504,Mata Paraibana,25020,Litoral Norte,Marcação,PB,,,,6203,7287,7611,3895,3716,2851,4760,2.07%
2509107,2504,Mata Paraibana,25021,Sapé,Mari,PB,15504,17836,20702,20663,20526,21173,10359,10814,17449,3724,0.24%
2509156,2501,Sertão Paraibano,25003,Sousa,Marizópolis,PB,,,,5618,6214,6173,3016,3157,5357,816,0.95%
2509206,2503,Agreste Paraibano,25017,Campina Grande,Massaranduba,PB,14672,12802,12030,11697,12494,12910,6250,6660,4487,8423,0.99%
2509305,2504,Mata Paraibana,25020,Litoral Norte,Mataraca,PB,2297,2482,4990,5500,6984,7404,3687,3717,6544,860,3.02%
2509339,2503,Agreste Paraibano,25015,Brejo Paraibano,Matinhas,PB,,,,4086,4178,4316,2149,2167,682,3634,0.55%
2509370,2501,Sertão Paraibano,25001,Catolé do Rocha,Mato Grosso,PB,,,,2427,2601,2702,1349,1353,1201,1501,1.08%
2509396,2501,Sertão Paraibano,25007,Serra do Teixeira,Maturéia,PB,,,,5032,5785,5939,2900,3039,3857,2082,1.67%
2509404,2503,Agreste Paraibano,25018,Itabaiana,Mogeiro,PB,11002,12812,13295,13231,12305,12490,6076,6414,5582,6908,-0.57%
2509503,2503,Agreste Paraibano,25014,Esperança,Montadas,PB,3096,3361,3836,3969,4558,4990,2482,2508,3156,1834,2.32%
2509602,2501,Sertão Paraibano,25002,Cajazeiras,Monte Horebe,PB,4003,3789,4053,4112,4345,4508,2263,2245,2501,2007,0.92%
2509701,2502,Borborema,25010,Cariri Ocidental,Monteiro,PB,25396,26852,27052,27687,29980,30844,14976,15868,20259,10585,1.09%
2509800,2503,Agreste Paraibano,25016,Guarabira,Mulungu,PB,11672,11751,10922,9189,9317,9469,4630,4839,4536,4933,0.30%
2509909,2503,Agreste Paraibano,25019,Umbuzeiro,Natuba,PB,10760,11457,11624,10562,10216,10566,5217,5349,3634,6932,0.00%
2510006,2501,Sertão Paraibano,25003,Sousa,Nazarezinho,PB,7344,8342,7420,7272,6933,7280,3630,3650,3184,4096,0.01%
2510105,2503,Agreste Paraibano,25012,Curimataú Ocidental,Nova Floresta,PB,5501,6472,7257,9421,10032,10533,5116,5417,7892,2641,1.12%
2510204,2501,Sertão Paraibano,25005,Piancó,Nova Olinda,PB,4793,5368,6198,6457,6280,6070,3019,3051,3227,2843,-0.62%
2510303,2502,Borborema,25009,Seridó Oriental Paraibano,Nova Palmeira,PB,2725,3041,3320,3573,3934,4365,2166,2199,2556,1809,2.02%
2510402,2501,Sertão Paraibano,25005,Piancó,Olho d'Água,PB,7868,9266,9109,7831,7450,6931,3352,3579,3868,3063,-1.21%
2510501,2503,Agreste Paraibano,25012,Curimataú Ocidental,Olivedos,PB,3296,3607,3392,3194,3489,3627,1853,1774,1902,1725,1.28%
2510600,2502,Borborema,25010,Cariri Ocidental,Ouro Velho,PB,2767,2997,2826,2823,2974,2928,1470,1458,2047,881,0.37%
2510659,2502,Borborema,25010,Cariri Ocidental,Parari,PB,,,,1437,1245,1256,621,635,699,557,-1.34%
2510709,2501,Sertão Paraibano,25004,Patos,Passagem,PB,3613,4234,3444,1979,2124,2233,1107,1126,1109,1124,1.21%
2510808,2501,Sertão Paraibano,25004,Patos,Patos,PB,46414,65162,81298,91761,97276,100695,47816,52879,97296,3399,0.93%
2510907,2501,Sertão Paraibano,25003,Sousa,Paulista,PB,9920,10464,11004,11266,11619,11783,5825,5958,5717,6066,0.45%
2511004,2501,Sertão Paraibano,25006,Itaporanga,Pedra Branca,PB,3516,3165,3566,3692,3743,3721,1847,1874,2365,1356,0.08%
2511103,2502,Borborema,25009,Seridó Oriental Paraibano,Pedra Lavrada,PB,5701,6155,6677,6617,6810,7475,3734,3741,3075,4400,1.23%
2511202,2504,Mata Paraibana,25023,Litoral Sul,Pedras de Fogo,PB,15642,19875,26614,25861,26279,27034,13468,13566,16360,10674,0.44%
2511301,2501,Sertão Paraibano,25005,Piancó,Piancó,PB,13380,14899,15960,14872,15881,15465,7388,8077,11278,4187,0.39%
2511400,2502,Borborema,25009,Seridó Oriental Paraibano,Picuí,PB,17386,18864,18895,17896,18716,18226,8957,9269,12122,6104,0.18%
2511509,2504,Mata Paraibana,25021,Sapé,Pilar,PB,12008,12721,13773,10274,11301,11191,5500,5691,7673,3518,0.86%
2511608,2503,Agreste Paraibano,25015,Brejo Paraibano,Pilões,PB,8206,7743,7894,7800,6936,6978,3517,3461,3332,3646,-1.11%
2511707,2503,Agreste Paraibano,25016,Guarabira,Pilõezinhos,PB,5465,5124,5391,5430,5319,5155,2543,2612,2747,2408,-0.52%
2511806,2503,Agreste Paraibano,25016,Guarabira,Pirpirituba,PB,9632,9957,10596,10198,10232,10319,5110,5209,7892,2427,0.12%
2511905,2504,Mata Paraibana,25023,Litoral Sul,Pitimbu,PB,6773,7873,9463,13927,16140,17032,8611,8421,10392,6640,2.03%
2512002,2503,Agreste Paraibano,25012,Curimataú Ocidental,Pocinhos,PB,14332,15039,14502,14880,15956,17020,8485,8535,9615,7405,1.35%
2512036,2501,Sertão Paraibano,25002,Cajazeiras,Poço Dantas,PB,,,,3828,3919,3752,1905,1847,977,2775,-0.20%
2512077,2501,Sertão Paraibano,25002,Cajazeiras,Poço de José de Moura,PB,,,,3529,3959,3978,1935,2043,1425,2553,1.20%
2512101,2501,Sertão Paraibano,25003,Sousa,Pombal,PB,36191,39948,39511,31954,31524,32117,15381,16736,25760,6357,0.05%
2512200,2502,Borborema,25010,Cariri Ocidental,Prata,PB,4026,4374,3311,3425,3896,3854,1927,1927,2444,1410,1.19%
2512309,2501,Sertão Paraibano,25007,Serra do Teixeira,Princesa Isabel,PB,16085,19006,22234,18231,19330,21283,10448,10835,14528,6755,1.56%
2512408,2503,Agreste Paraibano,25017,Campina Grande,Puxinanã,PB,10653,10394,11573,11981,12881,12929,6362,6567,4219,8710,0.76%
2512507,2503,Agreste Paraibano,25017,Campina Grande,Queimadas,PB,21258,25481,32555,36032,38883,41054,19942,21112,22249,18805,1.31%
2512606,2501,Sertão Paraibano,25004,Patos,Quixabá,PB,1644,1896,1657,1308,1433,1699,893,806,633,1066,2.65%
2512705,2503,Agreste Paraibano,25012,Curimataú Ocidental,Remígio,PB,14168,15812,17167,14914,16748,17582,8380,9202,12954,4628,1.66%
2512721,2504,Mata Paraibana,25020,Litoral Norte,Pedro Régis,PB,,,,4883,5588,5779,2899,2880,2148,3631,1.70%
2512747,2503,Agreste Paraibano,25013,Curimataú Oriental,Riachão,PB,,,,2793,3405,3274,1595,1679,2031,1243,1.60%
2512754,2503,Agreste Paraibano,25018,Itabaiana,Riachão do Bacamarte,PB,,,,3948,4172,4264,2082,2182,2663,1601,0.77%
2512762,2504,Mata Paraibana,25021,Sapé,Riachão do Poço,PB,,,,3694,4239,4164,2086,2078,1287,2877,1.20%
2512788,2502,Borborema,25011,Cariri Oriental,Riacho de Santo Antônio,PB,,,,1334,1524,1722,871,851,1186,536,2.59%
2512804,2501,Sertão Paraibano,25001,Catolé do Rocha,Riacho dos Cavalos,PB,8987,10073,9462,8064,8057,8314,4242,4072,4025,4289,0.31%
2512903,2504,Mata Paraibana,25020,Litoral Norte,Rio Tinto,PB,26190,24548,27127,22311,23023,22979,11311,11668,13060,9919,0.30%
2513000,2502,Borborema,25008,Seridó Ocidental Paraibano,Salgadinho,PB,3012,2893,2710,2823,3367,3508,1782,1726,1203,2305,2.20%
2513109,2503,Agreste Paraibano,25018,Itabaiana,Salgado de São Félix,PB,11198,12689,12534,12046,12526,11976,5836,6140,5250,6726,-0.06%
2513158,2503,Agreste Paraibano,25019,Umbuzeiro,Santa Cecília,PB,,,,6862,7016,6661,3411,3250,1868,4793,-0.30%
2513208,2501,Sertão Paraibano,25003,Sousa,Santa Cruz,PB,7615,7995,7410,6471,6480,6471,3283,3188,2988,3483,0.00%
2513307,2501,Sertão Paraibano,25002,Cajazeiras,Santa Helena,PB,5579,5912,6127,6170,6028,5369,2626,2743,2702,2667,-1.38%
2513356,2501,Sertão Paraibano,25006,Itaporanga,Santa Inês,PB,,,,3548,3707,3539,1823,1716,1430,2109,-0.03%
2513406,2502,Borborema,25008,Seridó Ocidental Paraibano,Santa Luzia,PB,8587,11670,13040,14012,14292,14729,7142,7587,13489,1240,0.50%
2513505,2501,Sertão Paraibano,25006,Itaporanga,Santana de Mangueira,PB,5092,6214,6501,5773,5609,5332,2698,2634,2232,3100,-0.79%
2513604,2501,Sertão Paraibano,25005,Piancó,Santana dos Garrotes,PB,9181,9164,8064,7882,7610,7266,3512,3754,3736,3530,-0.81%
2513653,2501,Sertão Paraibano,25002,Cajazeiras,Santarém,PB,,,,2568,2660,2615,1268,1347,840,1775,0.18%
2513703,2504,Mata Paraibana,25022,João Pessoa,Santa Rita,PB,53357,68227,94413,115844,122454,120333,58143,62190,103768,16565,0.38%
2513802,2501,Sertão Paraibano,25004,Patos,Santa Teresinha,PB,5262,5398,4920,4728,4644,4581,2276,2305,2208,2373,-0.32%
2513851,2502,Borborema,25011,Cariri Oriental,Santo André,PB,,,,2800,2641,2638,1337,1301,865,1773,-0.59%
2513901,2501,Sertão Paraibano,25001,Catolé do Rocha,São Bento,PB,10975,14608,21579,26225,29196,30880,15219,15661,25039,5841,1.65%
2513927,2501,Sertão Paraibano,25003,Sousa,São Bentinho,PB,,,,3589,4049,4138,2018,2120,2845,1293,1.43%
2513943,2502,Borborema,25011,Cariri Oriental,São Domingos do Cariri,PB,,,,2189,2265,2420,1212,1208,1034,1386,1.01%
2513968,2501,Sertão Paraibano,25003,Sousa,São Domingos,PB,,,,2498,2719,2851,1410,1441,994,1857,1.33%
2513984,2501,Sertão Paraibano,25003,Sousa,São Francisco,PB,,,,3464,3442,3364,1660,1704,1363,2001,-0.29%
2514008,2502,Borborema,25011,Cariri Oriental,São João do Cariri,PB,8055,7777,7537,4703,4438,4344,2121,2223,2347,1997,-0.79%
2514107,2502,Borborema,25010,Cariri Ocidental,São João do Tigre,PB,4083,4877,4146,4481,4578,4396,2247,2149,1529,2867,-0.19%
2514206,2501,Sertão Paraibano,25003,Sousa,São José da Lagoa Tapada,PB,9104,8498,7650,7184,7810,7564,3680,3884,3315,4249,0.52%
2514305,2501,Sertão Paraibano,25006,Itaporanga,São José de Caiana,PB,6007,6712,5329,5737,5942,6010,3052,2958,2729,3281,0.47%
2514404,2501,Sertão Paraibano,25004,Patos,São José de Espinharas,PB,8852,8440,5998,5109,4913,4760,2501,2259,1617,3143,-0.71%
2514453,2504,Mata Paraibana,25021,Sapé,São José dos Ramos,PB,,,,4900,5482,5508,2759,2749,2373,3135,1.18%
2514503,2501,Sertão Paraibano,25002,Cajazeiras,São José de Piranhas,PB,16729,18030,17625,17876,18898,19099,9530,9569,10798,8301,0.66%
2514552,2501,Sertão Paraibano,25007,Serra do Teixeira,São José de Princesa,PB,,,,4970,4644,4219,2139,2080,695,3524,-1.62%
2514602,2501,Sertão Paraibano,25004,Patos,São José do Bonfim,PB,3014,2956,2808,2838,3180,3233,1627,1606,1361,1872,1.31%
2514651,2501,Sertão Paraibano,25001,Catolé do Rocha,São José do Brejo do Cruz,PB,,,,1532,1647,1684,849,835,958,726,0.95%
2514701,2502,Borborema,25008,Seridó Ocidental Paraibano,São José do Sabugi,PB,3959,4337,4001,3903,3986,4010,2042,1968,2579,1431,0.27%
2514800,2502,Borborema,25010,Cariri Ocidental,São José dos Cordeiros,PB,6239,6685,6180,4136,3973,3985,1982,2003,1643,2342,-0.37%
2514909,2502,Borborema,25008,Seridó Ocidental Paraibano,São Mamede,PB,8241,9224,8521,8018,7782,7748,3837,3911,5929,1819,-0.34%
2515005,2504,Mata Paraibana,25021,Sapé,São Miguel de Taipu,PB,7971,4237,4213,6086,6568,6696,3342,3354,2977,3719,0.96%
2515104,2503,Agreste Paraibano,25014,Esperança,São Sebastião de Lagoa de Roça,PB,6652,7267,8794,10026,10908,11041,5423,5618,4659,6382,0.97%
2515203,2502,Borborema,25010,Cariri Ocidental,São Sebastião do Umbuzeiro,PB,5662,4589,4448,2894,3061,3239,1619,1620,2097,1142,1.13%
2515302,2504,Mata Paraibana,25021,Sapé,Sapé,PB,45345,50906,58515,47353,46363,50151,24658,25493,38149,12002,0.58%
2515401,2502,Borborema,25009,Seridó Oriental Paraibano,Seridó,PB,5355,6530,7870,9106,9737,10230,5261,4969,4597,5633,1.17%
2515500,2502,Borborema,25010,Cariri Ocidental,Serra Branca,PB,10531,15306,13595,12275,12413,12971,6331,6640,8417,4554,0.55%
2515609,2503,Agreste Paraibano,25016,Guarabira,Serra da Raiz,PB,3021,3532,3703,3436,3130,3204,1594,1610,2135,1069,-0.70%
2515708,2501,Sertão Paraibano,25006,Itaporanga,Serra Grande,PB,2540,2591,2598,2855,3038,2975,1502,1473,1776,1199,0.41%
2515807,2503,Agreste Paraibano,25017,Campina Grande,Serra Redonda,PB,7379,7316,7305,7307,7651,7054,3361,3693,3611,3443,-0.35%
2515906,2503,Agreste Paraibano,25015,Brejo Paraibano,Serraria,PB,11997,11036,9561,6678,6602,6238,3093,3145,3467,2771,-0.68%
2515930,2503,Agreste Paraibano,25016,Guarabira,Sertãozinho,PB,,,,3444,4213,4395,2143,2252,3215,1180,2.47%
2515971,2504,Mata Paraibana,25021,Sapé,Sobrado,PB,,,,6885,7340,7363,3674,3689,883,6480,0.67%
2516003,2503,Agreste Paraibano,25013,Curimataú Oriental,Solânea,PB,25699,30365,32732,30658,27346,26689,12760,13929,19332,7357,-1.38%
2516102,2503,Agreste Paraibano,25012,Curimataú Ocidental,Soledade,PB,7612,9128,11175,12061,13128,13739,6770,6969,10231,3508,1.31%
2516151,2503,Agreste Paraibano,25012,Curimataú Ocidental,Sossêgo,PB,,,,2598,2965,3173,1582,1591,1586,1587,2.02%
2516201,2501,Sertão Paraibano,25003,Sousa,Sousa,PB,62049,72887,79135,62635,63783,65807,31799,34008,51885,13922,0.50%
2516300,2502,Borborema,25010,Cariri Ocidental,Sumé,PB,15532,16801,17230,15035,16456,16072,7931,8141,12240,3832,0.67%
2516409,2503,Agreste Paraibano,25013,Curimataú Oriental,Campo de Santana,PB,11199,12328,10407,9388,9549,10263,5159,5104,4371,5892,0.90%
2516508,2502,Borborema,25010,Cariri Ocidental,Taperoá,PB,12531,15167,15197,13299,14715,14938,7346,7592,8941,5997,1.17%
2516607,2501,Sertão Paraibano,25007,Serra do Teixeira,Tavares,PB,10834,13210,14342,13584,14021,14103,7034,7069,6616,7487,0.38%
2516706,2501,Sertão Paraibano,25007,Serra do Teixeira,Teixeira,PB,14182,16133,17552,11953,13685,14153,6934,7219,9631,4522,1.70%
2516755,2502,Borborema,25009,Seridó Oriental Paraibano,Tenório,PB,,,,2473,2806,2816,1468,1348,1676,1140,1.31%
2516805,2501,Sertão Paraibano,25002,Cajazeiras,Triunfo,PB,8100,9521,10606,9053,9624,9223,4573,4650,4312,4911,0.19%
2516904,2501,Sertão Paraibano,25002,Cajazeiras,Uiraúna,PB,19577,20607,20133,13681,14454,14584,7014,7570,10349,4235,0.64%
2517001,2503,Agreste Paraibano,25019,Umbuzeiro,Umbuzeiro,PB,16272,17119,17362,9192,9173,9300,4508,4792,3986,5314,0.12%
2517100,2502,Borborema,25008,Seridó Ocidental Paraibano,Várzea,PB,2924,2656,2211,2051,2457,2504,1268,1236,1835,669,2.02%
2517209,2501,Sertão Paraibano,25003,Sousa,Vieirópolis,PB,,,,4672,4756,5045,2538,2507,996,4049,0.77%
2517407,2502,Borborema,25010,Cariri Ocidental,Zabelê,PB,,,,1853,2024,2075,1052,1023,1472,603,1.14%
2600054,2605,Metropolitana de Recife,26017,Recife,Abreu e Lima,PE,,,77035,89039,92217,94428,45165,49263,86589,7839,0.59%
2600104,2601,Sertão Pernambucano,26003,Pajeú,Afogados da Ingazeira,PE,19623,24489,29617,32922,34047,35091,16790,18301,27406,7685,0.64%
2600203,2602,São Francisco Pernambucano,26005,Petrolina,Afrânio,PE,9337,11491,13305,15014,16471,17588,8751,8837,5859,11729,1.59%
2600302,2603,Agreste Pernambucano,26012,Brejo Pernambucano,Agrestina,PE,17068,15573,17993,20036,21456,22680,10938,11742,16955,5725,1.25%
2600401,2604,Mata Pernambucana,26015,Mata Meridional Pernambucana,Água Preta,PE,34826,37009,36609,28531,29508,33046,16581,16465,18708,14338,1.48%
2600500,2603,Agreste Pernambucano,26007,Vale do Ipanema,Águas Belas,PE,25581,36647,38355,36641,37992,40007,19545,20462,24300,15707,0.88%
2600609,2603,Agreste Pernambucano,26008,Vale do Ipojuca,Alagoinha,PE,9383,10257,11068,12535,14016,13761,6906,6855,7770,5991,0.94%
2600708,2604,Mata Pernambucana,26013,Mata Setentrional Pernambucana,Aliança,PE,35057,37654,37455,37189,34740,37414,18579,18835,20249,17165,0.06%
2600807,2603,Agreste Pernambucano,26012,Brejo Pernambucano,Altinho,PE,28754,24765,23144,22131,21782,22363,11114,11249,12781,9582,0.10%
2600906,2604,Mata Pernambucana,26015,Mata Meridional Pernambucana,Amaraji,PE,16001,19397,19997,21309,20149,21925,10982,10943,16033,5892,0.29%
2601003,2603,Agreste Pernambucano,26011,Garanhuns,Angelim,PE,9761,9284,8734,9082,9836,10204,5019,5185,6089,4115,1.17%
2601052,2605,Metropolitana de Recife,26016,Itamaracá,Araçoiaba,PE,,,,15108,16520,18144,9014,9130,15261,2883,1.85%
2601102,2601,Sertão Pernambucano,26001,Araripina,Araripina,PE,38919,47920,60585,70898,75878,77363,37884,39479,46975,30388,0.88%
2601201,2601,Sertão Pernambucano,26004,Sertão do Moxotó,Arcoverde,PE,40162,47205,55776,61600,64863,69157,32563,36594,62899,6258,1.16%
2601300,2603,Agreste Pernambucano,26012,Brejo Pernambucano,Barra de Guabiraba,PE,7792,10016,10520,10939,12694,12765,6506,6259,11379,1386,1.56%
2601409,2604,Mata Pernambucana,26015,Mata Meridional Pernambucana,Barreiros,PE,28892,32446,40569,39139,41748,40720,19881,20839,33969,6751,0.40%
2601508,2604,Mata Pernambucana,26015,Mata Meridional Pernambucana,Belém de Maria,PE,12638,10979,12204,10626,9649,11349,5637,5712,7988,3361,0.66%
2601607,2602,São Francisco Pernambucano,26006,Itaparica,Belém do São Francisco,PE,17785,24155,23002,20208,20545,20236,9944,10292,12582,7654,0.01%
2601706,2603,Agreste Pernambucano,26008,Vale do Ipojuca,Belo Jardim,PE,45361,51702,60658,68698,70963,72412,34765,37647,58208,14204,0.53%
2601805,2601,Sertão Pernambucano,26004,Sertão do Moxotó,Betânia,PE,10329,11858,11226,11305,11548,12005,6014,5991,3709,8296,0.60%
2601904,2603,Agreste Pernambucano,26008,Vale do Ipojuca,Bezerros,PE,44289,48824,52134,57371,56629,58675,28051,30624,49747,8928,0.23%
2602001,2601,Sertão Pernambucano,26001,Araripina,Bodocó,PE,22121,25806,28507,31731,33381,35178,17643,17535,12836,22342,1.04%
2602100,2603,Agreste Pernambucano,26011,Garanhuns,Bom Conselho,PE,43933,43644,41177,42085,43397,45506,22010,23496,29782,15724,0.78%
2602209,2603,Agreste Pernambucano,26010,Médio Capibaribe,Bom Jardim,PE,35249,34922,36798,37013,39023,37828,18461,19367,15191,22637,0.22%
2602308,2603,Agreste Pernambucano,26012,Brejo Pernambucano,Bonito,PE,33438,33079,35043,37750,39111,37570,18575,18995,26210,11360,-0.05%
2602407,2603,Agreste Pernambucano,26011,Garanhuns,Brejão,PE,9929,8733,8707,8916,9341,8851,4338,4513,3571,5280,-0.07%
2602506,2601,Sertão Pernambucano,26003,Pajeú,Brejinho,PE,7394,7053,7403,7278,7158,7307,3608,3699,3386,3921,0.04%
2602605,2603,Agreste Pernambucano,26008,Vale do Ipojuca,Brejo da Madre de Deus,PE,25682,24768,31206,38109,40265,45192,22150,23042,35135,10057,1.72%
2602704,2604,Mata Pernambucana,26013,Mata Setentrional Pernambucana,Buenos Aires,PE,12028,12265,12462,12007,12962,12537,6197,6340,7917,4620,0.43%
2602803,2603,Agreste Pernambucano,26007,Vale do Ipanema,Buíque,PE,33405,36365,38123,44169,49937,51990,25572,26418,21121,30869,1.64%
2602902,2605,Metropolitana de Recife,26018,Suape,Cabo de Santo Agostinho,PE,75829,104155,127036,152977,163139,185123,90887,94236,167830,17293,1.93%
2603009,2602,São Francisco Pernambucano,26005,Petrolina,Cabrobó,PE,19522,20863,23965,26741,28851,30883,15060,15823,19811,11072,1.45%
2603108,2603,Agreste Pernambucano,26008,Vale do Ipojuca,Cachoeirinha,PE,13512,13443,15852,17042,17421,18833,9110,9723,15221,3612,1.00%
2603207,2603,Agreste Pernambucano,26011,Garanhuns,Caetés,PE,16891,17563,20626,24137,25219,26577,13172,13405,7520,19057,0.97%
2603306,2603,Agreste Pernambucano,26011,Garanhuns,Calçado,PE,8467,8498,9424,11709,11337,11125,5566,5559,3810,7315,-0.51%
2603405,2601,Sertão Pernambucano,26003,Pajeú,Calumbi,PE,4993,5710,6878,7079,7577,5651,2723,2928,2181,3470,-2.23%
2603454,2605,Metropolitana de Recife,26017,Recife,Camaragibe,PE,,,99407,128702,136381,144506,69237,75269,144506,0,1.16%
2603504,2603,Agreste Pernambucano,26012,Brejo Pernambucano,Camocim de São Félix,PE,9927,10860,13827,15115,15831,17104,8323,8781,14329,2775,1.24%
2603603,2604,Mata Pernambucana,26013,Mata Setentrional Pernambucana,Camutanga,PE,6437,7256,7488,7844,7921,8147,4081,4066,6525,1622,0.38%
2603702,2603,Agreste Pernambucano,26011,Garanhuns,Canhotinho,PE,27117,26379,24576,24920,24218,24536,12375,12161,14121,10415,-0.16%
2603801,2603,Agreste Pernambucano,26008,Vale do Ipojuca,Capoeiras,PE,18035,18739,19577,19556,19337,19593,9772,9821,6263,13330,0.02%
2603900,2601,Sertão Pernambucano,26003,Pajeú,Carnaíba,PE,21951,25468,25931,17696,18345,18585,9170,9415,7633,10952,0.49%
2603926,2602,São Francisco Pernambucano,26006,Itaparica,Carnaubeira da Penha,PE,,,,10404,11689,11782,6001,5781,1982,9800,1.25%
2604007,2604,Mata Pernambucana,26013,Mata Setentrional Pernambucana,Carpina,PE,45790,57343,66078,63811,65390,74851,35540,39311,72061,2790,1.61%
2604106,2603,Agreste Pernambucano,26008,Vale do Ipojuca,Caruaru,PE,142653,172532,213697,253634,289086,314951,149146,165805,278098,36853,2.19%
2604155,2603,Agreste Pernambucano,26009,Alto Capibaribe,Casinhas,PE,,,,13345,14103,13791,6813,6978,1688,12103,0.33%
2604205,2604,Mata Pernambucana,26015,Mata Meridional Pernambucana,Catende,PE,28198,28158,31519,31257,33479,37830,18305,19525,28877,8953,1.93%
2604304,2601,Sertão Pernambucano,26002,Salgueiro,Cedro,PE,4667,6507,9005,9551,10240,10778,5391,5387,6291,4487,1.22%
2604403,2604,Mata Pernambucana,26014,Vitória de Santo Antão,Chã de Alegria,PE,8098,9305,10899,11102,11636,12375,6078,6297,9515,2860,1.09%
2604502,2604,Mata Pernambucana,26014,Vitória de Santo Antão,Chã Grande,PE,13949,14414,15499,18407,17563,20020,9910,10110,13670,6350,0.84%
2604601,2604,Mata Pernambucana,26013,Mata Setentrional Pernambucana,Condado,PE,12256,16216,18450,21797,23211,24298,11850,12448,22657,1641,1.09%
2604700,2603,Agreste Pernambucano,26011,Garanhuns,Correntes,PE,20670,18006,16218,17044,16330,17421,8609,8812,10329,7092,0.22%
2604809,2604,Mata Pernambucana,26015,Mata Meridional Pernambucana,Cortês,PE,10168,11176,12415,12681,11616,12458,6186,6272,7905,4553,-0.18%
2604908,2603,Agreste Pernambucano,26010,Médio Capibaribe,Cumaru,PE,17449,22402,18004,27489,16388,17166,8506,8660,8032,9134,-4.60%
2605004,2603,Agreste Pernambucano,26012,Brejo Pernambucano,Cupira,PE,14539,18531,22701,22383,22106,23392,11043,12349,20790,2602,0.44%
2605103,2601,Sertão Pernambucano,26004,Sertão do Moxotó,Custódia,PE,20711,26823,28849,29969,32157,34305,16850,17455,21947,12358,1.36%
2605152,2602,São Francisco Pernambucano,26005,Petrolina,Dormentes,PE,,,,14411,15595,16915,8655,8260,6004,10911,1.61%
2605202,2604,Mata Pernambucana,26015,Mata Meridional Pernambucana,Escada,PE,43372,53167,55841,57341,59850,63535,31151,32384,53985,9550,1.03%
2605301,2601,Sertão Pernambucano,26001,Araripina,Exu,PE,30551,33316,31941,32423,30567,31636,15485,16151,16303,15333,-0.25%
2605400,2603,Agreste Pernambucano,26010,Médio Capibaribe,Feira Nova,PE,15207,17071,18526,18857,19276,20588,9980,10608,16329,4259,0.88%
2605459,2605,Metropolitana de Recife,26019,Fernando de Noronha,Fernando de Noronha,PE,1241,1274,1686,2051,2801,2629,1294,1335,2629,0,2.51%
2605509,2604,Mata Pernambucana,26013,Mata Setentrional Pernambucana,Ferreiros,PE,9572,10481,10927,10727,11002,11437,5656,5781,9169,2268,0.64%
2605608,2601,Sertão Pernambucano,26003,Pajeú,Flores,PE,20946,22408,21810,20823,21962,22171,10939,11232,9364,12807,0.63%
2605707,2602,São Francisco Pernambucano,26006,Itaparica,Floresta,PE,28163,32235,32336,24729,26648,29284,14427,14857,19972,9312,1.71%
2605806,2603,Agreste Pernambucano,26009,Alto Capibaribe,Frei Miguelinho,PE,13952,13749,14099,12978,14067,14231,6963,7268,3383,10848,0.93%
2605905,2604,Mata Pernambucana,26015,Mata Meridional Pernambucana,Gameleira,PE,14890,16951,19641,24003,26281,27915,14104,13811,19504,8411,1.52%
2606002,2603,Agreste Pernambucano,26011,Garanhuns,Garanhuns,PE,71623,87038,103341,117749,124996,129392,60962,68430,115344,14048,0.95%
2606101,2604,Mata Pernambucana,26014,Vitória de Santo Antão,Glória do Goitá,PE,28697,27223,26808,27554,27397,29675,14503,15172,15631,14044,0.74%
2606200,2604,Mata Pernambucana,26013,Mata Setentrional Pernambucana,Goiana,PE,51588,57799,64150,71177,71796,75648,36651,38997,58045,17603,0.61%
2606309,2601,Sertão Pernambucano,26001,Araripina,Granito,PE,3785,5203,5947,6110,6593,6857,3453,3404,3178,3679,1.16%
2606408,2603,Agreste Pernambucano,26008,Vale do Ipojuca,Gravatá,PE,49366,52499,61485,67273,71570,76669,37032,39637,68389,8280,1.32%
2606507,2603,Agreste Pernambucano,26011,Garanhuns,Iati,PE,13140,18567,18586,17691,17733,18271,9124,9147,7718,10553,0.32%
2606606,2601,Sertão Pernambucano,26004,Sertão do Moxotó,Ibimirim,PE,12736,17322,28101,24340,27261,26959,13336,13623,14897,12062,1.03%
2606705,2603,Agreste Pernambucano,26012,Brejo Pernambucano,Ibirajuba,PE,10950,8530,7548,7438,7545,7534,3791,3743,3140,4394,0.13%
2606804,2605,Metropolitana de Recife,26016,Itamaracá,Igarassu,PE,55079,73254,79837,82277,93748,101987,49313,52674,93888,8099,2.17%
2606903,2601,Sertão Pernambucano,26003,Pajeú,Iguaraci,PE,10934,11723,11239,11486,11880,11780,5915,5865,6112,5668,0.25%
2607000,2601,Sertão Pernambucano,26004,Sertão do Moxotó,Inajá,PE,13575,19179,23198,13280,14036,19081,9554,9527,7958,11123,3.69%
2607109,2601,Sertão Pernambucano,26003,Pajeú,Ingazeira,PE,3940,4547,4430,4567,4444,4496,2290,2206,2456,2040,-0.16%
2607208,2605,Metropolitana de Recife,26018,Suape,Ipojuca,PE,35851,39452,45424,59281,70070,80542,39840,40702,59640,20902,3.11%
2607307,2601,Sertão Pernambucano,26001,Araripina,Ipubi,PE,15040,18229,21231,23042,25718,28120,13850,14270,17284,10836,2.01%
2607406,2602,São Francisco Pernambucano,26006,Itaparica,Itacuruba,PE,3662,4410,3248,3669,4097,4369,2132,2237,3708,661,1.76%
2607505,2603,Agreste Pernambucano,26007,Vale do Ipanema,Itaíba,PE,22701,28348,27142,26799,26735,26264,13039,13225,9651,16613,-0.20%
2607604,2605,Metropolitana de Recife,26016,Itamaracá,Ilha de Itamaracá,PE,7117,8254,11606,15858,17573,22449,12861,9588,17521,4928,3.54%
2607653,2604,Mata Pernambucana,26013,Mata Setentrional Pernambucana,Itambé,PE,25083,28157,34250,34982,34944,35398,17484,17914,29424,5974,0.12%
2607703,2601,Sertão Pernambucano,26003,Pajeú,Itapetim,PE,15148,15910,15658,14766,13849,13882,6852,7030,8427,5455,-0.62%
2607752,2605,Metropolitana de Recife,26016,Itamaracá,Itapissuma,PE,,,16408,20116,22852,23723,11944,11779,18401,5322,1.66%
2607802,2604,Mata Pernambucana,26013,Mata Setentrional Pernambucana,Itaquitinga,PE,9294,10985,14027,14950,14985,15698,7885,7813,12065,3633,0.49%
2607901,2605,Metropolitana de Recife,26017,Recife,Jaboatão dos Guararapes,PE,200975,330416,487119,581556,665387,644699,304840,339859,630683,14016,1.04%
2607950,2604,Mata Pernambucana,26015,Mata Meridional Pernambucana,Jaqueira,PE,,,,11653,12102,11513,5719,5794,7089,4424,-0.12%
2608008,2603,Agreste Pernambucano,26008,Vale do Ipojuca,Jataúba,PE,14606,13547,14450,14653,14813,15810,7848,7962,9181,6629,0.76%
2608057,2602,São Francisco Pernambucano,26006,Itaparica,Jatobá,PE,,,,13148,13797,13982,6847,7135,6097,7885,0.62%
2608107,2603,Agreste Pernambucano,26010,Médio Capibaribe,João Alfredo,PE,24025,25264,27419,27023,28488,30735,14869,15866,15015,15720,1.30%
2608206,2604,Mata Pernambucana,26015,Mata Meridional Pernambucana,Joaquim Nabuco,PE,12391,14335,15702,15925,15947,15774,7902,7872,11507,4267,-0.10%
2608255,2603,Agreste Pernambucano,26011,Garanhuns,Jucati,PE,,,,9695,10500,10604,5272,5332,2828,7776,0.90%
2608305,2603,Agreste Pernambucano,26011,Garanhuns,Jupi,PE,17216,17828,19865,12329,13628,13709,6686,7023,8360,5349,1.07%
2608404,2603,Agreste Pernambucano,26011,Garanhuns,Jurema,PE,11952,12283,12688,13741,14760,14494,7098,7396,8748,5746,0.53%
2608453,2604,Mata Pernambucana,26013,Mata Setentrional Pernambucana,Lagoa do Carro,PE,,,,13110,14380,15990,7827,8163,11614,4376,2.01%
2608503,2604,Mata Pernambucana,26013,Mata Setentrional Pernambucana,Lagoa de Itaenga,PE,11110,12720,16508,20172,19987,20653,10071,10582,17112,3541,0.24%
2608602,2603,Agreste Pernambucano,26011,Garanhuns,Lagoa do Ouro,PE,13994,12812,11375,10977,11655,12121,5959,6162,6018,6103,1.00%
2608701,2603,Agreste Pernambucano,26012,Brejo Pernambucano,Lagoa dos Gatos,PE,19141,18409,16762,16100,15967,15615,7825,7790,8641,6974,-0.31%
2608750,2602,São Francisco Pernambucano,26005,Petrolina,Lagoa Grande,PE,,,,19137,21125,22719,11295,11424,10369,12350,1.73%
2608800,2603,Agreste Pernambucano,26011,Garanhuns,Lajedo,PE,21478,25687,29718,32209,33348,36606,17410,19196,26391,10215,1.29%
2608909,2603,Agreste Pernambucano,26010,Médio Capibaribe,Limoeiro,PE,57278,57154,54860,56322,55560,55574,26870,28704,44691,10883,-0.13%
2609006,2604,Mata Pernambucana,26013,Mata Setentrional Pernambucana,Macaparana,PE,16668,18681,20854,22494,23078,23907,11661,12246,14817,9090,0.61%
2609105,2603,Agreste Pernambucano,26010,Médio Capibaribe,Machados,PE,8018,8864,9021,9826,11152,13632,6565,7067,8481,5151,3.33%
2609154,2601,Sertão Pernambucano,26004,Sertão do Moxotó,Manari,PE,,,,13028,16540,18187,9197,8990,3844,14343,3.39%
2609204,2604,Mata Pernambucana,26015,Mata Meridional Pernambucana,Maraial,PE,20606,19571,21491,14017,12352,12257,6179,6078,8584,3673,-1.33%
2609303,2601,Sertão Pernambucano,26002,Salgueiro,Mirandiba,PE,9693,11911,12867,13122,13304,14308,7116,7192,7141,7167,0.87%
2609402,2605,Metropolitana de Recife,26017,Recife,Moreno,PE,31204,34943,39132,49205,52830,56767,27722,29045,50250,6517,1.44%
2609501,2604,Mata Pernambucana,26013,Mata Setentrional Pernambucana,Nazaré da Mata,PE,23742,25448,26539,29254,29202,30782,14735,16047,27177,3605,0.51%
2609600,2605,Metropolitana de Recife,26017,Recife,Olinda,PE,196342,282207,341394,367902,391433,375559,173654,201905,368119,7440,0.21%
2609709,2603,Agreste Pernambucano,26010,Médio Capibaribe,Orobó,PE,19601,20603,20877,22475,21632,22865,11058,11807,8216,14649,0.17%
2609808,2602,São Francisco Pernambucano,26005,Petrolina,Orocó,PE,5285,7087,10731,10825,13167,13176,6561,6615,4614,8562,1.98%
2609907,2601,Sertão Pernambucano,26001,Araripina,Ouricuri,PE,50167,63949,73526,56733,63042,64335,31688,32647,32577,31758,1.27%
2610004,2604,Mata Pernambucana,26015,Mata Meridional Pernambucana,Palmares,PE,50995,58430,57731,55790,56643,59524,28802,30722,46880,12644,0.65%
2610103,2603,Agreste Pernambucano,26011,Garanhuns,Palmeirina,PE,10165,9497,8311,9536,8487,8188,3985,4203,5178,3010,-1.51%
2610202,2603,Agreste Pernambucano,26012,Brejo Pernambucano,Panelas,PE,30610,28737,26666,25874,24918,25654,12595,13059,13966,11688,-0.09%
2610301,2603,Agreste Pernambucano,26011,Garanhuns,Paranatama,PE,13554,11671,11415,10348,11669,11001,5506,5495,2238,8763,0.61%
2610400,2601,Sertão Pernambucano,26002,Salgueiro,Parnamirim,PE,13066,15244,18746,19289,19214,20227,10281,9946,8380,11847,0.48%
2610509,2603,Agreste Pernambucano,26010,Médio Capibaribe,Passira,PE,21929,25661,29135,29132,27910,28664,14004,14660,13956,14708,-0.16%
2610608,2604,Mata Pernambucana,26013,Mata Setentrional Pernambucana,Paudalho,PE,32741,36770,39608,45138,45777,51374,25216,26158,36953,14421,1.30%
2610707,2605,Metropolitana de Recife,26017,Recife,Paulista,PE,70059,165743,211491,262237,307284,300611,141718,158893,300611,0,1.38%
2610806,2603,Agreste Pernambucano,26007,Vale do Ipanema,Pedra,PE,17680,19730,19614,20244,20132,20950,10475,10475,12008,8942,0.34%
2610905,2603,Agreste Pernambucano,26008,Vale do Ipojuca,Pesqueira,PE,49687,52281,57622,57721,61337,62793,30547,32246,45026,17767,0.85%
2611002,2602,São Francisco Pernambucano,26006,Itaparica,Petrolândia,PE,14499,23703,32963,27320,30597,32485,15945,16540,23615,8870,1.75%
2611101,2602,São Francisco Pernambucano,26005,Petrolina,Petrolina,PE,61252,104297,175406,218538,268339,294081,143283,150798,219309,74772,3.01%
2611200,2603,Agreste Pernambucano,26008,Vale do Ipojuca,Poção,PE,8081,9065,9584,11178,11135,11242,5375,5867,6988,4254,0.06%
2611309,2604,Mata Pernambucana,26014,Vitória de Santo Antão,Pombos,PE,22899,20915,21250,23351,21810,24033,11871,12162,16006,8027,0.29%
2611408,2604,Mata Pernambucana,26015,Mata Meridional Pernambucana,Primavera,PE,8627,8437,10854,11477,11853,13439,6882,6557,8579,4860,1.59%
2611507,2604,Mata Pernambucana,26015,Mata Meridional Pernambucana,Quipapá,PE,19568,19964,21132,22145,24197,24187,11929,12258,11834,12353,0.89%
2611533,2601,Sertão Pernambucano,26003,Pajeú,Quixaba,PE,,,,6855,6875,6735,3322,3413,2491,4244,-0.18%
2611606,2605,Metropolitana de Recife,26017,Recife,Recife,PE,1060701,1203887,1298229,1422905,1533580,1536934,709063,827871,1536934,0,0.77%
2611705,2603,Agreste Pernambucano,26008,Vale do Ipojuca,Riacho das Almas,PE,16222,17119,17941,18142,18269,19158,9414,9744,8779,10379,0.55%
2611804,2604,Mata Pernambucana,26015,Mata Meridional Pernambucana,Ribeirão,PE,31009,36346,41022,41449,38755,44445,21737,22708,34009,10436,0.70%
2611903,2604,Mata Pernambucana,26015,Mata Meridional Pernambucana,Rio Formoso,PE,28655,31358,33833,20764,21024,22140,11115,11025,13368,8772,0.64%
2612000,2603,Agreste Pernambucano,26012,Brejo Pernambucano,Sairé,PE,17235,14093,11113,13649,13709,11242,5534,5708,6305,4937,-1.92%
2612109,2603,Agreste Pernambucano,26010,Médio Capibaribe,Salgadinho,PE,5460,5559,5923,7139,7770,9287,4670,4617,3062,6225,2.67%
2612208,2601,Sertão Pernambucano,26002,Salgueiro,Salgueiro,PE,31314,40439,47211,51571,53167,56641,27611,29030,45718,10923,0.94%
2612307,2603,Agreste Pernambucano,26011,Garanhuns,Saloá,PE,15829,15681,14837,15006,15027,15283,7375,7908,7659,7624,0.18%
2612406,2603,Agreste Pernambucano,26008,Vale do Ipojuca,Sanharó,PE,13570,14263,15024,15879,17627,21960,10757,11203,12492,9468,3.30%
2612455,2601,Sertão Pernambucano,26001,Araripina,Santa Cruz,PE,,,,11264,13644,13594,6815,6779,4453,9141,1.90%
2612471,2601,Sertão Pernambucano,26003,Pajeú,Santa Cruz da Baixa Verde,PE,,,,10893,11610,11769,5812,5957,5277,6492,0.78%
2612505,2603,Agreste Pernambucano,26009,Alto Capibaribe,Santa Cruz do Capibaribe,PE,11685,21104,38332,59048,73680,87538,42335,45203,85562,1976,4.02%
2612554,2601,Sertão Pernambucano,26001,Araripina,Santa Filomena,PE,,,,12115,13759,13322,6725,6597,2226,11096,0.95%
2612604,2602,São Francisco Pernambucano,26005,Petrolina,Santa Maria da Boa Vista,PE,18837,23876,42006,36914,39626,39473,19865,19608,14861,24612,0.67%
2612703,2603,Agreste Pernambucano,26009,Alto Capibaribe,Santa Maria do Cambucá,PE,9724,10453,11415,11739,12348,13023,6474,6549,3277,9746,1.04%
2612802,2601,Sertão Pernambucano,26003,Pajeú,Santa Terezinha,PE,7848,9508,9748,10251,9934,10991,5385,5606,6876,4115,0.70%
2612901,2604,Mata Pernambucana,26015,Mata Meridional Pernambucana,São Benedito do Sul,PE,11048,10543,9885,10477,9790,13939,7015,6924,7156,6783,2.90%
2613008,2603,Agreste Pernambucano,26008,Vale do Ipojuca,São Bento do Una,PE,33514,37587,42236,45360,47230,53232,26568,26664,28007,25225,1.61%
2613107,2603,Agreste Pernambucano,26008,Vale do Ipojuca,São Caetano,PE,23933,24601,29598,33426,34769,35278,17209,18069,27081,8197,0.54%
2613206,2603,Agreste Pernambucano,26011,Garanhuns,São João,PE,16323,17668,18912,19744,21011,21305,10440,10865,9661,11644,0.76%
2613305,2603,Agreste Pernambucano,26012,Brejo Pernambucano,São Joaquim do Monte,PE,20064,18214,17291,19842,20869,20489,10197,10292,14122,6367,0.32%
2613404,2604,Mata Pernambucana,26015,Mata Meridional Pernambucana,São José da Coroa Grande,PE,8292,9639,11533,13971,17090,18172,8865,9307,13429,4743,2.66%
2613503,2601,Sertão Pernambucano,26002,Salgueiro,São José do Belmonte,PE,23101,29258,31015,31652,32704,32620,16243,16377,16168,16452,0.30%
2613602,2601,Sertão Pernambucano,26003,Pajeú,São José do Egito,PE,23607,26155,28676,29468,30469,31838,15522,16316,20968,10870,0.78%
2613701,2605,Metropolitana de Recife,26017,Recife,São Lourenço da Mata,PE,94016,144142,85861,90402,95304,102956,50032,52924,96812,6144,1.31%
2613800,2603,Agreste Pernambucano,26010,Médio Capibaribe,São Vicente Ferrer,PE,12248,12908,14172,16004,16598,17000,8364,8636,11205,5795,0.61%
2613909,2601,Sertão Pernambucano,26003,Pajeú,Serra Talhada,PE,55774,67156,72341,70912,76198,79241,37831,41410,61288,17953,1.12%
2614006,2601,Sertão Pernambucano,26002,Salgueiro,Serrita,PE,16383,18289,19009,17848,18228,18331,9199,9132,6356,11975,0.27%
2614105,2601,Sertão Pernambucano,26004,Sertão do Moxotó,Sertânia,PE,31373,32480,31510,31657,34069,33723,16480,17243,18548,15175,0.63%
2614204,2604,Mata Pernambucana,26015,Mata Meridional Pernambucana,Sirinhaém,PE,24806,29061,33258,33046,36414,40306,20350,19956,21473,18833,2.01%
2614303,2601,Sertão Pernambucano,26001,Araripina,Moreilândia,PE,10329,12248,11879,11116,10424,11137,5595,5542,6843,4294,0.02%
2614402,2601,Sertão Pernambucano,26003,Pajeú,Solidão,PE,5516,6178,5779,5532,5837,5744,2902,2842,1831,3913,0.38%
2614501,2603,Agreste Pernambucano,26009,Alto Capibaribe,Surubim,PE,52275,61030,67572,50331,53934,58444,27931,30513,44004,14440,1.51%
2614600,2601,Sertão Pernambucano,26003,Pajeú,Tabira,PE,16245,19405,22726,24065,25836,26430,12969,13461,19772,6658,0.94%
2614709,2603,Agreste Pernambucano,26008,Vale do Ipojuca,Tacaimbó,PE,9626,9896,11675,12929,12095,12704,6261,6443,7076,5628,-0.18%
2614808,2602,São Francisco Pernambucano,26006,Itaparica,Tacaratu,PE,12948,14540,17352,17096,20552,22073,11162,10911,9197,12876,2.59%
2614857,2604,Mata Pernambucana,26015,Mata Meridional Pernambucana,Tamandaré,PE,,,,17281,18137,20745,10425,10320,15186,5559,1.84%
2615003,2603,Agreste Pernambucano,26009,Alto Capibaribe,Taquaritinga do Norte,PE,14492,14899,17093,19757,21447,24923,12348,12575,17977,6946,2.35%
2615102,2603,Agreste Pernambucano,26011,Garanhuns,Terezinha,PE,8053,7016,6789,6300,6496,6737,3271,3466,2860,3877,0.67%
2615201,2602,São Francisco Pernambucano,26005,Petrolina,Terra Nova,PE,4071,5216,6677,7518,9057,9256,4702,4554,5015,4241,2.10%
2615300,2604,Mata Pernambucana,26013,Mata Setentrional Pernambucana,Timbaúba,PE,52077,54513,57256,56906,51529,53823,25906,27917,46371,7452,-0.56%
2615409,2603,Agreste Pernambucano,26009,Alto Capibaribe,Toritama,PE,6382,8616,14907,21800,29897,35631,17473,18158,34198,1433,5.04%
2615508,2604,Mata Pernambucana,26013,Mata Setentrional Pernambucana,Tracunhaém,PE,11249,11197,11934,12394,12734,13055,6363,6692,10969,2086,0.52%
2615607,2601,Sertão Pernambucano,26001,Araripina,Trindade,PE,9112,13082,18799,21930,24642,26116,12889,13227,22463,3653,1.76%
2615706,2601,Sertão Pernambucano,26003,Pajeú,Triunfo,PE,24849,26793,27674,15135,15225,15006,7180,7826,7944,7062,-0.09%
2615805,2603,Agreste Pernambucano,26007,Vale do Ipanema,Tupanatinga,PE,16456,18649,19148,20801,18913,24254,12022,12232,8496,15758,1.55%
2615904,2601,Sertão Pernambucano,26003,Pajeú,Tuparetama,PE,5747,5473,7110,7766,8257,7925,3852,4073,6351,1574,0.20%
2616001,2603,Agreste Pernambucano,26007,Vale do Ipanema,Venturosa,PE,8708,10070,12070,13462,15576,16064,7869,8195,10351,5713,1.78%
2616100,2601,Sertão Pernambucano,26002,Salgueiro,Verdejante,PE,7395,7713,8132,8846,9567,9142,4484,4658,2692,6450,0.33%
2616183,2603,Agreste Pernambucano,26009,Alto Capibaribe,Vertente do Lério,PE,,,,8536,7500,7894,3878,4016,1813,6081,-0.78%
2616209,2603,Agreste Pernambucano,26009,Alto Capibaribe,Vertentes,PE,13285,16565,14256,14957,17021,18267,8976,9291,12978,5289,2.02%
2616308,2604,Mata Pernambucana,26013,Mata Setentrional Pernambucana,Vicência,PE,25270,26021,28018,28820,27360,30731,15194,15537,13805,16926,0.64%
2616407,2604,Mata Pernambucana,26014,Vitória de Santo Antão,Vitória de Santo Antão,PE,80537,93198,106848,117609,121233,130540,62685,67855,113481,17059,1.05%
2616506,2604,Mata Pernambucana,26015,Mata Meridional Pernambucana,Xexéu,PE,,,,13597,14224,14092,6996,7096,9165,4927,0.36%
2200053,2204,Sudeste Piauiense,22015,Alto Médio Canindé,Acauã,PI,,,,5147,6300,6749,3459,3290,901,5848,2.75%
2200103,2202,Centro-Norte Piauiense,22005,Médio Parnaíba Piauiense,Agricolândia,PI,3105,4477,5720,5340,4980,5114,2467,2647,3617,1497,-0.43%
2200202,2202,Centro-Norte Piauiense,22005,Médio Parnaíba Piauiense,Água Branca,PI,10085,15003,16191,14517,15887,16461,7813,8648,14549,1912,1.26%
2200251,2204,Sudeste Piauiense,22014,Pio IX,Alagoinha do Piauí,PI,,,8074,6868,7447,7349,3687,3662,2669,4680,0.68%
2200277,2204,Sudeste Piauiense,22014,Pio IX,Alegrete do Piauí,PI,,,,4713,4482,5151,2556,2595,2837,2314,0.89%
2200301,2202,Centro-Norte Piauiense,22004,Campo Maior,Alto Longá,PI,16176,17755,15581,12000,13612,13654,6966,6688,6714,6940,1.30%
2200400,2202,Centro-Norte Piauiense,22003,Teresina,Altos,PI,30334,33228,38853,39122,38328,38823,19114,19709,27391,11432,-0.08%
2200459,2203,Sudoeste Piauiense,22010,Alto Médio Gurguéia,Alvorada do Gurguéia,PI,,,,4211,4976,5051,2651,2400,1849,3202,1.84%
2200509,2202,Centro-Norte Piauiense,22005,Médio Parnaíba Piauiense,Amarante,PI,12796,14517,16528,16884,17316,17141,8331,8810,8775,8366,0.15%
2200608,2202,Centro-Norte Piauiense,22005,Médio Parnaíba Piauiense,Angical do Piauí,PI,4498,5322,6129,6788,6609,6670,3233,3437,5212,1458,-0.18%
2200707,2203,Sudoeste Piauiense,22011,São Raimundo Nonato,Anísio de Abreu,PI,5911,9285,10379,7166,8197,9094,4641,4453,4504,4590,2.41%
2200806,2203,Sudoeste Piauiense,22008,Bertolínia,Antônio Almeida,PI,3725,3393,4909,2851,3140,3046,1562,1484,2227,819,0.66%
2200905,2202,Centro-Norte Piauiense,22006,Valença do Piauí,Aroazes,PI,9913,9590,8919,6025,5857,5781,2866,2915,3432,2349,-0.41%
2200954,2204,Sudeste Piauiense,22013,Picos,Aroeiras do Itaim,PI,,,,,2654,2442,1274,1168,238,2204,-
2201002,2202,Centro-Norte Piauiense,22005,Médio Parnaíba Piauiense,Arraial,PI,3340,4691,5491,4909,5002,4688,2316,2372,2433,2255,-0.46%
2201051,2202,Centro-Norte Piauiense,22004,Campo Maior,Assunção do Piauí,PI,,,,6933,8011,7503,3825,3678,3378,4125,0.79%
2201101,2203,Sudoeste Piauiense,22012,Chapadas do Extremo Sul Piauiense,Avelino Lopes,PI,7676,10148,12005,9625,11507,11067,5581,5486,6714,4353,1.41%
2201150,2203,Sudoeste Piauiense,22007,Alto Parnaíba Piauiense,Baixa Grande do Ribeiro,PI,,,,7779,10232,10516,5466,5050,6487,4029,3.06%
2201176,2202,Centro-Norte Piauiense,22006,Valença do Piauí,Barra D'Alcântara,PI,,,,4107,3774,3852,1821,2031,2032,1820,-0.64%
2201200,2201,Norte Piauiense,22001,Baixo Parnaíba Piauiense,Barras,PI,38175,43672,50151,40891,43328,44850,22562,22288,22126,22724,0.93%
2201309,2203,Sudoeste Piauiense,22010,Alto Médio Gurguéia,Barreiras do Piauí,PI,2273,2960,4052,3098,3355,3234,1690,1544,1875,1359,0.43%
2201408,2202,Centro-Norte Piauiense,22005,Médio Parnaíba Piauiense,Barro Duro,PI,6035,6691,8448,6787,6661,6609,3231,3378,4789,1820,-0.27%
2201507,2201,Norte Piauiense,22001,Baixo Parnaíba Piauiense,Batalha,PI,19020,21473,22332,24127,25724,25786,13055,12731,9619,16167,0.67%
2201556,2204,Sudeste Piauiense,22015,Alto Médio Canindé,Bela Vista do Piauí,PI,,,,2963,3344,3778,1936,1842,1243,2535,2.46%
2201572,2204,Sudeste Piauiense,22015,Alto Médio Canindé,Belém do Piauí,PI,,,,2429,2788,3284,1682,1602,1603,1681,3.06%
2201606,2202,Centro-Norte Piauiense,22003,Teresina,Beneditinos,PI,11606,13365,12484,9712,9560,9911,5014,4897,6261,3650,0.20%
2201705,2203,Sudoeste Piauiense,22008,Bertolínia,Bertolínia,PI,6447,7445,8756,5117,5302,5319,2679,2640,3894,1425,0.39%
2201739,2204,Sudeste Piauiense,22015,Alto Médio Canindé,Betânia do Piauí,PI,,,,8640,9312,6015,3114,2901,1678,4337,-3.56%
2201770,2201,Norte Piauiense,22001,Baixo Parnaíba Piauiense,Boa Hora,PI,,,,5170,6086,6299,3204,3095,1524,4775,1.99%
2201804,2204,Sudeste Piauiense,22013,Picos,Bocaina,PI,3962,3786,3890,4208,4039,4346,2135,2211,1730,2616,0.32%
2201903,2203,Sudoeste Piauiense,22010,Alto Médio Gurguéia,Bom Jesus,PI,9977,14370,18126,15924,19532,22632,11306,11326,17627,5005,3.58%
2201919,2201,Norte Piauiense,22002,Litoral Piauiense,Bom Princípio do Piauí,PI,,,,4625,5276,5304,2747,2557,1654,3650,1.38%
2201929,2203,Sudoeste Piauiense,22011,São Raimundo Nonato,Bonfim do Piauí,PI,,,,4881,5185,5393,2695,2698,1635,3758,1.00%
2201945,2202,Centro-Norte Piauiense,22004,Campo Maior,Boqueirão do Piauí,PI,,,,5567,6325,6193,3080,3113,2666,3527,1.07%
2201960,2201,Norte Piauiense,22001,Baixo Parnaíba Piauiense,Brasileira,PI,,,,7366,7699,7961,4073,3888,3478,4483,0.78%
2201988,2203,Sudoeste Piauiense,22011,São Raimundo Nonato,Brejo do Piauí,PI,,,,3986,3181,3852,1946,1906,1426,2426,-0.34%
2202000,2201,Norte Piauiense,22002,Litoral Piauiense,Buriti dos Lopes,PI,25145,25823,31000,18598,19150,19074,9623,9451,10294,8780,0.25%
2202026,2202,Centro-Norte Piauiense,22004,Campo Maior,Buriti dos Montes,PI,,,,7284,7820,7977,4143,3834,2421,5556,0.91%
2202059,2201,Norte Piauiense,22001,Baixo Parnaíba Piauiense,Cabeceiras do Piauí,PI,,,,8498,9438,9927,5095,4832,1657,8270,1.57%
2202075,2204,Sudeste Piauiense,22013,Picos,Cajazeiras do Piauí,PI,,,,2667,3193,3343,1699,1644,1112,2231,2.28%
2202083,2201,Norte Piauiense,22002,Litoral Piauiense,Cajueiro da Praia,PI,,,,6122,6981,7163,3742,3421,2699,4464,1.58%
2202091,2204,Sudeste Piauiense,22015,Alto Médio Canindé,Caldeirão Grande do Piauí,PI,,,,5481,5622,5668,2839,2829,1660,4008,0.34%
2202109,2204,Sudeste Piauiense,22015,Alto Médio Canindé,Campinas do Piauí,PI,6416,6825,5894,5141,5598,5406,2713,2693,1805,3601,0.50%
2202117,2204,Sudeste Piauiense,22015,Alto Médio Canindé,Campo Alegre do Fidalgo,PI,,,,4451,4451,4696,2405,2291,1224,3472,0.54%
2202133,2204,Sudeste Piauiense,22015,Alto Médio Canindé,Campo Grande do Piauí,PI,,,,4882,5645,5592,2840,2752,1569,4023,1.37%
2202174,2201,Norte Piauiense,22001,Baixo Parnaíba Piauiense,Campo Largo do Piauí,PI,,,,5743,6726,6803,3466,3337,1430,5373,1.71%
2202208,2202,Centro-Norte Piauiense,22004,Campo Maior,Campo Maior,PI,61549,67705,72258,43126,44548,45180,21781,23399,33524,11656,0.47%
2202251,2203,Sudoeste Piauiense,22009,Floriano,Canavieira,PI,,,,4114,3984,3922,2028,1894,1741,2181,-0.48%
2202307,2203,Sudoeste Piauiense,22011,São Raimundo Nonato,Canto do Buriti,PI,19863,25526,27190,18371,20673,20035,9960,10075,11140,8895,0.87%
2202406,2202,Centro-Norte Piauiense,22004,Campo Maior,Capitão de Campos,PI,7342,8862,10161,10036,10830,10956,5440,5516,6347,4609,0.88%
2202455,2204,Sudeste Piauiense,22015,Alto Médio Canindé,Capitão Gervásio Oliveira,PI,,,,3433,3865,3876,1997,1879,1162,2714,1.22%
2202505,2203,Sudoeste Piauiense,22011,São Raimundo Nonato,Caracol,PI,7829,9391,11804,8040,10343,10212,5203,5009,4028,6184,2.42%
2202539,2201,Norte Piauiense,22002,Litoral Piauiense,Caraúbas do Piauí,PI,,,,4809,5371,5522,2837,2685,967,4555,1.39%
2202554,2204,Sudeste Piauiense,22015,Alto Médio Canindé,Caridade do Piauí,PI,,,,4062,4583,4825,2501,2324,1579,3246,1.74%
2202604,2202,Centro-Norte Piauiense,22004,Campo Maior,Castelo do Piauí,PI,25077,28529,28744,18339,18550,18338,8984,9354,11479,6859,-0.00%
2202653,2201,Norte Piauiense,22002,Litoral Piauiense,Caxingó,PI,,,,4147,5023,5039,2656,2383,966,4073,1.97%
2202703,2201,Norte Piauiense,22002,Litoral Piauiense,Cocal,PI,18897,24308,26989,24150,26201,26044,13178,12866,12021,14023,0.76%
2202711,2202,Centro-Norte Piauiense,22004,Campo Maior,Cocal de Telha,PI,,,,4248,4522,4525,2209,2316,2667,1858,0.63%
2202729,2201,Norte Piauiense,22002,Litoral Piauiense,Cocal dos Alves,PI,,,,5155,5341,5572,2797,2775,1782,3790,0.78%
2202737,2202,Centro-Norte Piauiense,22003,Teresina,Coivaras,PI,,,,3507,3797,3811,1970,1841,1173,2638,0.83%
2202752,2203,Sudoeste Piauiense,22008,Bertolínia,Colônia do Gurguéia,PI,,,,5012,5700,6035,2967,3068,4851,1184,1.87%
2202778,2204,Sudeste Piauiense,22013,Picos,Colônia do Piauí,PI,,,,7251,7662,7433,3701,3732,2644,4789,0.25%
2202802,2204,Sudeste Piauiense,22015,Alto Médio Canindé,Conceição do Canindé,PI,5058,6874,7629,4926,4923,4484,2251,2233,2365,2119,-0.94%
2202851,2203,Sudoeste Piauiense,22011,São Raimundo Nonato,Coronel José Dias,PI,,,,4415,4356,4541,2379,2162,1491,3050,0.28%
2202901,2203,Sudoeste Piauiense,22012,Chapadas do Extremo Sul Piauiense,Corrente,PI,14397,21539,24964,23226,24518,25408,12843,12565,15693,9715,0.90%
2203008,2203,Sudoeste Piauiense,22012,Chapadas do Extremo Sul Piauiense,Cristalândia do Piauí,PI,3300,4831,5963,6493,7800,7831,4087,3744,2945,4886,1.89%
2203107,2203,Sudoeste Piauiense,22010,Alto Médio Gurguéia,Cristino Castro,PI,6023,8518,11041,9269,9518,9981,5041,4940,7261,2720,0.74%
2203206,2203,Sudoeste Piauiense,22012,Chapadas do Extremo Sul Piauiense,Curimatá,PI,8184,10491,12813,9518,10360,10765,5457,5308,7084,3681,1.24%
2203230,2203,Sudoeste Piauiense,22010,Alto Médio Gurguéia,Currais,PI,,,,4232,4538,4704,2473,2231,924,3780,1.06%
2203255,2202,Centro-Norte Piauiense,22003,Teresina,Curralinhos,PI,,,,3641,4072,4182,2144,2038,1331,2851,1.39%
2203271,2204,Sudeste Piauiense,22015,Alto Médio Canindé,Curral Novo do Piauí,PI,,,,4220,4898,4870,2534,2336,1372,3498,1.44%
2203305,2202,Centro-Norte Piauiense,22003,Teresina,Demerval Lobão,PI,8421,10436,12218,12489,12806,13274,6472,6802,10873,2401,0.61%
2203354,2203,Sudoeste Piauiense,22011,São Raimundo Nonato,Dirceu Arcoverde,PI,,,10948,6066,6721,6677,3406,3271,2371,4306,0.96%
2203404,2204,Sudeste Piauiense,22013,Picos,Dom Expedito Lopes,PI,3518,4258,5058,5954,6532,6587,3229,3358,3594,2993,1.02%
2203420,2202,Centro-Norte Piauiense,22004,Campo Maior,Domingos Mourão,PI,3567,3692,4273,4284,4312,4264,2157,2107,958,3306,-0.05%
2203453,2203,Sudoeste Piauiense,22011,São Raimundo Nonato,Dom Inocêncio,PI,,,8992,8909,10329,9246,4732,4514,2018,7228,0.37%
2203503,2202,Centro-Norte Piauiense,22006,Valença do Piauí,Elesbão Veloso,PI,14340,16838,16641,15002,14174,14499,7141,7358,10119,4380,-0.34%
2203602,2203,Sudoeste Piauiense,22008,Bertolínia,Eliseu Martins,PI,5309,6521,8746,4188,4722,4667,2403,2264,3823,844,1.09%
2203701,2201,Norte Piauiense,22001,Baixo Parnaíba Piauiense,Esperantina,PI,24582,29110,35806,34094,36190,37765,18772,18993,23156,14609,1.03%
2203750,2203,Sudoeste Piauiense,22011,São Raimundo Nonato,Fartura do Piauí,PI,,,,4685,5190,5076,2574,2502,1336,3740,0.80%
2203800,2203,Sudoeste Piauiense,22009,Floriano,Flores do Piauí,PI,3526,4671,4850,4372,4468,4368,2220,2148,1987,2381,-0.01%
2203859,2204,Sudeste Piauiense,22015,Alto Médio Canindé,Floresta do Piauí,PI,,,,2416,2551,2482,1272,1210,861,1621,0.27%
2203909,2203,Sudoeste Piauiense,22009,Floriano,Floriano,PI,35850,43129,51494,54591,56090,57707,27318,30389,49978,7729,0.56%
2204006,2202,Centro-Norte Piauiense,22006,Valença do Piauí,Francinópolis,PI,4023,5029,5311,5254,5292,5230,2556,2674,3271,1959,-0.05%
2204105,2202,Centro-Norte Piauiense,22005,Médio Parnaíba Piauiense,Francisco Ayres,PI,3937,4498,5028,5236,5017,4483,2224,2259,2154,2329,-1.54%
2204154,2204,Sudeste Piauiense,22015,Alto Médio Canindé,Francisco Macedo,PI,,,,2337,2255,2879,1436,1443,1159,1720,2.11%
2204204,2204,Sudeste Piauiense,22014,Pio IX,Francisco Santos,PI,3877,4917,7049,7043,8293,8619,4393,4226,3989,4630,2.04%
2204303,2204,Sudeste Piauiense,22015,Alto Médio Canindé,Fronteiras,PI,12612,14429,14782,10012,11054,11122,5482,5640,7294,3828,1.06%
2204352,2204,Sudeste Piauiense,22013,Picos,Geminiano,PI,,,,4790,5255,5475,2776,2699,1216,4259,1.35%
2204402,2203,Sudoeste Piauiense,22010,Alto Médio Gurguéia,Gilbués,PI,8071,8697,9972,10229,10351,10393,5216,5177,5991,4402,0.16%
2204501,2203,Sudoeste Piauiense,22009,Floriano,Guadalupe,PI,9284,8586,9603,10308,9587,10268,5088,5180,9842,426,-0.04%
2204550,2203,Sudoeste Piauiense,22011,São Raimundo Nonato,Guaribas,PI,,,,4814,4343,4401,2216,2185,1275,3126,-0.89%
2204600,2202,Centro-Norte Piauiense,22005,Médio Parnaíba Piauiense,Hugo Napoleão,PI,2027,2881,3633,3703,3674,3771,1839,1932,3098,673,0.18%
2204659,2201,Norte Piauiense,22002,Litoral Piauiense,Ilha Grande,PI,,,,7890,8420,8914,4557,4357,7445,1469,1.23%
2204709,2202,Centro-Norte Piauiense,22006,Valença do Piauí,Inhuma,PI,9685,11166,13174,14426,14973,14868,7333,7535,7294,7574,0.30%
2204808,2204,Sudeste Piauiense,22013,Picos,Ipiranga do Piauí,PI,5393,6273,7525,8428,9354,9326,4600,4726,5745,3581,1.02%
2204907,2204,Sudeste Piauiense,22015,Alto Médio Canindé,Isaías Coelho,PI,4873,6936,7637,7658,7790,8218,4112,4106,1843,6375,0.71%
2205003,2204,Sudeste Piauiense,22015,Alto Médio Canindé,Itainópolis,PI,10168,13370,13506,10381,11084,11099,5546,5553,2517,8582,0.67%
2205102,2203,Sudoeste Piauiense,22009,Floriano,Itaueira,PI,9252,10225,11009,10347,10558,10677,5383,5294,5942,4735,0.31%
2205151,2204,Sudeste Piauiense,22015,Alto Médio Canindé,Jacobina do Piauí,PI,,,,5690,5597,5719,2903,2816,1026,4693,0.05%
2205201,2204,Sudeste Piauiense,22015,Alto Médio Canindé,Jaicós,PI,20360,24679,28731,15859,16826,18008,8784,9224,8544,9464,1.28%
2205250,2202,Centro-Norte Piauiense,22005,Médio Parnaíba Piauiense,Jardim do Mulato,PI,,,,3990,4171,4309,2182,2127,1183,3126,0.77%
2205276,2202,Centro-Norte Piauiense,22004,Campo Maior,Jatobá do Piauí,PI,,,,4314,4523,4637,2412,2225,888,3749,0.72%
2205300,2203,Sudoeste Piauiense,22009,Floriano,Jerumenha,PI,6987,7863,8144,4515,4371,4383,2216,2167,2469,1914,-0.30%
2205359,2204,Sudeste Piauiense,22015,Alto Médio Canindé,João Costa,PI,,,,3025,3199,2960,1571,1389,701,2259,-0.22%
2205409,2201,Norte Piauiense,22001,Baixo Parnaíba Piauiense,Joaquim Pires,PI,11433,14022,14629,13076,13779,13822,7155,6667,4260,9562,0.56%
2205458,2201,Norte Piauiense,22001,Baixo Parnaíba Piauiense,Joca Marques,PI,,,,4349,5345,5100,2665,2435,1677,3423,1.61%
2205508,2202,Centro-Norte Piauiense,22003,Teresina,José de Freitas,PI,21669,25369,29451,32858,35164,37095,18524,18571,21604,15491,1.22%
2205516,2202,Centro-Norte Piauiense,22004,Campo Maior,Juazeiro do Piauí,PI,,,,4523,4769,4757,2419,2338,1479,3278,0.51%
2205524,2203,Sudoeste Piauiense,22012,Chapadas do Extremo Sul Piauiense,Júlio Borges,PI,,,,4866,5250,5377,2802,2575,1618,3759,1.00%
2205532,2203,Sudoeste Piauiense,22011,São Raimundo Nonato,Jurema,PI,,,,4047,4388,4517,2356,2161,866,3651,1.10%
2205540,2202,Centro-Norte Piauiense,22005,Médio Parnaíba Piauiense,Lagoinha do Piauí,PI,,,,2231,2563,2656,1339,1317,1582,1074,1.76%
2205557,2202,Centro-Norte Piauiense,22003,Teresina,Lagoa Alegre,PI,,,,6849,7862,8008,4128,3880,3042,4966,1.58%
2205565,2204,Sudeste Piauiense,22015,Alto Médio Canindé,Lagoa do Barro do Piauí,PI,,,,4450,4543,4523,2321,2202,994,3529,0.16%
2205573,2202,Centro-Norte Piauiense,22004,Campo Maior,Lagoa de São Francisco,PI,,,,5795,6520,6422,3208,3214,2092,4330,1.03%
2205581,2202,Centro-Norte Piauiense,22003,Teresina,Lagoa do Piauí,PI,,,,3488,3684,3863,1990,1873,1672,2191,1.03%
2205599,2202,Centro-Norte Piauiense,22006,Valença do Piauí,Lagoa do Sítio,PI,,,,4138,5042,4853,2472,2381,1723,3130,1.61%
2205607,2203,Sudoeste Piauiense,22008,Bertolínia,Landri Sales,PI,4047,5928,5681,5628,5586,5281,2619,2662,3957,1324,-0.63%
2205706,2201,Norte Piauiense,22002,Litoral Piauiense,Luís Correia,PI,20521,25626,28835,24253,26147,28422,14605,13817,12646,15776,1.60%
2205805,2201,Norte Piauiense,22001,Baixo Parnaíba Piauiense,Luzilândia,PI,25525,34268,36013,24042,24323,24711,12401,12310,13252,11459,0.27%
2205854,2201,Norte Piauiense,22001,Baixo Parnaíba Piauiense,Madeiro,PI,,,,6771,7680,7816,4044,3772,3364,4452,1.45%
2205904,2203,Sudoeste Piauiense,22008,Bertolínia,Manoel Emídio,PI,4413,5679,6799,5151,5357,5209,2700,2509,3315,1894,0.11%
2205953,2204,Sudeste Piauiense,22015,Alto Médio Canindé,Marcolândia,PI,,,,6178,7154,7810,3864,3946,6705,1105,2.37%
2206001,2203,Sudoeste Piauiense,22008,Bertolínia,Marcos Parente,PI,2428,3187,4421,4279,4198,4456,2219,2237,3845,611,0.41%
2206050,2204,Sudeste Piauiense,22015,Alto Médio Canindé,Massapê do Piauí,PI,,,,5988,6428,6222,3154,3068,936,5286,0.38%
2206100,2201,Norte Piauiense,22001,Baixo Parnaíba Piauiense,Matias Olímpio,PI,9261,10801,11938,9727,10465,10485,5274,5211,4808,5677,0.75%
2206209,2201,Norte Piauiense,22001,Baixo Parnaíba Piauiense,Miguel Alves,PI,24597,26636,27679,29849,32178,32292,16360,15932,10714,21578,0.79%
2206308,2202,Centro-Norte Piauiense,22003,Teresina,Miguel Leão,PI,1418,1481,1254,1370,1194,1253,657,596,862,391,-0.89%
2206357,2202,Centro-Norte Piauiense,22004,Campo Maior,Milton Brandão,PI,,,,6900,7018,6770,3442,3328,1702,5068,-0.19%
2206407,2202,Centro-Norte Piauiense,22003,Teresina,Monsenhor Gil,PI,9090,9929,10986,10309,10321,10337,5112,5225,5316,5021,0.03%
2206506,2204,Sudeste Piauiense,22014,Pio IX,Monsenhor Hipólito,PI,4243,4640,6276,6764,7163,7391,3715,3676,3485,3906,0.89%
2206605,2203,Sudoeste Piauiense,22010,Alto Médio Gurguéia,Monte Alegre do Piauí,PI,7751,7960,9446,10230,10335,10349,5288,5061,2981,7368,0.12%
2206654,2203,Sudoeste Piauiense,22012,Chapadas do Extremo Sul Piauiense,Morro Cabeça no Tempo,PI,,,,4426,4241,4068,2061,2007,1404,2664,-0.84%
2206670,2201,Norte Piauiense,22001,Baixo Parnaíba Piauiense,Morro do Chapéu do Piauí,PI,,,,6006,6377,6499,3323,3176,2298,4201,0.79%
2206696,2201,Norte Piauiense,22002,Litoral Piauiense,Murici dos Portelas,PI,,,,6375,7655,8464,4422,4042,1689,6775,2.87%
2206704,2203,Sudoeste Piauiense,22009,Floriano,Nazaré do Piauí,PI,6268,7500,7831,7805,6947,7327,3674,3653,3503,3824,-0.63%
2206720,,,,,Nazária,PI,,,,,,8039,4075,3964,1652,6387,-
2206753,2202,Centro-Norte Piauiense,22004,Campo Maior,Nossa Senhora de Nazaré,PI,,,,3865,4048,4560,2333,2227,1363,3197,1.67%
2206803,2201,Norte Piauiense,22001,Baixo Parnaíba Piauiense,Nossa Senhora dos Remédios,PI,5171,5528,6077,7214,8044,8214,4083,4131,3693,4521,1.31%
2206902,2202,Centro-Norte Piauiense,22006,Valença do Piauí,Novo Oriente do Piauí,PI,6364,7287,7201,6760,6191,6498,3234,3264,3280,3218,-0.39%
2206951,2202,Centro-Norte Piauiense,22004,Campo Maior,Novo Santo Antônio,PI,,,,3155,3383,3260,1672,1588,916,2344,0.33%
2207009,2204,Sudeste Piauiense,22013,Picos,Oeiras,PI,41576,47319,51891,33910,35075,35646,17045,18601,22001,13645,0.50%
2207108,2202,Centro-Norte Piauiense,22005,Médio Parnaíba Piauiense,Olho D'Água do Piauí,PI,,,,2283,2637,2630,1310,1320,1064,1566,1.42%
2207207,2204,Sudeste Piauiense,22015,Alto Médio Canindé,Padre Marcos,PI,11191,15742,18728,7178,7340,6651,3219,3432,2355,4296,-0.76%
2207306,2204,Sudeste Piauiense,22015,Alto Médio Canindé,Paes Landim,PI,3786,4789,5436,4184,4462,4059,2048,2011,2376,1683,-0.30%
2207355,2203,Sudoeste Piauiense,22011,São Raimundo Nonato,Pajeú do Piauí,PI,,,,2894,3616,3366,1745,1621,1426,1940,1.52%
2207405,2203,Sudoeste Piauiense,22010,Alto Médio Gurguéia,Palmeira do Piauí,PI,3682,4314,4445,5199,4985,4993,2571,2422,1764,3229,-0.40%
2207504,2202,Centro-Norte Piauiense,22005,Médio Parnaíba Piauiense,Palmeirais,PI,10477,12578,11595,12154,13721,13745,6781,6964,5342,8403,1.24%
2207553,2204,Sudeste Piauiense,22013,Picos,Paquetá,PI,,,,4386,4531,4147,2148,1999,557,3590,-0.56%
2207603,2203,Sudoeste Piauiense,22012,Chapadas do Extremo Sul Piauiense,Parnaguá,PI,7966,10663,12666,9345,10313,10265,5451,4814,5328,4937,0.94%
2207702,2201,Norte Piauiense,22002,Litoral Piauiense,Parnaíba,PI,79216,102174,127929,132282,140839,145729,69729,76000,137507,8222,0.97%
2207751,2202,Centro-Norte Piauiense,22005,Médio Parnaíba Piauiense,Passagem Franca do Piauí,PI,,,,4195,4127,4546,2316,2230,2482,2064,0.81%
2207777,2204,Sudeste Piauiense,22015,Alto Médio Canindé,Patos do Piauí,PI,,,,5634,6171,6106,3094,3012,1689,4417,0.81%
2207793,2202,Centro-Norte Piauiense,22003,Teresina,Pau D'Arco do Piauí,PI,,,,,3713,3757,1935,1822,556,3201,-
2207801,2204,Sudeste Piauiense,22015,Alto Médio Canindé,Paulistana,PI,26034,32874,38942,16529,16930,19783,9566,10217,10654,9129,1.81%
2207850,2203,Sudoeste Piauiense,22009,Floriano,Pavussu,PI,,,,3973,4291,3666,1953,1713,1793,1873,-0.80%
2207900,2202,Centro-Norte Piauiense,22004,Campo Maior,Pedro II,PI,31041,38816,43817,36201,36675,37500,18443,19057,22671,14829,0.35%
2207934,2204,Sudeste Piauiense,22015,Alto Médio Canindé,Pedro Laurentino,PI,,,,2002,2105,2410,1251,1159,819,1591,1.87%
2207959,2204,Sudeste Piauiense,22015,Alto Médio Canindé,Nova Santa Rita,PI,,,,4150,4284,4192,2158,2034,704,3488,0.10%
2208007,2204,Sudeste Piauiense,22013,Picos,Picos,PI,52757,71018,78409,68974,70450,73417,35069,38348,58295,15122,0.63%
2208106,2202,Centro-Norte Piauiense,22006,Valença do Piauí,Pimenteiras,PI,9082,9463,10588,11306,11722,11713,5980,5733,4795,6918,0.35%
2208205,2204,Sudeste Piauiense,22014,Pio IX,Pio IX,PI,17765,19828,16126,16505,17123,17693,8837,8856,5290,12403,0.70%
2208304,2201,Norte Piauiense,22002,Litoral Piauiense,Piracuruca,PI,25143,29404,31163,24786,25625,27548,13623,13925,19242,8306,1.06%
2208403,2201,Norte Piauiense,22001,Baixo Parnaíba Piauiense,Piripiri,PI,43227,55095,63162,60154,60249,61840,30141,31699,44539,17301,0.28%
2208502,2201,Norte Piauiense,22001,Baixo Parnaíba Piauiense,Porto,PI,10349,12403,14324,10573,11492,11897,6009,5888,7503,4394,1.19%
2208551,2203,Sudoeste Piauiense,22008,Bertolínia,Porto Alegre do Piauí,PI,,,,2421,2468,2559,1324,1235,1802,757,0.56%
2208601,2202,Centro-Norte Piauiense,22006,Valença do Piauí,Prata do Piauí,PI,1528,2130,2710,3117,3159,3085,1551,1534,2552,533,-0.10%
2208650,2204,Sudeste Piauiense,22015,Alto Médio Canindé,Queimada Nova,PI,,,,8332,9146,8565,4289,4276,1156,7409,0.28%
2208700,2203,Sudoeste Piauiense,22010,Alto Médio Gurguéia,Redenção do Gurguéia,PI,3738,5331,6882,7781,8263,8403,4224,4179,5334,3069,0.77%
2208809,2202,Centro-Norte Piauiense,22005,Médio Parnaíba Piauiense,Regeneração,PI,13552,16950,20537,17471,17633,17576,8599,8977,13832,3744,0.06%
2208858,2203,Sudoeste Piauiense,22012,Chapadas do Extremo Sul Piauiense,Riacho Frio,PI,,,,4321,4884,4238,2221,2017,2222,2016,-0.19%
2208874,2204,Sudeste Piauiense,22015,Alto Médio Canindé,Ribeira do Piauí,PI,,,,3879,4103,4263,2138,2125,1030,3233,0.95%
2208908,2203,Sudoeste Piauiense,22007,Alto Parnaíba Piauiense,Ribeiro Gonçalves,PI,8296,9933,11913,5722,6577,6841,3509,3332,4445,2396,1.80%
2209005,2203,Sudoeste Piauiense,22009,Floriano,Rio Grande do Piauí,PI,7673,9310,9789,6131,6430,6429,3184,3245,4094,2335,0.48%
2209104,2204,Sudeste Piauiense,22013,Picos,Santa Cruz do Piauí,PI,8177,9435,9701,5776,5790,6025,2971,3054,4067,1958,0.42%
2209153,2202,Centro-Norte Piauiense,22006,Valença do Piauí,Santa Cruz dos Milagres,PI,,,,3334,3352,3794,1884,1910,2127,1667,1.30%
2209203,2203,Sudoeste Piauiense,22007,Alto Parnaíba Piauiense,Santa Filomena,PI,4614,4657,5616,6031,5999,6096,3219,2877,3544,2552,0.11%
2209302,2203,Sudoeste Piauiense,22010,Alto Médio Gurguéia,Santa Luz,PI,3909,4269,4458,4780,5280,5513,2869,2644,3109,2404,1.44%
2209351,2204,Sudeste Piauiense,22013,Picos,Santana do Piauí,PI,,,,4595,4841,4920,2407,2513,1941,2979,0.69%
2209377,2204,Sudeste Piauiense,22013,Picos,Santa Rosa do Piauí,PI,,,,5223,5149,5149,2582,2567,3655,1494,-0.14%
2209401,2204,Sudeste Piauiense,22014,Pio IX,Santo Antônio de Lisboa,PI,3022,5607,5073,5154,5729,6008,2979,3029,3917,2091,1.55%
2209450,2202,Centro-Norte Piauiense,22005,Médio Parnaíba Piauiense,Santo Antônio dos Milagres,PI,,,,1876,1963,2058,1023,1035,807,1251,0.93%
2209500,2204,Sudeste Piauiense,22015,Alto Médio Canindé,Santo Inácio do Piauí,PI,4562,5519,5621,3447,3626,3653,1854,1799,2297,1356,0.58%
2209559,2203,Sudoeste Piauiense,22011,São Raimundo Nonato,São Braz do Piauí,PI,,,,4192,4311,4313,2243,2070,1021,3292,0.28%
2209609,2202,Centro-Norte Piauiense,22006,Valença do Piauí,São Félix do Piauí,PI,5970,5705,5537,3397,3132,3069,1500,1569,1641,1428,-1.01%
2209658,2204,Sudeste Piauiense,22015,Alto Médio Canindé,São Francisco de Assis do Piauí,PI,,,,3806,5015,5575,2837,2738,1429,4146,3.89%
2209708,2203,Sudoeste Piauiense,22009,Floriano,São Francisco do Piauí,PI,6116,6844,6675,6356,6276,6301,3191,3110,1983,4318,-0.09%
2209757,2203,Sudoeste Piauiense,22010,Alto Médio Gurguéia,São Gonçalo do Gurguéia,PI,,,,2322,2455,2825,1464,1361,1219,1606,1.98%
2209807,2202,Centro-Norte Piauiense,22005,Médio Parnaíba Piauiense,São Gonçalo do Piauí,PI,3204,4227,5200,4249,4342,4754,2351,2403,3308,1446,1.13%
2209856,2204,Sudeste Piauiense,22013,Picos,São João da Canabrava,PI,,,6839,4240,4364,4445,2188,2257,1233,3212,0.47%
2209872,2201,Norte Piauiense,22002,Litoral Piauiense,São João da Fronteira,PI,,,,4886,5008,5608,2805,2803,2272,3336,1.39%
2209906,2202,Centro-Norte Piauiense,22004,Campo Maior,São João da Serra,PI,6689,7784,7288,6675,6672,6157,3012,3145,3447,2710,-0.80%
2209955,2204,Sudeste Piauiense,22013,Picos,São João da Varjota,PI,,,,4375,4776,4648,2282,2366,1389,3259,0.61%
2209971,2201,Norte Piauiense,22001,Baixo Parnaíba Piauiense,São João do Arraial,PI,,,,5734,7081,7337,3698,3639,3703,3634,2.50%
2210003,2204,Sudeste Piauiense,22015,Alto Médio Canindé,São João do Piauí,PI,27823,34545,38172,17670,18689,19553,9584,9969,13470,6083,1.02%
2210052,2201,Norte Piauiense,22002,Litoral Piauiense,São José do Divino,PI,,,,4881,5045,5141,2649,2492,2703,2438,0.52%
2210102,2203,Sudoeste Piauiense,22009,Floriano,São José do Peixe,PI,4516,5547,5924,3825,3730,3700,1886,1814,1889,1811,-0.33%
2210201,2204,Sudeste Piauiense,22013,Picos,São José do Piauí,PI,5011,5612,6525,6706,6808,6608,3287,3321,1935,4673,-0.15%
2210300,2204,Sudeste Piauiense,22014,Pio IX,São Julião,PI,6307,7993,9728,5700,5908,5677,2831,2846,2328,3349,-0.04%
2210359,2203,Sudoeste Piauiense,22011,São Raimundo Nonato,São Lourenço do Piauí,PI,,,,4274,4899,4423,2265,2158,1113,3310,0.34%
2210375,2204,Sudeste Piauiense,22013,Picos,São Luis do Piauí,PI,,,,2488,2596,2561,1262,1299,814,1747,0.29%
2210383,2202,Centro-Norte Piauiense,22006,Valença do Piauí,São Miguel da Baixa Grande,PI,,,,2030,2083,2113,1050,1063,1358,755,0.40%
2210391,2203,Sudoeste Piauiense,22009,Floriano,São Miguel do Fidalgo,PI,,,,2991,3078,2976,1546,1430,1085,1891,-0.05%
2210409,2202,Centro-Norte Piauiense,22004,Campo Maior,São Miguel do Tapuio,PI,20648,24184,24829,18808,19201,18149,9225,8924,6684,11465,-0.36%
2210508,2202,Centro-Norte Piauiense,22005,Médio Parnaíba Piauiense,São Pedro do Piauí,PI,10088,10699,11520,12510,13083,13645,6820,6825,8194,5451,0.87%
2210607,2203,Sudoeste Piauiense,22011,São Raimundo Nonato,São Raimundo Nonato,PI,47092,57713,44208,26890,30852,32347,15899,16448,21272,11075,1.86%
2210623,2203,Sudoeste Piauiense,22012,Chapadas do Extremo Sul Piauiense,Sebastião Barros,PI,,,,4524,4178,3559,1886,1673,1112,2447,-2.37%
2210631,2203,Sudoeste Piauiense,22008,Bertolínia,Sebastião Leal,PI,,,,3835,4080,4116,2151,1965,1922,2194,0.71%
2210656,2202,Centro-Norte Piauiense,22004,Campo Maior,Sigefredo Pacheco,PI,,,,9046,9506,9619,4972,4647,3176,6443,0.62%
2210706,2204,Sudeste Piauiense,22015,Alto Médio Canindé,Simões,PI,14524,18193,22147,13621,13734,14185,7079,7106,5697,8488,0.41%
2210805,2204,Sudeste Piauiense,22015,Alto Médio Canindé,Simplício Mendes,PI,9564,11546,13451,10966,11472,12078,6090,5988,7163,4915,0.97%
2210904,2204,Sudeste Piauiense,22015,Alto Médio Canindé,Socorro do Piauí,PI,3433,4795,5266,4675,4599,4528,2296,2232,1630,2898,-0.32%
2210938,2204,Sudeste Piauiense,22013,Picos,Sussuapara,PI,,,,5042,5537,6235,3102,3133,1582,4653,2.15%
2210953,2203,Sudoeste Piauiense,22011,São Raimundo Nonato,Tamboril do Piauí,PI,,,,2413,2897,2755,1446,1309,1512,1243,1.33%
2210979,2204,Sudeste Piauiense,22013,Picos,Tanque do Piauí,PI,,,,2318,2605,2621,1277,1344,1239,1382,1.24%
2211001,2202,Centro-Norte Piauiense,22003,Teresina,Teresina,PI,220487,377771,599272,715360,779939,814439,380693,433746,767777,46662,1.31%
2211100,2202,Centro-Norte Piauiense,22003,Teresina,União,PI,37463,41560,41328,39801,41661,42657,21402,21255,20969,21688,0.70%
2211209,2203,Sudoeste Piauiense,22007,Alto Parnaíba Piauiense,Uruçuí,PI,10853,14543,15913,17011,19017,20152,9916,10236,15503,4649,1.71%
2211308,2202,Centro-Norte Piauiense,22006,Valença do Piauí,Valença do Piauí,PI,14702,18724,20600,19887,19716,20325,9579,10746,15791,4534,0.22%
2211357,2203,Sudoeste Piauiense,22011,São Raimundo Nonato,Várzea Branca,PI,,,,5203,5178,4913,2506,2407,1147,3766,-0.57%
2211407,2202,Centro-Norte Piauiense,22006,Valença do Piauí,Várzea Grande,PI,5725,7152,8079,4475,4429,4336,2048,2288,2581,1755,-0.32%
2211506,2204,Sudeste Piauiense,22015,Alto Médio Canindé,Vera Mendes,PI,,,,2907,3097,2987,1494,1493,967,2020,0.27%
2211605,2204,Sudeste Piauiense,22015,Alto Médio Canindé,Vila Nova do Piauí,PI,,,,2906,3030,3076,1576,1500,759,2317,0.57%
2211704,2204,Sudeste Piauiense,22013,Picos,Wall Ferraz,PI,,,,3998,4452,4280,2167,2113,1166,3114,0.68%
4100103,4104,Norte Pioneiro Paranaense,41015,Cornélio Procópio,Abatiá,PR,15497,9642,10238,8259,7791,7753,3911,3842,5721,2032,-0.63%
4100202,4110,Metropolitana de Curitiba,41035,Cerro Azul,Adrianópolis,PR,11540,11122,8935,7007,6709,6374,3296,3078,2060,4314,-0.94%
4100301,4110,Metropolitana de Curitiba,41039,Rio Negro,Agudos do Sul,PR,5432,5195,6076,7221,8192,8270,4306,3964,2822,5448,1.37%
4100400,4110,Metropolitana de Curitiba,41037,Curitiba,Almirante Tamandaré,PR,15299,34157,66159,88277,93055,103245,51181,52064,98954,4291,1.58%
4100459,4102,Centro Ocidental Paranaense,41004,Goioerê,Altamira do Paraná,PR,,,7437,6999,4369,4306,2202,2104,2135,2171,-4.74%
4100509,4101,Noroeste Paranaense,41002,Umuarama,Altônia,PR,43042,42763,24589,19230,19904,20516,10157,10359,15094,5422,0.65%
4100608,4101,Noroeste Paranaense,41001,Paranavaí,Alto Paraná,PR,19593,13348,12047,12717,12936,13662,6841,6821,11219,2443,0.72%
4100707,4101,Noroeste Paranaense,41002,Umuarama,Alto Piquiri,PR,40439,22656,17229,10761,10210,10179,5128,5051,8375,1804,-0.55%
4100806,4103,Norte Central Paranaense,41007,Porecatu,Alvorada do Sul,PR,19209,12567,9685,9253,9014,10298,5212,5086,7348,2950,1.08%
4100905,4101,Noroeste Paranaense,41001,Paranavaí,Amaporã,PR,4848,3256,3948,4655,5140,5444,2756,2688,4332,1112,1.58%
4101002,4107,Sudoeste Paranaense,41025,Capanema,Ampére,PR,13246,15628,13213,15623,17067,17308,8586,8722,13257,4051,1.03%
4101051,4106,Oeste Paranaense,41023,Cascavel,Anahy,PR,,,,3011,2868,2865,1435,1430,2099,766,-0.50%
4101101,4104,Norte Pioneiro Paranaense,41015,Cornélio Procópio,Andirá,PR,20146,17644,19584,21663,21330,20615,10043,10572,19356,1259,-0.49%
4101150,4103,Norte Central Paranaense,41006,Astorga,Ângulo,PR,,,,2840,2807,2861,1457,1404,2255,606,0.07%
4101200,4110,Metropolitana de Curitiba,41038,Paranaguá,Antonina,PR,16448,16304,17070,19174,17581,18891,9349,9542,16063,2828,-0.15%
4101309,4109,Sudeste Paranaense,41034,São Mateus do Sul,Antônio Olinto,PR,7177,6804,7733,7407,7477,7351,3857,3494,687,6664,-0.08%
4101408,4103,Norte Central Paranaense,41010,Apucarana,Apucarana,PR,69302,80245,95064,107827,115323,120884,58630,62254,114104,6780,1.15%
4101507,4103,Norte Central Paranaense,41010,Apucarana,Arapongas,PR,51210,54670,64556,85428,96669,104161,51045,53116,101862,2299,2.00%
4101606,4105,Centro Oriental Paranaense,41020,Jaguariaíva,Arapoti,PR,13650,17103,20603,23884,25645,25856,12949,12907,21779,4077,0.80%
4101655,4103,Norte Central Paranaense,41013,Ivaiporã,Arapuã,PR,,,,4172,3945,3554,1760,1794,1331,2223,-1.59%
4101705,4102,Centro Ocidental Paranaense,41005,Campo Mourão,Araruna,PR,23326,14222,12387,13081,12650,13424,6823,6601,10480,2944,0.26%
4101804,4110,Metropolitana de Curitiba,41037,Curitiba,Araucária,PR,17117,34789,61889,94258,109943,119207,59668,59539,110293,8914,2.38%
4101853,4103,Norte Central Paranaense,41013,Ivaiporã,Ariranha do Ivaí,PR,,,,2883,2540,2453,1229,1224,904,1549,-1.60%
4101903,4104,Norte Pioneiro Paranaense,41014,Assaí,Assaí,PR,29090,22098,20325,18045,16098,16368,8019,8349,13601,2767,-0.97%
4102000,4106,Oeste Paranaense,41022,Toledo,Assis Chateaubriand,PR,78600,54629,39737,33317,32226,33028,16179,16849,29018,4010,-0.09%
4102109,4103,Norte Central Paranaense,41006,Astorga,Astorga,PR,25018,20677,22458,23637,24191,24704,12147,12557,22563,2141,0.44%
4102208,4103,Norte Central Paranaense,41006,Astorga,Atalaia,PR,6542,4749,4129,4015,3627,3913,1970,1943,3347,566,-0.26%
4102307,4110,Metropolitana de Curitiba,41037,Curitiba,Balsa Nova,PR,4704,5293,7515,10153,10639,11294,5718,5576,6871,4423,1.07%
4102406,4104,Norte Pioneiro Paranaense,41015,Cornélio Procópio,Bandeirantes,PR,38773,33726,34310,33732,32290,32182,15550,16632,28382,3800,-0.47%
4102505,4102,Centro Ocidental Paranaense,41005,Campo Mourão,Barbosa Ferraz,PR,37455,36156,18389,14110,13655,12653,6366,6287,9584,3069,-1.08%
4102604,4107,Sudoeste Paranaense,41026,Francisco Beltrão,Barracão,PR,16205,18143,14692,9271,9027,9737,4799,4938,7015,2722,0.49%
4102703,4104,Norte Pioneiro Paranaense,41016,Jacarezinho,Barra do Jacaré,PR,6661,4005,3151,2723,2757,2727,1385,1342,1851,876,0.01%
4102752,4107,Sudoeste Paranaense,41025,Capanema,Bela Vista da Caroba,PR,,,,4503,4136,3939,2016,1923,1038,2901,-1.33%
4102802,4103,Norte Central Paranaense,41007,Porecatu,Bela Vista do Paraíso,PR,18097,15003,15098,15031,14996,15080,7318,7762,14198,882,0.03%
4102901,4109,Sudeste Paranaense,41033,União da Vitória,Bituruna,PR,9104,11703,12852,15733,16142,15883,8152,7731,9902,5981,0.09%
4103008,4102,Centro Ocidental Paranaense,41004,Goioerê,Boa Esperança,PR,14124,8487,6954,5162,4706,4568,2280,2288,2640,1928,-1.22%
4103024,4107,Sudoeste Paranaense,41026,Francisco Beltrão,Boa Esperança do Iguaçu,PR,,,,3107,2866,2768,1403,1365,957,1811,-1.15%
4103040,4108,Centro-Sul Paranaense,41028,Pitanga,Boa Ventura de São Roque,PR,,,,6780,6744,6549,3345,3204,1544,5005,-0.35%
4103057,4106,Oeste Paranaense,41023,Cascavel,Boa Vista da Aparecida,PR,,,10370,8423,7818,7911,3994,3917,4900,3011,-0.63%
4103107,4110,Metropolitana de Curitiba,41037,Curitiba,Bocaiúva do Sul,PR,10697,12115,10657,9050,9533,11005,5570,5435,5136,5869,1.98%
4103156,4107,Sudoeste Paranaense,41026,Francisco Beltrão,Bom Jesus do Sul,PR,,,,4154,3835,3796,1969,1827,933,2863,-0.90%
4103206,4103,Norte Central Paranaense,41012,Faxinal,Bom Sucesso,PR,16045,9408,7116,6173,6397,6568,3228,3340,5337,1231,0.62%
4103222,4107,Sudoeste Paranaense,41027,Pato Branco,Bom Sucesso do Sul,PR,,,,3392,3061,3296,1639,1657,1581,1715,-0.29%
4103305,4103,Norte Central Paranaense,41012,Faxinal,Borrazópolis,PR,24137,15456,11481,9453,8275,7877,3937,3940,5809,2068,-1.81%
4103354,4106,Oeste Paranaense,41023,Cascavel,Braganey,PR,,,8069,6191,6044,5735,2938,2797,3417,2318,-0.76%
4103370,4101,Noroeste Paranaense,41002,Umuarama,Brasilândia do Sul,PR,,,,3889,3306,3209,1602,1607,2178,1031,-1.90%
4103404,4103,Norte Central Paranaense,41006,Astorga,Cafeara,PR,4882,3141,2398,2485,2702,2695,1376,1319,2195,500,0.81%
4103453,4106,Oeste Paranaense,41023,Cascavel,Cafelândia,PR,,,8093,11143,13065,14551,7287,7264,12316,2235,2.70%
4103479,4101,Noroeste Paranaense,41002,Umuarama,Cafezal do Sul,PR,,,,4648,4271,4285,2167,2118,3323,962,-0.81%
4103503,4103,Norte Central Paranaense,41010,Apucarana,Califórnia,PR,11562,8082,7329,7678,7546,8069,4051,4018,6028,2041,0.50%
4103602,4104,Norte Pioneiro Paranaense,41016,Jacarezinho,Cambará,PR,25631,21359,21343,22740,23956,23871,11640,12231,22348,1523,0.49%
4103701,4103,Norte Central Paranaense,41011,Londrina,Cambé,PR,35621,53857,73842,88186,92888,96735,47302,49433,92956,3779,0.93%
4103800,4103,Norte Central Paranaense,41010,Apucarana,Cambira,PR,20236,12026,9793,6688,6862,7236,3674,3562,5475,1761,0.79%
4103909,4102,Centro Ocidental Paranaense,41004,Goioerê,Campina da Lagoa,PR,38661,23110,20506,17018,15983,15393,7650,7743,12556,2837,-1.00%
4103958,4108,Centro-Sul Paranaense,41029,Guarapuava,Campina do Simão,PR,,,,4365,4180,4076,2134,1942,1388,2688,-0.68%
4104006,4110,Metropolitana de Curitiba,41037,Curitiba,Campina Grande do Sul,PR,7891,9800,19343,34566,35396,38756,19220,19536,31937,6819,1.15%
4104055,4106,Oeste Paranaense,41023,Cascavel,Campo Bonito,PR,,,5059,5128,4426,4407,2215,2192,2580,1827,-1.50%
4104105,4110,Metropolitana de Curitiba,41039,Rio Negro,Campo do Tenente,PR,4411,3847,5241,6335,6461,7125,3677,3448,4194,2931,1.18%
4104204,4110,Metropolitana de Curitiba,41037,Curitiba,Campo Largo,PR,34405,54834,72523,92782,105492,112486,55735,56751,94253,18233,1.94%
4104253,4110,Metropolitana de Curitiba,41037,Curitiba,Campo Magro,PR,,,,20409,22325,24836,12504,12332,19548,5288,1.98%
4104303,4102,Centro Ocidental Paranaense,41005,Campo Mourão,Campo Mourão,PR,77118,75423,82318,80476,82530,87287,42085,45202,82757,4530,0.82%
4104402,4103,Norte Central Paranaense,41013,Ivaiporã,Cândido de Abreu,PR,14547,18492,21607,18795,17775,16662,8551,8111,4759,11903,-1.20%
4104428,4108,Centro-Sul Paranaense,41029,Guarapuava,Candói,PR,,,,14185,15412,14982,7551,7431,7011,7971,0.55%
4104451,4108,Centro-Sul Paranaense,41029,Guarapuava,Cantagalo,PR,,,25497,12810,12418,12952,6562,6390,8509,4443,0.11%
4104501,4107,Sudoeste Paranaense,41025,Capanema,Capanema,PR,21717,25779,19368,18239,18103,18512,9152,9360,11136,7376,0.15%
4104600,4106,Oeste Paranaense,41023,Cascavel,Capitão Leônidas Marques,PR,23256,40832,17843,14377,13616,14936,7457,7479,11456,3480,0.38%
4104659,4105,Centro Oriental Paranaense,41021,Ponta Grossa,Carambeí,PR,,,,14860,16521,19171,9703,9468,13926,5245,2.58%
4104709,4104,Norte Pioneiro Paranaense,41018,Wenceslau Braz,Carlópolis,PR,15569,13528,12357,13305,13170,13706,6932,6774,9354,4352,0.30%
4104808,4106,Oeste Paranaense,41023,Cascavel,Cascavel,PR,89921,163470,192990,245369,285784,286172,139727,146445,270009,16163,1.55%
4104907,4105,Centro Oriental Paranaense,41021,Ponta Grossa,Castro,PR,37536,49815,64058,63581,65363,67082,33404,33678,49254,17828,0.54%
4105003,4106,Oeste Paranaense,41023,Cascavel,Catanduvas,PR,25726,36325,9821,10421,9578,10208,5192,5016,5344,4864,-0.21%
4105102,4103,Norte Central Paranaense,41006,Astorga,Centenário do Sul,PR,19543,16392,14269,11817,11247,11178,5553,5625,9327,1851,-0.55%
4105201,4110,Metropolitana de Curitiba,41035,Cerro Azul,Cerro Azul,PR,18363,20006,21073,16352,17693,16948,8725,8223,4814,12134,0.36%
4105300,4106,Oeste Paranaense,41024,Foz do Iguaçu,Céu Azul,PR,23219,25441,10586,10445,10914,11032,5413,5619,8387,2645,0.55%
4105409,4107,Sudoeste Paranaense,41027,Pato Branco,Chopinzinho,PR,27042,35170,24587,20543,19224,19673,9769,9904,12503,7170,-0.43%
4105508,4101,Noroeste Paranaense,41003,Cianorte,Cianorte,PR,52532,48801,49846,57401,64498,69962,34042,35920,62282,7680,2.00%
4105607,4101,Noroeste Paranaense,41003,Cianorte,Cidade Gaúcha,PR,13042,8240,8472,9531,10468,11067,5534,5533,9181,1886,1.51%
4105706,4108,Centro-Sul Paranaense,41030,Palmas,Clevelândia,PR,13636,16799,18057,18338,17599,17232,8438,8794,14756,2476,-0.62%
4105805,4110,Metropolitana de Curitiba,41037,Curitiba,Colombo,PR,19258,62882,117767,183329,233916,213027,105039,107988,203251,9776,1.51%
4105904,4103,Norte Central Paranaense,41006,Astorga,Colorado,PR,16088,17055,18972,20957,21049,22347,11045,11302,21007,1340,0.64%
4106001,4104,Norte Pioneiro Paranaense,41015,Cornélio Procópio,Congonhinhas,PR,18472,8308,7773,7851,8552,8279,4237,4042,4834,3445,0.53%
4106100,4104,Norte Pioneiro Paranaense,41017,Ibaiti,Conselheiro Mairinck,PR,6551,3718,3493,3463,3554,3627,1830,1797,2513,1114,0.46%
4106209,4110,Metropolitana de Curitiba,41037,Curitiba,Contenda,PR,7224,7558,8941,13241,14800,15892,8099,7793,9233,6659,1.84%
4106308,4106,Oeste Paranaense,41023,Cascavel,Corbélia,PR,39672,35898,22813,15803,15428,16302,7965,8337,13964,2338,0.31%
4106407,4104,Norte Pioneiro Paranaense,41015,Cornélio Procópio,Cornélio Procópio,PR,49796,42588,46644,46861,46931,46925,22698,24227,44305,2620,0.01%
4106456,4108,Centro-Sul Paranaense,41030,Palmas,Coronel Domingos Soares,PR,,,,7004,7480,7238,3792,3446,1753,5485,0.33%
4106506,4107,Sudoeste Paranaense,41027,Pato Branco,Coronel Vivida,PR,22413,26947,25140,23306,21571,21737,10613,11124,15432,6305,-0.69%
4106555,4102,Centro Ocidental Paranaense,41005,Campo Mourão,Corumbataí do Sul,PR,,,6642,4946,4262,4003,2034,1969,2128,1875,-2.09%
4106571,4107,Sudoeste Paranaense,41026,Francisco Beltrão,Cruzeiro do Iguaçu,PR,,,,4394,4150,4274,2131,2143,2619,1655,-0.28%
4106605,4101,Noroeste Paranaense,41002,Umuarama,Cruzeiro do Oeste,PR,37663,27279,23660,20222,20182,20419,9992,10427,17667,2752,0.10%
4106704,4101,Noroeste Paranaense,41001,Paranavaí,Cruzeiro do Sul,PR,8088,5704,5006,4759,4493,4563,2310,2253,3404,1159,-0.42%
4106803,4109,Sudeste Paranaense,41033,União da Vitória,Cruz Machado,PR,13560,15149,16568,17667,18329,18043,9328,8715,6057,11986,0.21%
4106852,4103,Norte Central Paranaense,41012,Faxinal,Cruzmaltina,PR,,,,3459,3116,3162,1635,1527,1503,1659,-0.89%
4106902,4110,Metropolitana de Curitiba,41037,Curitiba,Curitiba,PR,609026,1024980,1315035,1587315,1797408,1746896,832500,914396,1746896,0,0.96%
4107009,4104,Norte Pioneiro Paranaense,41017,Ibaiti,Curiúva,PR,17724,19660,10503,12904,14338,13924,7105,6819,9576,4348,0.76%
4107108,4101,Noroeste Paranaense,41001,Paranavaí,Diamante do Norte,PR,7643,8408,7604,6099,5611,5524,2735,2789,4559,965,-0.99%
4107124,4106,Oeste Paranaense,41023,Cascavel,Diamante do Sul,PR,,,,3659,3665,3510,1795,1715,1405,2105,-0.41%
4107157,4106,Oeste Paranaense,41022,Toledo,Diamante D'Oeste,PR,,,9253,4878,4944,5027,2570,2457,2561,2466,0.30%
4107207,4107,Sudoeste Paranaense,41026,Francisco Beltrão,Dois Vizinhos,PR,37153,42468,40267,31986,34001,36198,17995,18203,28115,8083,1.24%
4107256,4101,Noroeste Paranaense,41002,Umuarama,Douradina,PR,,,6578,6160,6530,7446,3770,3676,5233,2213,1.91%
4107306,4103,Norte Central Paranaense,41008,Floraí,Doutor Camargo,PR,9223,6634,5942,5777,5609,5829,2870,2959,5111,718,0.09%
4107405,4107,Sudoeste Paranaense,41026,Francisco Beltrão,Enéas Marques,PR,13882,14277,12396,6382,5974,6101,3130,2971,2126,3975,-0.45%
4107504,4102,Centro Ocidental Paranaense,41005,Campo Mourão,Engenheiro Beltrão,PR,25239,15638,14671,14082,13867,13920,6929,6991,12288,1632,-0.12%
4107520,4101,Noroeste Paranaense,41002,Umuarama,Esperança Nova,PR,,,,2308,1887,1970,981,989,752,1218,-1.57%
4107538,4106,Oeste Paranaense,41022,Toledo,Entre Rios do Oeste,PR,,,,3328,3842,3922,1953,1969,2641,1281,1.66%
4107546,4108,Centro-Sul Paranaense,41029,Guarapuava,Espigão Alto do Iguaçu,PR,,,,5388,5104,4677,2386,2291,1646,3031,-1.41%
4107553,4102,Centro Ocidental Paranaense,41005,Campo Mourão,Farol,PR,,,,3963,3394,3472,1723,1749,2018,1454,-1.31%
4107603,4103,Norte Central Paranaense,41012,Faxinal,Faxinal,PR,33851,25550,19926,15608,15527,16317,8028,8289,12745,3572,0.45%
4107652,4110,Metropolitana de Curitiba,41037,Curitiba,Fazenda Rio Grande,PR,,,,62877,75006,81687,40580,41107,75940,5747,2.65%
4107702,4102,Centro Ocidental Paranaense,41005,Campo Mourão,Fênix,PR,14799,7444,5983,4942,4871,4802,2397,2405,3993,809,-0.29%
4107736,4109,Sudeste Paranaense,41031,Prudentópolis,Fernandes Pinheiro,PR,,,,6368,5688,5932,3039,2893,2094,3838,-0.71%
4107751,4104,Norte Pioneiro Paranaense,41017,Ibaiti,Figueira,PR,,,9585,9038,8380,8293,4103,4190,7091,1202,-0.86%
4107801,4103,Norte Central Paranaense,41008,Floraí,Floraí,PR,11022,6645,5500,5285,5051,5050,2502,2548,4472,578,-0.45%
4107850,4107,Sudoeste Paranaense,41026,Francisco Beltrão,Flor da Serra do Sul,PR,,,,5059,4685,4725,2398,2327,1644,3081,-0.68%
4107900,4103,Norte Central Paranaense,41008,Floraí,Floresta,PR,8303,4297,4527,5122,5215,5921,2943,2978,5471,450,1.46%
4108007,4103,Norte Central Paranaense,41007,Porecatu,Florestópolis,PR,9774,12140,11998,12190,11571,11220,5684,5536,10546,674,-0.83%
4108106,4103,Norte Central Paranaense,41006,Astorga,Flórida,PR,2976,1985,2096,2434,2448,2540,1287,1253,2322,218,0.43%
4108205,4106,Oeste Paranaense,41022,Toledo,Formosa do Oeste,PR,44278,36002,15196,8755,7532,7543,3787,3756,4964,2579,-1.48%
4108304,4106,Oeste Paranaense,41024,Foz do Iguaçu,Foz do Iguaçu,PR,33966,136352,190123,258543,311336,256081,124203,131878,253950,2131,-0.10%
4108320,4101,Noroeste Paranaense,41002,Umuarama,Francisco Alves,PR,,14715,9205,6956,6342,6424,3227,3197,4240,2184,-0.79%
4108403,4107,Sudoeste Paranaense,41026,Francisco Beltrão,Francisco Beltrão,PR,36807,48765,61272,67132,72409,78957,38971,39986,67456,11501,1.64%
4108452,4108,Centro-Sul Paranaense,41029,Guarapuava,Foz do Jordão,PR,,,,6378,5832,5414,2683,2731,3924,1490,-1.63%
4108502,4109,Sudeste Paranaense,41033,União da Vitória,General Carneiro,PR,6810,8976,11287,13899,14591,13667,6898,6769,9569,4098,-0.17%
4108551,4103,Norte Central Paranaense,41013,Ivaiporã,Godoy Moreira,PR,,,5294,3836,3568,3337,1701,1636,1547,1790,-1.38%
4108601,4102,Centro Ocidental Paranaense,41004,Goioerê,Goioerê,PR,73854,48792,45131,29750,28941,29024,14009,15015,25248,3776,-0.25%
4108650,4108,Centro-Sul Paranaense,41029,Guarapuava,Goioxim,PR,,,,8086,7993,7504,3925,3579,1756,5748,-0.74%
4108700,4103,Norte Central Paranaense,41013,Ivaiporã,Grandes Rios,PR,36588,35310,12156,7868,7641,6625,3381,3244,3562,3063,-1.70%
4108809,4106,Oeste Paranaense,41022,Toledo,Guaíra,PR,32875,29170,30000,28659,28683,30669,14925,15744,28176,2493,0.68%
4108908,4101,Noroeste Paranaense,41001,Paranavaí,Guairaçá,PR,7922,7099,5556,5898,5721,6194,3106,3088,4957,1237,0.49%
4108957,4109,Sudeste Paranaense,41031,Prudentópolis,Guamiranga,PR,,,,7134,7548,7900,4009,3891,2236,5664,1.03%
4109005,4104,Norte Pioneiro Paranaense,41018,Wenceslau Braz,Guapirama,PR,5134,3168,3806,4068,3639,3886,1929,1957,2904,982,-0.46%
4109104,4101,Noroeste Paranaense,41003,Cianorte,Guaporema,PR,5975,2705,2290,2244,2190,2218,1134,1084,1280,938,-0.12%
4109203,4103,Norte Central Paranaense,41006,Astorga,Guaraci,PR,7678,5681,5549,4919,4993,5247,2582,2665,4214,1033,0.65%
4109302,4106,Oeste Paranaense,41023,Cascavel,Guaraniaçu,PR,28649,34465,26012,17201,15959,14583,7261,7322,7800,6783,-1.64%
4109401,4108,Centro-Sul Paranaense,41029,Guarapuava,Guarapuava,PR,110903,158585,159634,155161,164567,167463,81901,85562,153098,14365,0.77%
4109500,4110,Metropolitana de Curitiba,41038,Paranaguá,Guaraqueçaba,PR,7648,7650,7762,8288,7732,7870,4179,3691,2680,5190,-0.52%
4109609,4110,Metropolitana de Curitiba,41038,Paranaguá,Guaratuba,PR,9734,12178,17998,27257,30793,32088,15972,16116,28793,3295,1.65%
4109658,4108,Centro-Sul Paranaense,41030,Palmas,Honório Serpa,PR,,,,6896,6169,5960,3095,2865,1991,3969,-1.45%
4109708,4104,Norte Pioneiro Paranaense,41017,Ibaiti,Ibaiti,PR,31537,28465,26026,26448,28050,28725,14460,14265,23097,5628,0.83%
4109757,4106,Oeste Paranaense,41023,Cascavel,Ibema,PR,,,6106,5872,5927,6066,3036,3030,4941,1125,0.33%
4109807,4103,Norte Central Paranaense,41011,Londrina,Ibiporã,PR,27193,27621,35168,42153,45158,48200,23442,24758,45896,2304,1.35%
4109906,4101,Noroeste Paranaense,41002,Umuarama,Icaraíma,PR,24857,16391,11970,10048,9212,8839,4458,4381,6240,2599,-1.27%
4110003,4103,Norte Central Paranaense,41006,Astorga,Iguaraçu,PR,9855,6527,5691,3598,3741,3992,2010,1982,3569,423,1.04%
4110052,4106,Oeste Paranaense,41023,Cascavel,Iguatu,PR,,,,2255,2286,2233,1136,1097,1438,795,-0.10%
4110078,4105,Centro Oriental Paranaense,41019,Telêmaco Borba,Imbaú,PR,,,,9474,11191,11276,5748,5528,7067,4209,1.76%
4110102,4109,Sudeste Paranaense,41031,Prudentópolis,Imbituva,PR,20332,21983,25621,24496,27044,28455,14391,14064,17888,10567,1.51%
4110201,4108,Centro-Sul Paranaense,41029,Guarapuava,Inácio Martins,PR,7647,10468,13776,10963,11036,10943,5604,5339,6288,4655,-0.02%
4110300,4101,Noroeste Paranaense,41001,Paranavaí,Inajá,PR,4373,2684,2642,2915,2810,2988,1528,1460,2761,227,0.25%
4110409,4101,Noroeste Paranaense,41003,Cianorte,Indianópolis,PR,11612,9066,6742,4212,4138,4299,2189,2110,3148,1151,0.20%
4110508,4109,Sudeste Paranaense,41031,Prudentópolis,Ipiranga,PR,9523,10106,12590,13308,13993,14153,7330,6823,4892,9261,0.62%
4110607,4101,Noroeste Paranaense,41002,Umuarama,Iporã,PR,72115,37570,26032,16445,15086,14964,7379,7585,11775,3189,-0.94%
4110656,4106,Oeste Paranaense,41022,Toledo,Iracema do Oeste,PR,,,,2951,2580,2578,1320,1258,2002,576,-1.34%
4110706,4109,Sudeste Paranaense,41032,Irati,Irati,PR,36471,42228,47854,52352,54151,56288,27761,28527,45004,11284,0.73%
4110805,4102,Centro Ocidental Paranaense,41005,Campo Mourão,Iretama,PR,15042,22109,15814,11335,11174,10602,5422,5180,6177,4425,-0.67%
4110904,4103,Norte Central Paranaense,41006,Astorga,Itaguajé,PR,8563,5217,5054,4771,4508,4568,2296,2272,3636,932,-0.43%
4110953,4106,Oeste Paranaense,41024,Foz do Iguaçu,Itaipulândia,PR,,,,6836,8581,9027,4547,4480,4742,4285,2.82%
4111001,4104,Norte Pioneiro Paranaense,41015,Cornélio Procópio,Itambaracá,PR,11618,8655,9717,7090,6935,6759,3390,3369,5080,1679,-0.48%
4111100,4103,Norte Central Paranaense,41008,Floraí,Itambé,PR,15044,6556,6169,5956,5897,5977,2948,3029,5669,308,0.04%
4111209,4107,Sudoeste Paranaense,41027,Pato Branco,Itapejara d'Oeste,PR,10075,10110,9045,9162,10537,10532,5263,5269,6988,3544,1.40%
4111258,4110,Metropolitana de Curitiba,41037,Curitiba,Itaperuçu,PR,,,,19344,22021,23899,11989,11910,19966,3933,2.14%
4111308,4101,Noroeste Paranaense,41001,Paranavaí,Itaúna do Sul,PR,4604,4128,4555,4447,3699,3585,1822,1763,2549,1036,-2.13%
4111407,4109,Sudeste Paranaense,41031,Prudentópolis,Ivaí,PR,10107,10505,11454,11899,12840,12806,6672,6134,4623,8183,0.74%
4111506,4103,Norte Central Paranaense,41013,Ivaiporã,Ivaiporã,PR,67598,62836,45564,32270,31344,31812,15409,16403,27431,4381,-0.14%
4111555,4101,Noroeste Paranaense,41002,Umuarama,Ivaté,PR,,,,6925,7792,7524,3820,3704,5241,2283,0.83%
4111605,4103,Norte Central Paranaense,41008,Floraí,Ivatuba,PR,13921,2550,2508,2796,2715,3008,1435,1573,2294,714,0.73%
4111704,4104,Norte Pioneiro Paranaense,41017,Ibaiti,Jaboti,PR,5894,5190,4376,4590,5019,4895,2485,2410,3025,1870,0.65%
4111803,4104,Norte Pioneiro Paranaense,41016,Jacarezinho,Jacarezinho,PR,38741,38922,40858,39625,39327,39093,19120,19973,34763,4330,-0.14%
4111902,4103,Norte Central Paranaense,41006,Astorga,Jaguapitã,PR,16710,11987,10613,10932,11782,12256,6125,6131,10412,1844,1.15%
4112009,4105,Centro Oriental Paranaense,41020,Jaguariaíva,Jaguariaíva,PR,15100,15313,25149,30780,31865,32616,16097,16519,28051,4565,0.58%
4112108,4103,Norte Central Paranaense,41010,Apucarana,Jandaia do Sul,PR,21803,17756,18574,19676,19534,20283,9898,10385,18337,1946,0.30%
4112207,4102,Centro Ocidental Paranaense,41004,Goioerê,Janiópolis,PR,22698,13741,10614,8084,7032,6536,3274,3262,4042,2494,-2.10%
4112306,4104,Norte Pioneiro Paranaense,41017,Ibaiti,Japira,PR,8306,5774,4834,4901,4694,4910,2546,2364,2734,2176,0.02%
4112405,4101,Noroeste Paranaense,41003,Cianorte,Japurá,PR,12918,10492,8115,7755,8248,8547,4319,4228,7614,933,0.98%
4112504,4103,Norte Central Paranaense,41013,Ivaiporã,Jardim Alegre,PR,34870,28636,20446,13673,14315,12325,6272,6053,7175,5150,-1.03%
4112603,4101,Noroeste Paranaense,41001,Paranavaí,Jardim Olinda,PR,2415,1306,1405,1523,1461,1409,699,710,1001,408,-0.77%
4112702,4104,Norte Pioneiro Paranaense,41014,Assaí,Jataizinho,PR,10826,9551,10428,11327,11244,11859,5869,5990,11037,822,0.46%
4112751,4106,Oeste Paranaense,41022,Toledo,Jesuítas,PR,,,12841,9832,8825,9001,4470,4531,6070,2931,-0.88%
4112801,4104,Norte Pioneiro Paranaense,41018,Wenceslau Braz,Joaquim Távora,PR,12425,10383,9875,9661,10247,10735,5319,5416,8219,2516,1.06%
4112900,4104,Norte Pioneiro Paranaense,41016,Jacarezinho,Jundiaí do Sul,PR,8501,5406,4223,3659,3654,3433,1742,1691,1975,1458,-0.64%
4112959,4102,Centro Ocidental Paranaense,41004,Goioerê,Juranda,PR,,,8796,8134,7684,7641,3815,3826,5839,1802,-0.62%
4113007,4101,Noroeste Paranaense,41003,Cianorte,Jussara,PR,10745,5716,6046,6299,6090,6613,3264,3349,5936,677,0.49%
4113106,4103,Norte Central Paranaense,41012,Faxinal,Kaloré,PR,13978,8365,6568,5044,4664,4503,2281,2222,3217,1286,-1.13%
4113205,4110,Metropolitana de Curitiba,41036,Lapa,Lapa,PR,32122,35031,40150,41838,41679,44936,22646,22290,27228,17708,0.72%
4113254,4108,Centro-Sul Paranaense,41028,Pitanga,Laranjal,PR,,,,7121,6322,6361,3236,3125,2031,4330,-1.12%
4113304,4108,Centro-Sul Paranaense,41029,Guarapuava,Laranjeiras do Sul,PR,39651,62838,54102,30025,30481,30783,14993,15790,25039,5744,0.25%
4113403,4104,Norte Pioneiro Paranaense,41015,Cornélio Procópio,Leópolis,PR,12021,5180,4761,4440,4230,4145,2054,2091,2401,1744,-0.69%
4113429,4103,Norte Central Paranaense,41013,Ivaiporã,Lidianópolis,PR,,,,4783,4123,3972,1962,2010,2046,1926,-1.84%
4113452,4106,Oeste Paranaense,41023,Cascavel,Lindoeste,PR,,,6877,6224,5446,5363,2793,2570,2384,2979,-1.48%
4113502,4101,Noroeste Paranaense,41001,Paranavaí,Loanda,PR,19280,19458,17757,19549,19464,21211,10456,10755,19281,1930,0.82%
4113601,4103,Norte Central Paranaense,41006,Astorga,Lobato,PR,6178,3413,3762,4064,4219,4392,2224,2168,4099,293,0.78%
4113700,4103,Norte Central Paranaense,41011,Londrina,Londrina,PR,228101,301696,390100,447065,497833,506645,243017,263628,493457,13188,1.26%
4113734,4102,Centro Ocidental Paranaense,41005,Campo Mourão,Luiziana,PR,,,9103,7540,7204,7317,3742,3575,4762,2555,-0.30%
4113759,4103,Norte Central Paranaense,41013,Ivaiporã,Lunardelli,PR,,,7530,5668,5082,5156,2560,2596,3593,1563,-0.94%
4113809,4103,Norte Central Paranaense,41006,Astorga,Lupionópolis,PR,5898,5146,4459,4323,4375,4592,2261,2331,4079,513,0.61%
4113908,4109,Sudeste Paranaense,41032,Irati,Mallet,PR,9950,10041,11808,12602,12414,12973,6721,6252,7570,5403,0.29%
4114005,4102,Centro Ocidental Paranaense,41005,Campo Mourão,Mamborê,PR,34277,24646,16032,15156,14132,13968,6947,7021,8988,4980,-0.81%
4114104,4103,Norte Central Paranaense,41006,Astorga,Mandaguaçu,PR,16662,14016,14697,16828,18259,19784,9855,9929,17570,2214,1.63%
4114203,4103,Norte Central Paranaense,41009,Maringá,Mandaguari,PR,30410,24475,28086,31395,31890,32669,16032,16637,30950,1719,0.40%
4114302,4110,Metropolitana de Curitiba,41037,Curitiba,Mandirituba,PR,11036,15444,38336,17540,20408,22235,11338,10897,7419,14816,2.40%
4114351,4107,Sudoeste Paranaense,41026,Francisco Beltrão,Manfrinópolis,PR,,,,3802,3306,3127,1680,1447,652,2475,-1.94%
4114401,4108,Centro-Sul Paranaense,41030,Palmas,Mangueirinha,PR,15430,21151,25604,17760,17119,17041,8433,8608,8386,8655,-0.41%
4114500,4103,Norte Central Paranaense,41013,Ivaiporã,Manoel Ribas,PR,12552,16228,11956,13066,12762,13164,6525,6639,6802,6362,0.07%
4114609,4106,Oeste Paranaense,41022,Toledo,Marechal Cândido Rondon,PR,43776,56210,49430,41007,44562,46799,22833,23966,39134,7665,1.33%
4114708,4101,Noroeste Paranaense,41002,Umuarama,Maria Helena,PR,41270,24957,8439,6384,6012,5956,2994,2962,3994,1962,-0.69%
4114807,4103,Norte Central Paranaense,41009,Maringá,Marialva,PR,37496,42367,22625,28702,30017,31972,15797,16175,25794,6178,1.08%
4114906,4103,Norte Central Paranaense,41010,Apucarana,Marilândia do Sul,PR,21949,13915,13764,9071,8932,8855,4495,4360,6312,2543,-0.24%
4115002,4101,Noroeste Paranaense,41001,Paranavaí,Marilena,PR,6945,6975,6725,6756,6541,6854,3532,3322,4983,1871,0.14%
4115101,4101,Noroeste Paranaense,41002,Umuarama,Mariluz,PR,23082,13448,11053,10296,10461,10224,5113,5111,8467,1757,-0.07%
4115200,4103,Norte Central Paranaense,41009,Maringá,Maringá,PR,121374,168232,240292,288653,325968,357117,171748,185369,349120,7997,2.15%
4115309,4107,Sudoeste Paranaense,41027,Pato Branco,Mariópolis,PR,6866,6199,6280,6017,5805,6269,3116,3153,4469,1800,0.41%
4115358,4106,Oeste Paranaense,41022,Toledo,Maripá,PR,,,,5889,5571,5691,2843,2848,3267,2424,-0.34%
4115408,4107,Sudoeste Paranaense,41026,Francisco Beltrão,Marmeleiro,PR,12651,14388,17113,13665,13156,13909,6916,6993,8835,5074,0.18%
4115457,4108,Centro-Sul Paranaense,41029,Guarapuava,Marquinho,PR,,,,5659,5205,4983,2611,2372,523,4460,-1.26%
4115507,4103,Norte Central Paranaense,41012,Faxinal,Marumbi,PR,12554,6733,5007,4612,4142,4599,2283,2316,3139,1460,-0.03%
4115606,4106,Oeste Paranaense,41024,Foz do Iguaçu,Matelândia,PR,24561,33440,17329,14344,15404,16077,7968,8109,11612,4465,1.15%
4115705,4110,Metropolitana de Curitiba,41038,Paranaguá,Matinhos,PR,4317,5676,11325,24184,23357,29426,14333,15093,29277,149,1.98%
4115739,4108,Centro-Sul Paranaense,41028,Pitanga,Mato Rico,PR,,,,4496,4156,3822,2032,1790,961,2861,-1.61%
4115754,4103,Norte Central Paranaense,41010,Apucarana,Mauá da Serra,PR,,,,6471,7814,8553,4364,4189,7011,1542,2.83%
4115804,4106,Oeste Paranaense,41024,Foz do Iguaçu,Medianeira,PR,31142,49367,38665,37827,38397,41830,20578,21252,37403,4427,1.01%
4115853,4106,Oeste Paranaense,41022,Toledo,Mercedes,PR,,,,4608,4713,5046,2524,2522,2439,2607,0.91%
4115903,4101,Noroeste Paranaense,41001,Paranavaí,Mirador,PR,3130,2037,2337,2500,2336,2327,1181,1146,1579,748,-0.71%
4116000,4103,Norte Central Paranaense,41007,Porecatu,Miraselva,PR,7769,5941,5326,1961,1899,1858,922,936,1430,428,-0.54%
4116059,4106,Oeste Paranaense,41024,Foz do Iguaçu,Missal,PR,,,10372,10433,10412,10474,5269,5205,5420,5054,0.04%
4116109,4102,Centro Ocidental Paranaense,41004,Goioerê,Moreira Sales,PR,24007,18939,17004,13395,12926,12606,6315,6291,9933,2673,-0.61%
4116208,4110,Metropolitana de Curitiba,41038,Paranaguá,Morretes,PR,11836,13245,13135,15275,16198,15718,7950,7768,7178,8540,0.29%
4116307,4103,Norte Central Paranaense,41006,Astorga,Munhoz de Melo,PR,7376,4914,3628,3401,3552,3678,1839,1839,2980,698,0.79%
4116406,4103,Norte Central Paranaense,41006,Astorga,Nossa Senhora das Graças,PR,6288,4266,3480,3833,3903,3834,1953,1881,3183,651,0.00%
4116505,4101,Noroeste Paranaense,41001,Paranavaí,Nova Aliança do Ivaí,PR,1945,1080,1206,1338,1377,1433,717,716,1043,390,0.69%
4116604,4104,Norte Pioneiro Paranaense,41015,Cornélio Procópio,Nova América da Colina,PR,6891,4479,4105,3585,3298,3480,1770,1710,2526,954,-0.30%
4116703,4106,Oeste Paranaense,41023,Cascavel,Nova Aurora,PR,30588,18391,15494,13641,11753,11871,5832,6039,9045,2826,-1.38%
4116802,4102,Centro Ocidental Paranaense,41004,Goioerê,Nova Cantu,PR,15116,11789,11260,9914,7795,7425,3757,3668,4104,3321,-2.85%
4116901,4103,Norte Central Paranaense,41006,Astorga,Nova Esperança,PR,29379,23932,24189,25729,25719,26613,13018,13595,24314,2299,0.34%
4116950,4107,Sudoeste Paranaense,41026,Francisco Beltrão,Nova Esperança do Sudoeste,PR,,,,5258,5182,5110,2662,2448,1753,3357,-0.29%
4117008,4104,Norte Pioneiro Paranaense,41015,Cornélio Procópio,Nova Fátima,PR,12503,8200,8385,8305,8054,8153,4037,4116,6615,1538,-0.18%
4117057,4108,Centro-Sul Paranaense,41029,Guarapuava,Nova Laranjeiras,PR,,,,11699,11302,11239,5693,5546,2375,8864,-0.40%
4117107,4101,Noroeste Paranaense,41001,Paranavaí,Nova Londrina,PR,10679,12113,12854,13169,12619,13069,6419,6650,12024,1045,-0.08%
4117206,4101,Noroeste Paranaense,41002,Umuarama,Nova Olímpia,PR,9475,6262,5397,5280,5227,5506,2694,2812,4688,818,0.42%
4117214,4104,Norte Pioneiro Paranaense,41014,Assaí,Nova Santa Bárbara,PR,,,,3611,3802,3911,1896,2015,3282,629,0.80%
4117222,4106,Oeste Paranaense,41022,Toledo,Nova Santa Rosa,PR,,6895,7042,7125,7582,7625,3791,3834,5315,2310,0.68%
4117255,4107,Sudoeste Paranaense,41026,Francisco Beltrão,Nova Prata do Iguaçu,PR,,,11615,10397,10452,10369,5221,5148,6066,4303,-0.03%
4117271,4103,Norte Central Paranaense,41013,Ivaiporã,Nova Tebas,PR,,,17587,9476,8317,7389,3807,3582,2891,4498,-2.46%
4117297,4103,Norte Central Paranaense,41010,Apucarana,Novo Itacolomi,PR,,,,2866,2747,2827,1485,1342,1588,1239,-0.14%
4117305,4105,Centro Oriental Paranaense,41019,Telêmaco Borba,Ortigueira,PR,36689,50099,27504,25216,24397,23364,12067,11297,9574,13790,-0.76%
4117404,4103,Norte Central Paranaense,41008,Floraí,Ourizona,PR,8272,4879,3750,3396,3296,3380,1703,1677,3042,338,-0.05%
4117453,4106,Oeste Paranaense,41022,Toledo,Ouro Verde do Oeste,PR,,,6330,5472,5465,5690,2865,2825,4040,1650,0.39%
4117503,4103,Norte Central Paranaense,41009,Maringá,Paiçandu,PR,12093,11970,22197,30764,34640,35941,17840,18101,35450,491,1.57%
4117602,4108,Centro-Sul Paranaense,41030,Palmas,Palmas,PR,25811,30867,35262,34819,40485,42887,21180,21707,39803,3084,2.11%
4117701,4105,Centro Oriental Paranaense,41021,Ponta Grossa,Palmeira,PR,20030,24235,29046,30847,31234,32125,16046,16079,19376,12749,0.41%
4117800,4108,Centro-Sul Paranaense,41028,Pitanga,Palmital,PR,29420,34066,24317,16958,15454,14870,7515,7355,7403,7467,-1.31%
4117909,4106,Oeste Paranaense,41022,Toledo,Palotina,PR,43005,28253,30705,25771,27545,28692,14003,14689,24655,4037,1.08%
4118006,4101,Noroeste Paranaense,41001,Paranavaí,Paraíso do Norte,PR,11716,7834,8875,9739,11169,11781,5856,5925,11108,673,1.92%
4118105,4101,Noroeste Paranaense,41001,Paranavaí,Paranacity,PR,11642,8312,8528,9109,9513,10256,5115,5141,9475,781,1.19%
4118204,4110,Metropolitana de Curitiba,41038,Paranaguá,Paranaguá,PR,62327,81971,107675,127339,133559,140450,69301,71149,135405,5045,0.98%
4118303,4101,Noroeste Paranaense,41001,Paranavaí,Paranapoema,PR,4036,2158,2455,2393,2656,2791,1383,1408,2500,291,1.55%
4118402,4101,Noroeste Paranaense,41001,Paranavaí,Paranavaí,PR,57387,65286,71052,75750,79110,81595,39285,42310,77733,3862,0.75%
4118451,4106,Oeste Paranaense,41022,Toledo,Pato Bragado,PR,,,,4049,4631,4823,2367,2456,2991,1832,1.76%
4118501,4107,Sudoeste Paranaense,41027,Pato Branco,Pato Branco,PR,33808,45938,55675,62234,66680,72373,34984,37389,68093,4280,1.52%
4118600,4109,Sudeste Paranaense,41033,União da Vitória,Paula Freitas,PR,4695,4519,4665,5060,5457,5430,2800,2630,2748,2682,0.71%
4118709,4109,Sudeste Paranaense,41033,União da Vitória,Paulo Frontin,PR,5312,5356,6558,6565,7032,6913,3634,3279,2173,4740,0.52%
4118808,4102,Centro Ocidental Paranaense,41005,Campo Mourão,Peabiru,PR,24046,16966,14161,13487,13029,13622,6733,6889,11009,2613,0.10%
4118857,4101,Noroeste Paranaense,41002,Umuarama,Perobal,PR,,,,5291,5055,5648,2824,2824,3081,2567,0.66%
4118907,4101,Noroeste Paranaense,41002,Umuarama,Pérola,PR,26942,21531,15046,9282,9334,10208,5004,5204,8069,2139,0.96%
4119004,4107,Sudoeste Paranaense,41025,Capanema,Pérola d'Oeste,PR,15273,16684,12255,7354,7046,6764,3403,3361,3190,3574,-0.83%
4119103,4110,Metropolitana de Curitiba,41039,Rio Negro,Piên,PR,5353,5985,7745,9798,11083,11214,5745,5469,4514,6700,1.36%
4119152,4110,Metropolitana de Curitiba,41037,Curitiba,Pinhais,PR,,,,102985,112038,117166,56895,60271,117166,0,1.30%
4119202,4104,Norte Pioneiro Paranaense,41017,Ibaiti,Pinhalão,PR,7976,7268,5728,6217,5893,6210,3163,3047,3921,2289,-0.01%
4119251,4107,Sudoeste Paranaense,41026,Francisco Beltrão,Pinhal de São Bento,PR,,,,2560,2524,2620,1365,1255,1162,1458,0.23%
4119301,4108,Centro-Sul Paranaense,41029,Guarapuava,Pinhão,PR,20356,33460,35010,28408,29113,30233,15192,15041,15323,14910,0.62%
4119400,4105,Centro Oriental Paranaense,41020,Jaguariaíva,Piraí do Sul,PR,15013,17074,19414,21647,23170,23425,11621,11804,16104,7321,0.79%
4119509,4110,Metropolitana de Curitiba,41037,Curitiba,Piraquara,PR,21253,70641,106882,72886,82006,93279,48220,45059,45779,47500,2.50%
4119608,4108,Centro-Sul Paranaense,41028,Pitanga,Pitanga,PR,64014,84504,64514,35861,34310,32645,16247,16398,20587,12058,-0.94%
4119657,4103,Norte Central Paranaense,41011,Londrina,Pitangueiras,PR,,,,2418,2664,2814,1441,1373,2040,774,1.53%
4119707,4101,Noroeste Paranaense,41001,Paranavaí,Planaltina do Paraná,PR,8547,4688,3796,3992,3791,4095,2074,2021,2774,1321,0.26%
4119806,4107,Sudoeste Paranaense,41025,Capanema,Planalto,PR,17195,20279,15092,14122,13649,13668,6851,6817,6080,7588,-0.33%
4119905,4105,Centro Oriental Paranaense,41021,Ponta Grossa,Ponta Grossa,PR,126940,186656,233984,273616,306351,311697,151429,160268,304841,6856,1.31%
4119954,4110,Metropolitana de Curitiba,41038,Paranaguá,Pontal do Paraná,PR,,,,14323,16625,20919,10355,10564,20742,177,3.86%
4120002,4103,Norte Central Paranaense,41007,Porecatu,Porecatu,PR,22277,21464,17102,15881,14174,14183,7033,7150,11440,2743,-1.12%
4120101,4110,Metropolitana de Curitiba,41036,Lapa,Porto Amazonas,PR,2904,2915,3579,4236,4212,4515,2255,2260,2949,1566,0.64%
4120150,4108,Centro-Sul Paranaense,41029,Guarapuava,Porto Barreiro,PR,,,,4206,3761,3659,1914,1745,688,2971,-1.38%
4120200,4101,Noroeste Paranaense,41001,Paranavaí,Porto Rico,PR,6192,5344,3211,2550,2462,2531,1284,1247,1764,767,-0.07%
4120309,4109,Sudeste Paranaense,41033,União da Vitória,Porto Vitória,PR,3104,3520,3772,4051,3779,4020,2066,1954,2229,1791,-0.08%
4120333,4103,Norte Central Paranaense,41007,Porecatu,Prado Ferreira,PR,,,,3152,3344,3434,1735,1699,3016,418,0.86%
4120358,4107,Sudoeste Paranaense,41025,Capanema,Pranchita,PR,,,8604,6260,5811,5632,2817,2815,3609,2023,-1.05%
4120408,4103,Norte Central Paranaense,41006,Astorga,Presidente Castelo Branco,PR,5786,4773,3633,4305,4674,4775,2449,2326,4188,587,1.04%
4120507,4103,Norte Central Paranaense,41007,Porecatu,Primeiro de Maio,PR,25738,13217,11910,10728,10753,10832,5401,5431,10083,749,0.10%
4120606,4109,Sudeste Paranaense,41031,Prudentópolis,Prudentópolis,PR,34314,39723,47014,46346,48708,48793,24893,23900,22458,26335,0.52%
4120655,4102,Centro Ocidental Paranaense,41004,Goioerê,Quarto Centenário,PR,,,,5333,4848,4856,2391,2465,2912,1944,-0.93%
4120705,4104,Norte Pioneiro Paranaense,41018,Wenceslau Braz,Quatiguá,PR,6096,5312,5766,6742,6877,7044,3455,3589,6371,673,0.44%
4120804,4110,Metropolitana de Curitiba,41037,Curitiba,Quatro Barras,PR,4066,5717,10007,16161,18125,19786,9924,9862,17923,1863,2.04%
4120853,4106,Oeste Paranaense,41022,Toledo,Quatro Pontes,PR,,,,3646,3669,3804,1849,1955,2436,1368,0.43%
4120903,4108,Centro-Sul Paranaense,41029,Guarapuava,Quedas do Iguaçu,PR,11268,31507,31509,27364,30181,30585,15385,15200,20988,9597,1.12%
4121000,4101,Noroeste Paranaense,41001,Paranavaí,Querência do Norte,PR,14232,9070,10384,11438,11804,11749,5940,5809,7627,4122,0.27%
4121109,4102,Centro Ocidental Paranaense,41005,Campo Mourão,Quinta do Sol,PR,15891,7688,5599,5759,5173,5085,2543,2542,3809,1276,-1.24%
4121208,4110,Metropolitana de Curitiba,41039,Rio Negro,Quitandinha,PR,10853,12395,14418,15272,15897,17088,8838,8250,4886,12202,1.13%
4121257,4106,Oeste Paranaense,41024,Foz do Iguaçu,Ramilândia,PR,,,,3868,4147,4134,2124,2010,2043,2091,0.67%
4121307,4104,Norte Pioneiro Paranaense,41014,Assaí,Rancho Alegre,PR,7499,4899,4509,4197,4001,3955,1953,2002,3470,485,-0.59%
4121356,4102,Centro Ocidental Paranaense,41004,Goioerê,Rancho Alegre D'Oeste,PR,,,,3117,2928,2847,1415,1432,2303,544,-0.90%
4121406,4107,Sudoeste Paranaense,41025,Capanema,Realeza,PR,16737,21709,17146,16023,15809,16348,8005,8343,11808,4540,0.20%
4121505,4109,Sudeste Paranaense,41032,Irati,Rebouças,PR,11130,10915,12948,13663,14053,14176,7201,6975,7505,6671,0.37%
4121604,4107,Sudoeste Paranaense,41026,Francisco Beltrão,Renascença,PR,9280,7909,7546,6959,6762,6810,3424,3386,3483,3327,-0.22%
4121703,4105,Centro Oriental Paranaense,41019,Telêmaco Borba,Reserva,PR,20917,23611,25084,23977,24249,25177,12927,12250,12211,12966,0.49%
4121752,4108,Centro-Sul Paranaense,41029,Guarapuava,Reserva do Iguaçu,PR,,,,6678,7094,7327,3763,3564,3921,3406,0.93%
4121802,4104,Norte Pioneiro Paranaense,41016,Jacarezinho,Ribeirão Claro,PR,14706,12562,11385,10903,10882,10690,5278,5412,7093,3597,-0.20%
4121901,4104,Norte Pioneiro Paranaense,41015,Cornélio Procópio,Ribeirão do Pinhal,PR,19086,14837,13841,14341,13389,13522,6731,6791,11088,2434,-0.59%
4122008,4109,Sudeste Paranaense,41032,Irati,Rio Azul,PR,9681,10697,12406,13023,13248,14093,7340,6753,5012,9081,0.79%
4122107,4103,Norte Central Paranaense,41012,Faxinal,Rio Bom,PR,10272,5015,4197,3546,3260,3334,1742,1592,2007,1327,-0.61%
4122156,4108,Centro-Sul Paranaense,41029,Guarapuava,Rio Bonito do Iguaçu,PR,,,,13791,14450,13660,7064,6596,3325,10335,-0.10%
4122172,4103,Norte Central Paranaense,41013,Ivaiporã,Rio Branco do Ivaí,PR,,,,3758,3850,3897,1962,1935,919,2978,0.36%
4122206,4110,Metropolitana de Curitiba,41037,Curitiba,Rio Branco do Sul,PR,25133,31780,38296,29341,31486,30662,15553,15109,22044,8618,0.44%
4122305,4110,Metropolitana de Curitiba,41039,Rio Negro,Rio Negro,PR,18436,21665,26315,28710,29862,31261,15556,15705,25700,5561,0.85%
4122404,4103,Norte Central Paranaense,41011,Londrina,Rolândia,PR,47964,41452,43776,49410,53437,57870,28462,29408,54758,3112,1.59%
4122503,4102,Centro Ocidental Paranaense,41005,Campo Mourão,Roncador,PR,13468,17991,17573,13632,12265,11544,5824,5720,7126,4418,-1.65%
4122602,4101,Noroeste Paranaense,41003,Cianorte,Rondon,PR,22005,12999,8647,8527,9023,9005,4569,4436,7200,1805,0.55%
4122651,4103,Norte Central Paranaense,41013,Ivaiporã,Rosário do Ivaí,PR,,,9908,6585,5823,5586,2828,2758,2721,2865,-1.63%
4122701,4103,Norte Central Paranaense,41010,Apucarana,Sabáudia,PR,8323,4928,5293,5413,5447,6095,3050,3045,5096,999,1.19%
4122800,4107,Sudoeste Paranaense,41026,Francisco Beltrão,Salgado Filho,PR,12305,15538,13829,5338,4666,4403,2248,2155,2252,2151,-1.91%
4122909,4104,Norte Pioneiro Paranaense,41018,Wenceslau Braz,Salto do Itararé,PR,7383,7482,6360,5549,5087,5178,2614,2564,3723,1455,-0.69%
4123006,4107,Sudoeste Paranaense,41026,Francisco Beltrão,Salto do Lontra,PR,31448,34251,14297,12757,12480,13672,6934,6738,7429,6243,0.70%
4123105,4104,Norte Pioneiro Paranaense,41015,Cornélio Procópio,Santa Amélia,PR,7065,4620,4628,4407,4062,3804,1909,1895,2887,917,-1.46%
4123204,4104,Norte Pioneiro Paranaense,41014,Assaí,Santa Cecília do Pavão,PR,13313,9871,8642,4064,3676,3646,1804,1842,3057,589,-1.08%
4123303,4101,Noroeste Paranaense,41001,Paranavaí,Santa Cruz de Monte Castelo,PR,13180,10002,10209,8578,7924,8093,4054,4039,5744,2349,-0.58%
4123402,4103,Norte Central Paranaense,41006,Astorga,Santa Fé,PR,11527,9510,8708,8870,9774,10436,5119,5317,9230,1206,1.64%
4123501,4106,Oeste Paranaense,41022,Toledo,Santa Helena,PR,26834,34882,18861,20491,22794,23425,11507,11918,12596,10829,1.35%
4123600,4103,Norte Central Paranaense,41006,Astorga,Santa Inês,PR,4862,2895,2044,2099,1878,1818,927,891,1192,626,-1.43%
4123709,4101,Noroeste Paranaense,41001,Paranavaí,Santa Isabel do Ivaí,PR,21191,20242,12858,9154,8509,8755,4383,4372,7056,1699,-0.44%
4123808,4107,Sudoeste Paranaense,41025,Capanema,Santa Izabel do Oeste,PR,14903,15995,12510,11711,11434,13134,6621,6513,7427,5707,1.15%
4123824,4106,Oeste Paranaense,41023,Cascavel,Santa Lúcia,PR,,,,4126,3725,3926,1959,1967,2537,1389,-0.50%
4123857,4108,Centro-Sul Paranaense,41028,Pitanga,Santa Maria do Oeste,PR,,,,13639,11548,11497,5911,5586,3209,8288,-1.69%
4123907,4104,Norte Pioneiro Paranaense,41015,Cornélio Procópio,Santa Mariana,PR,22793,15380,14711,13470,11992,12437,6174,6263,8323,4114,-0.79%
4123956,4101,Noroeste Paranaense,41001,Paranavaí,Santa Mônica,PR,,,,3190,3453,3570,1845,1725,1475,2095,1.13%
4124004,4104,Norte Pioneiro Paranaense,41018,Wenceslau Braz,Santana do Itararé,PR,7525,7530,6030,5638,5537,5249,2643,2606,3456,1793,-0.71%
4124020,4106,Oeste Paranaense,41023,Cascavel,Santa Tereza do Oeste,PR,,,6118,10754,9378,10342,5247,5095,8038,2304,-0.39%
4124053,4106,Oeste Paranaense,41024,Foz do Iguaçu,Santa Terezinha de Itaipu,PR,,,14149,18368,19552,20834,10198,10636,18832,2002,1.27%
4124103,4104,Norte Pioneiro Paranaense,41016,Jacarezinho,Santo Antônio da Platina,PR,38627,36781,38714,39943,40480,42688,20968,21720,36937,5751,0.67%
4124202,4101,Noroeste Paranaense,41001,Paranavaí,Santo Antônio do Caiuá,PR,7243,4043,3111,2878,2692,2732,1349,1383,2128,604,-0.52%
4124301,4104,Norte Pioneiro Paranaense,41015,Cornélio Procópio,Santo Antônio do Paraíso,PR,7132,3360,2488,2790,2354,2412,1203,1209,1826,586,-1.45%
4124400,4107,Sudoeste Paranaense,41026,Francisco Beltrão,Santo Antônio do Sudoeste,PR,29533,35193,20290,17870,18565,18905,9279,9626,13712,5193,0.56%
4124509,4103,Norte Central Paranaense,41006,Astorga,Santo Inácio,PR,8353,5605,5514,5188,4876,5269,2663,2606,4200,1069,0.16%
4124608,4101,Noroeste Paranaense,41001,Paranavaí,São Carlos do Ivaí,PR,7575,4706,4972,5904,5817,6352,3255,3097,5679,673,0.73%
4124707,4104,Norte Pioneiro Paranaense,41014,Assaí,São Jerônimo da Serra,PR,24460,16383,13275,11750,11563,11336,5845,5491,5657,5679,-0.36%
4124806,4107,Sudoeste Paranaense,41027,Pato Branco,São João,PR,15454,17084,13661,11207,10900,10607,5243,5364,6746,3861,-0.55%
4124905,4101,Noroeste Paranaense,41001,Paranavaí,São João do Caiuá,PR,10266,7199,6008,6091,5979,5909,2923,2986,5039,870,-0.30%
4125001,4103,Norte Central Paranaense,41013,Ivaiporã,São João do Ivaí,PR,47762,41293,16663,13196,11854,11523,5672,5851,8879,2644,-1.35%
4125100,4109,Sudeste Paranaense,41034,São Mateus do Sul,São João do Triunfo,PR,10296,10803,12320,12418,13611,13704,7208,6496,4048,9656,0.99%
4125209,4107,Sudoeste Paranaense,41026,Francisco Beltrão,São Jorge d'Oeste,PR,12036,13717,10321,9307,8979,9085,4546,4539,5214,3871,-0.24%
4125308,4103,Norte Central Paranaense,41008,Floraí,São Jorge do Ivaí,PR,17912,9130,6087,5590,5286,5508,2725,2783,4772,736,-0.15%
4125357,4101,Noroeste Paranaense,41002,Umuarama,São Jorge do Patrocínio,PR,,,9137,6604,6031,6047,3067,2980,3542,2505,-0.88%
4125407,4104,Norte Pioneiro Paranaense,41018,Wenceslau Braz,São José da Boa Vista,PR,8500,9787,8507,6978,6293,6511,3365,3146,3864,2647,-0.69%
4125456,4106,Oeste Paranaense,41022,Toledo,São José das Palmeiras,PR,,,5596,4102,3873,3831,1927,1904,2412,1419,-0.68%
4125506,4110,Metropolitana de Curitiba,41037,Curitiba,São José dos Pinhais,PR,34124,70643,127455,204316,263622,263488,130211,133277,236233,27255,2.58%
4125555,4101,Noroeste Paranaense,41003,Cianorte,São Manoel do Paraná,PR,,,,2072,2093,2098,1054,1044,1159,939,0.12%
4125605,4109,Sudeste Paranaense,41034,São Mateus do Sul,São Mateus do Sul,PR,23635,26977,33138,36569,39152,41257,20782,20475,25706,15551,1.21%
4125704,4106,Oeste Paranaense,41024,Foz do Iguaçu,São Miguel do Iguaçu,PR,25242,34241,24721,24432,25341,25755,12835,12920,16476,9279,0.53%
4125753,4106,Oeste Paranaense,41022,Toledo,São Pedro do Iguaçu,PR,,,,7277,6540,6492,3291,3201,4056,2436,-1.13%
4125803,4103,Norte Central Paranaense,41013,Ivaiporã,São Pedro do Ivaí,PR,19378,10464,9333,9473,9569,10164,5107,5057,8038,2126,0.71%
4125902,4101,Noroeste Paranaense,41001,Paranavaí,São Pedro do Paraná,PR,6378,4833,3247,2738,2532,2494,1263,1231,1633,861,-0.93%
4126009,4104,Norte Pioneiro Paranaense,41014,Assaí,São Sebastião da Amoreira,PR,12809,6931,7943,8548,8681,8629,4257,4372,7596,1033,0.09%
4126108,4101,Noroeste Paranaense,41003,Cianorte,São Tomé,PR,9298,7160,5115,5045,5279,5349,2696,2653,4446,903,0.59%
4126207,4104,Norte Pioneiro Paranaense,41017,Ibaiti,Sapopema,PR,8622,8416,7095,6872,6638,6736,3507,3229,3552,3184,-0.20%
4126256,4103,Norte Central Paranaense,41009,Maringá,Sarandi,PR,,,47981,71422,79686,82842,40839,42003,82155,687,1.49%
4126272,4107,Sudoeste Paranaense,41027,Pato Branco,Saudade do Iguaçu,PR,,,,4608,4931,5007,2526,2481,2500,2507,0.83%
4126306,4105,Centro Oriental Paranaense,41020,Jaguariaíva,Sengés,PR,11754,13566,14995,17778,19356,18410,9462,8948,15108,3302,0.35%
4126355,4106,Oeste Paranaense,41024,Foz do Iguaçu,Serranópolis do Iguaçu,PR,,,,4740,4327,4568,2229,2339,2322,2246,-0.37%
4126405,4104,Norte Pioneiro Paranaense,41015,Cornélio Procópio,Sertaneja,PR,14295,6928,6708,6521,5894,5817,2896,2921,5105,712,-1.14%
4126504,4103,Norte Central Paranaense,41007,Porecatu,Sertanópolis,PR,21877,16492,14291,15147,15485,15637,7753,7884,13716,1921,0.32%
4126603,4104,Norte Pioneiro Paranaense,41018,Wenceslau Braz,Siqueira Campos,PR,15643,15348,14226,16000,16663,18446,9197,9249,13419,5027,1.43%
4126652,4107,Sudoeste Paranaense,41027,Pato Branco,Sulina,PR,,,5222,3918,3445,3394,1713,1681,1390,2004,-1.43%
4126678,4103,Norte Central Paranaense,41011,Londrina,Tamarana,PR,,,,9713,10887,12232,6253,5979,5857,6375,2.33%
4126702,4101,Noroeste Paranaense,41001,Paranavaí,Tamboara,PR,9793,5267,4579,4255,4564,4664,2309,2355,3995,669,0.92%
4126801,4101,Noroeste Paranaense,41003,Cianorte,Tapejara,PR,22220,12780,12057,13120,14498,14600,7306,7294,13168,1432,1.07%
4126900,4101,Noroeste Paranaense,41002,Umuarama,Tapira,PR,21313,12470,8528,6282,5829,5834,2918,2916,3434,2400,-0.74%
4127007,4109,Sudeste Paranaense,41031,Prudentópolis,Teixeira Soares,PR,12879,12886,14021,8192,9781,10277,5327,4950,4793,5484,2.29%
4127106,4105,Centro Oriental Paranaense,41019,Telêmaco Borba,Telêmaco Borba,PR,37238,54583,64963,61238,65797,69878,34388,35490,68431,1447,1.33%
4127205,4102,Centro Ocidental Paranaense,41005,Campo Mourão,Terra Boa,PR,19673,16267,14249,14640,14588,15791,7831,7960,13057,2734,0.76%
4127304,4101,Noroeste Paranaense,41001,Paranavaí,Terra Rica,PR,18004,16991,13909,13797,14405,15256,7624,7632,12393,2863,1.01%
4127403,4106,Oeste Paranaense,41022,Toledo,Terra Roxa,PR,38237,25225,19820,16300,16208,16763,8300,8463,12802,3961,0.28%
4127502,4105,Centro Oriental Paranaense,41019,Telêmaco Borba,Tibagi,PR,20386,20600,22759,18434,18710,19332,9793,9539,11675,7657,0.48%
4127601,4110,Metropolitana de Curitiba,41039,Rio Negro,Tijucas do Sul,PR,7848,8001,10224,12260,13091,14526,7537,6989,2267,12259,1.71%
4127700,4106,Oeste Paranaense,41022,Toledo,Toledo,PR,68885,81287,94879,98200,109857,119353,58359,60994,108287,11066,1.97%
4127809,4104,Norte Pioneiro Paranaense,41018,Wenceslau Braz,Tomazina,PR,20027,15943,11912,9931,8814,8788,4528,4260,4119,4669,-1.22%
4127858,4106,Oeste Paranaense,41023,Cascavel,Três Barras do Paraná,PR,,,14982,11822,11718,11824,5994,5830,6095,5729,0.00%
4127882,4110,Metropolitana de Curitiba,41037,Curitiba,Tunas do Paraná,PR,,,,3611,5921,6258,3272,2986,2790,3468,5.65%
4127908,4101,Noroeste Paranaense,41003,Cianorte,Tuneiras do Oeste,PR,19838,12290,11460,9013,8598,8697,4443,4254,5975,2722,-0.36%
4127957,4106,Oeste Paranaense,41022,Toledo,Tupãssi,PR,,,8829,8018,7755,7997,4053,3944,6286,1711,-0.03%
4127965,4108,Centro-Sul Paranaense,41029,Guarapuava,Turvo,PR,,,14146,14530,14025,13838,6991,6847,5053,8785,-0.49%
4128005,4102,Centro Ocidental Paranaense,41004,Goioerê,Ubiratã,PR,39940,27326,26828,22593,21214,21562,10509,11053,18400,3162,-0.47%
4128104,4101,Noroeste Paranaense,41002,Umuarama,Umuarama,PR,113697,100555,100249,90690,95153,100716,48818,51898,93489,7227,1.05%
4128203,4109,Sudeste Paranaense,41033,União da Vitória,União da Vitória,PR,29750,39639,44008,48522,51043,52753,25826,26927,50002,2751,0.84%
4128302,4103,Norte Central Paranaense,41006,Astorga,Uniflor,PR,4169,3092,2662,2362,2402,2465,1231,1234,1986,479,0.43%
4128401,4104,Norte Pioneiro Paranaense,41014,Assaí,Uraí,PR,18401,13974,13299,11876,11489,11472,5680,5792,9358,2114,-0.35%
4128500,4104,Norte Pioneiro Paranaense,41018,Wenceslau Braz,Wenceslau Braz,PR,15688,18452,18872,19559,18691,19294,9512,9782,15505,3789,-0.14%
4128534,4105,Centro Oriental Paranaense,41019,Telêmaco Borba,Ventania,PR,,,,8024,10275,9967,5147,4820,6515,3452,2.19%
4128559,4106,Oeste Paranaense,41024,Foz do Iguaçu,Vera Cruz do Oeste,PR,,,11370,9651,9099,8973,4411,4562,6863,2110,-0.73%
4128609,4107,Sudoeste Paranaense,41026,Francisco Beltrão,Verê,PR,12709,12268,10212,8721,8002,7879,3938,3941,3284,4595,-1.01%
4128625,4101,Noroeste Paranaense,41002,Umuarama,Alto Paraíso,PR,,,,3783,3252,3206,1619,1587,1772,1434,-1.64%
4128633,4110,Metropolitana de Curitiba,41035,Cerro Azul,Doutor Ulysses,PR,,,,6003,5956,5734,2980,2754,939,4795,-0.46%
4128658,4108,Centro-Sul Paranaense,41029,Guarapuava,Virmond,PR,,,,3949,4024,3950,1999,1951,1880,2070,0.00%
4128708,4107,Sudoeste Paranaense,41027,Pato Branco,Vitorino,PR,7622,6830,6478,6285,6310,6509,3228,3281,3981,2528,0.35%
4128807,4101,Noroeste Paranaense,41002,Umuarama,Xambrê,PR,19851,12126,8771,6500,5818,6011,2998,3013,1991,4020,-0.78%
3300100,3305,Sul Fluminense,33013,Baía da Ilha Grande,Angra dos Reis,RJ,40276,57869,85571,119247,148476,169270,84490,84780,163080,6190,3.57%
3300159,3301,Noroeste Fluminense,33002,Santo Antônio de Pádua,Aperibé,RJ,,,,8018,8820,10215,5023,5192,8880,1335,2.45%
3300209,3304,Baixadas,33010,Lagos,Araruama,RJ,40031,49827,59024,82803,98268,112028,54305,57723,106519,5509,3.07%
3300225,3303,Centro Fluminense,33005,Três Rios,Areal,RJ,,,,9899,11009,11421,5663,5758,9920,1501,1.44%
3300233,3304,Baixadas,33010,Lagos,Armação dos Búzios,RJ,,,,18204,24560,27538,13737,13801,27538,0,4.23%
3300258,3304,Baixadas,33010,Lagos,Arraial do Cabo,RJ,,,19866,23877,25248,27770,13647,14123,27770,0,1.52%
3300308,3305,Sul Fluminense,33012,Barra do Piraí,Barra do Piraí,RJ,59076,71930,79199,88503,96282,94855,45208,49647,92040,2815,0.70%
3300407,3305,Sul Fluminense,33011,Vale do Paraíba Fluminense,Barra Mansa,RJ,101660,154719,172216,170753,175315,177861,85822,92039,176251,1610,0.41%
3300456,3306,Metropolitana do Rio de Janeiro,33018,Rio de Janeiro,Belford Roxo,RJ,,,,434474,480555,469261,226757,242504,469261,0,0.77%
3300506,3303,Centro Fluminense,33007,Nova Friburgo,Bom Jardim,RJ,17095,18534,20630,22651,24626,25398,12756,12642,15281,10117,1.15%
3300605,3301,Noroeste Fluminense,33001,Itaperuna,Bom Jesus do Itabapoana,RJ,29418,27968,29873,33655,33888,35384,17179,18205,29912,5472,0.50%
3300704,3304,Baixadas,33010,Lagos,Cabo Frio,RJ,44379,70961,84915,126828,162229,186222,90806,95416,140466,45756,3.92%
3300803,3306,Metropolitana do Rio de Janeiro,33016,Macacu-Caceribu,Cachoeiras de Macacu,RJ,33793,35871,40208,48543,53037,54370,27127,27243,47015,7355,1.14%
3300902,3301,Noroeste Fluminense,33002,Santo Antônio de Pádua,Cambuci,RJ,24424,21038,21011,14670,14368,14829,7402,7427,11301,3528,0.11%
3300936,3302,Norte Fluminense,33004,Macaé,Carapebus,RJ,,,,8666,10677,13348,6792,6556,10542,2806,4.41%
3300951,3303,Centro Fluminense,33005,Três Rios,Comendador Levy Gasparian,RJ,,,,7924,8322,8183,4080,4103,7865,318,0.32%
3301009,3302,Norte Fluminense,33003,Campos dos Goytacazes,Campos dos Goytacazes,RJ,318806,348542,389109,406989,426154,463545,223100,240445,418565,44980,1.31%
3301108,3303,Centro Fluminense,33006,Cantagalo-Cordeiro,Cantagalo,RJ,18590,19190,19672,19835,19799,19826,9840,9986,14027,5799,-0.00%
3301157,3302,Norte Fluminense,33003,Campos dos Goytacazes,Cardoso Moreira,RJ,,,,12595,12206,12540,6243,6297,8764,3776,-0.04%
3301207,3303,Centro Fluminense,33006,Cantagalo-Cordeiro,Carmo,RJ,11787,12270,14509,15289,16690,17439,8603,8836,13474,3965,1.32%
3301306,3304,Baixadas,33009,Bacia de São João,Casimiro de Abreu,RJ,16799,22161,33845,22152,27086,35373,17436,17937,28533,6840,4.79%
3301405,3302,Norte Fluminense,33004,Macaé,Conceição de Macabu,RJ,11560,13624,16963,18782,19479,21200,10543,10657,18332,2868,1.22%
3301504,3303,Centro Fluminense,33006,Cantagalo-Cordeiro,Cordeiro,RJ,12859,15354,20781,18601,18984,20403,9761,10642,19835,568,0.93%
3301603,3303,Centro Fluminense,33007,Nova Friburgo,Duas Barras,RJ,7874,7992,9875,10334,10438,10933,5512,5421,7739,3194,0.57%
3301702,3306,Metropolitana do Rio de Janeiro,33018,Rio de Janeiro,Duque de Caxias,RJ,431397,575830,667821,775456,842686,855046,410959,444087,852131,2915,0.98%
3301801,3306,Metropolitana do Rio de Janeiro,33014,Vassouras,Engenheiro Paulo de Frontin,RJ,11556,12917,12061,12164,12544,13239,6451,6788,9525,3714,0.85%
3301850,3306,Metropolitana do Rio de Janeiro,33018,Rio de Janeiro,Guapimirim,RJ,,,,37952,44692,51487,25289,26198,49757,1730,3.10%
3301876,3304,Baixadas,33010,Lagos,Iguaba Grande,RJ,,,,15089,19716,22858,11044,11814,22858,0,4.24%
3301900,3306,Metropolitana do Rio de Janeiro,33018,Rio de Janeiro,Itaboraí,RJ,65912,114542,162742,187479,215792,218090,106214,111876,215503,2587,1.52%
3302007,3306,Metropolitana do Rio de Janeiro,33017,Itaguaí,Itaguaí,RJ,55839,90131,113057,82003,95356,109163,54426,54737,104292,4871,2.90%
3302056,3301,Noroeste Fluminense,33001,Itaperuna,Italva,RJ,,,12764,12621,13645,14027,6834,7193,10228,3799,1.06%
3302106,3301,Noroeste Fluminense,33002,Santo Antônio de Pádua,Itaocara,RJ,22264,21309,22933,23003,22069,22902,11193,11709,17329,5573,-0.04%
3302205,3301,Noroeste Fluminense,33001,Itaperuna,Itaperuna,RJ,60622,63094,78000,86720,92852,95876,46541,49335,88408,7468,1.01%
3302254,3305,Sul Fluminense,33011,Vale do Paraíba Fluminense,Itatiaia,RJ,,,16073,24739,31185,28852,14248,14604,27848,1004,1.55%
3302270,3306,Metropolitana do Rio de Janeiro,33018,Rio de Janeiro,Japeri,RJ,,,,83278,93197,95391,48058,47333,95391,0,1.37%
3302304,3301,Noroeste Fluminense,33001,Itaperuna,Laje do Muriaé,RJ,8538,7517,7464,7909,7769,7491,3754,3737,5636,1855,-0.54%
3302403,3302,Norte Fluminense,33004,Macaé,Macaé,RJ,65318,75863,100895,132461,169513,206748,102471,104277,202873,3875,4.55%
3302452,3303,Centro Fluminense,33006,Cantagalo-Cordeiro,Macuco,RJ,,,,4886,5246,5269,2528,2741,4593,676,0.76%
3302502,3306,Metropolitana do Rio de Janeiro,33018,Rio de Janeiro,Magé,RJ,113023,166603,191734,205830,232171,228150,110970,117180,215941,12209,1.03%
3302601,3306,Metropolitana do Rio de Janeiro,33017,Itaguaí,Mangaratiba,RJ,12338,13841,17925,24901,29253,36311,17876,18435,31989,4322,3.84%
3302700,3306,Metropolitana do Rio de Janeiro,33018,Rio de Janeiro,Maricá,RJ,23664,32618,46545,76737,105294,127519,62695,64824,125532,1987,5.21%
3302809,3306,Metropolitana do Rio de Janeiro,33014,Vassouras,Mendes,RJ,12748,15532,16598,17289,17242,17940,8657,9283,17706,234,0.37%
3302858,3306,Metropolitana do Rio de Janeiro,33018,Rio de Janeiro,Mesquita,RJ,,,,,182495,168403,79775,88628,168403,0,-
3302908,3306,Metropolitana do Rio de Janeiro,33014,Vassouras,Miguel Pereira,RJ,13652,14733,19446,23902,24585,24647,11727,12920,21508,3139,0.31%
3303005,3301,Noroeste Fluminense,33002,Santo Antônio de Pádua,Miracema,RJ,21187,22005,25091,27064,26231,26829,13015,13814,24701,2128,-0.09%
3303104,3301,Noroeste Fluminense,33001,Itaperuna,Natividade,RJ,20154,19879,21765,15125,14930,15077,7441,7636,12041,3036,-0.03%
3303203,3306,Metropolitana do Rio de Janeiro,33018,Rio de Janeiro,Nilópolis,RJ,128011,151585,158092,153712,153581,157483,73714,83769,157483,0,0.24%
3303302,3306,Metropolitana do Rio de Janeiro,33018,Rio de Janeiro,Niterói,RJ,324246,397135,436155,459451,474002,487327,225671,261656,487327,0,0.59%
3303401,3303,Centro Fluminense,33007,Nova Friburgo,Nova Friburgo,RJ,90420,123383,167081,173418,177376,182016,87242,94774,159335,22681,0.49%
3303500,3306,Metropolitana do Rio de Janeiro,33018,Rio de Janeiro,Nova Iguaçu,RJ,727140,1094789,1297704,920599,830672,795212,381198,414014,786536,8676,-1.45%
3303609,3306,Metropolitana do Rio de Janeiro,33014,Vassouras,Paracambi,RJ,25368,30310,36427,40475,42423,47074,23753,23321,41677,5397,1.52%
3303708,3303,Centro Fluminense,33005,Três Rios,Paraíba do Sul,RJ,26736,29245,33922,37410,39257,41088,19770,21318,36159,4929,0.94%
3303807,3305,Sul Fluminense,33013,Baía da Ilha Grande,Paraty,RJ,15934,20626,23928,29544,32838,37575,18992,18583,27717,9858,2.43%
3303856,3306,Metropolitana do Rio de Janeiro,33014,Vassouras,Paty do Alferes,RJ,,,21095,24931,25132,26381,12819,13562,18607,7774,0.57%
3303906,3306,Metropolitana do Rio de Janeiro,33015,Serrana,Petrópolis,RJ,189140,242017,255468,286537,306645,296044,141079,154965,281356,14688,0.33%
3303955,3305,Sul Fluminense,33011,Vale do Paraíba Fluminense,Pinheiral,RJ,,,,19481,20885,22724,11036,11688,20414,2310,1.55%
3304003,3305,Sul Fluminense,33011,Vale do Paraíba Fluminense,Piraí,RJ,24150,28789,33782,22118,24170,26309,12920,13389,20831,5478,1.75%
3304102,3301,Noroeste Fluminense,33001,Itaperuna,Porciúncula,RJ,12395,13452,14561,15952,17178,17771,8873,8898,13902,3869,1.09%
3304110,3305,Sul Fluminense,33011,Vale do Paraíba Fluminense,Porto Real,RJ,,,,12095,14503,16574,8232,8342,16481,93,3.20%
3304128,3305,Sul Fluminense,33011,Vale do Paraíba Fluminense,Quatis,RJ,,,,10730,12031,12831,6261,6570,12067,764,1.80%
3304144,3306,Metropolitana do Rio de Janeiro,33018,Rio de Janeiro,Queimados,RJ,,,,121993,130275,137938,66621,71317,137938,0,1.24%
3304151,3302,Norte Fluminense,33004,Macaé,Quissamã,RJ,,,10467,13674,17376,20244,10036,10208,13016,7228,4.00%
3304201,3305,Sul Fluminense,33011,Vale do Paraíba Fluminense,Resende,RJ,66907,87338,91757,104549,118547,119801,58244,61557,112375,7426,1.37%
3304300,3306,Metropolitana do Rio de Janeiro,33016,Macacu-Caceribu,Rio Bonito,RJ,34434,40038,45161,49691,51942,55586,27349,28237,41267,14319,1.13%
3304409,3305,Sul Fluminense,33011,Vale do Paraíba Fluminense,Rio Claro,RJ,14251,12916,13665,16228,17216,17401,8747,8654,13754,3647,0.70%
3304508,3305,Sul Fluminense,33012,Barra do Piraí,Rio das Flores,RJ,7183,6853,6451,7625,8192,8545,4201,4344,5948,2597,1.15%
3304524,3304,Baixadas,33009,Bacia de São João,Rio das Ostras,RJ,,,,36419,74750,105757,52240,53517,99999,5758,11.25%
3304557,3306,Metropolitana do Rio de Janeiro,33018,Rio de Janeiro,Rio de Janeiro,RJ,4251918,5090723,5480768,5857904,6093472,6323037,2960954,3362083,6323037,0,0.77%
3304607,3303,Centro Fluminense,33008,Santa Maria Madalena,Santa Maria Madalena,RJ,12452,11082,10850,10476,10409,10321,5275,5046,5932,4389,-0.15%
3304706,3301,Noroeste Fluminense,33002,Santo Antônio de Pádua,Santo Antônio de Pádua,RJ,31151,33520,39600,38692,40145,40569,19946,20623,31086,9483,0.47%
3304755,3302,Norte Fluminense,33003,Campos dos Goytacazes,São Francisco de Itabapoana,RJ,,,,41145,44475,41357,20802,20555,21090,20267,0.05%
3304805,3302,Norte Fluminense,33003,Campos dos Goytacazes,São Fidélis,RJ,35143,34973,34581,36789,37477,37553,18402,19151,29689,7864,0.21%
3304904,3306,Metropolitana do Rio de Janeiro,33018,Rio de Janeiro,São Gonçalo,RJ,430271,615351,779832,891119,960631,999901,475336,524565,999161,740,1.16%
3305000,3302,Norte Fluminense,33003,Campos dos Goytacazes,São João da Barra,RJ,55619,54588,59561,27682,28889,32767,16234,16533,25715,7052,1.70%
3305109,3306,Metropolitana do Rio de Janeiro,33018,Rio de Janeiro,São João de Meriti,RJ,302394,398819,425772,449476,464282,459356,218391,240965,459356,0,0.22%
3305133,3301,Noroeste Fluminense,33002,Santo Antônio de Pádua,São José de Ubá,RJ,,,,6413,6829,7003,3498,3505,3098,3905,0.88%
3305158,3306,Metropolitana do Rio de Janeiro,33015,Serrana,São José do Vale do Rio Preto,RJ,,,15472,19278,19439,20252,10147,10105,9005,11247,0.49%
3305208,3304,Baixadas,33010,Lagos,São Pedro da Aldeia,RJ,27721,37508,50474,63227,75869,88013,43495,44518,82286,5727,3.36%
3305307,3303,Centro Fluminense,33008,Santa Maria Madalena,São Sebastião do Alto,RJ,10073,8947,8108,8402,8616,8906,4474,4432,4623,4283,0.58%
3305406,3303,Centro Fluminense,33005,Três Rios,Sapucaia,RJ,16042,14946,15429,17157,16858,17504,8763,8741,13247,4257,0.20%
3305505,3304,Baixadas,33010,Lagos,Saquarema,RJ,24378,28200,37888,52461,62174,74221,36846,37375,70448,3773,3.53%
3305554,3306,Metropolitana do Rio de Janeiro,33017,Itaguaí,Seropédica,RJ,,,,65260,72466,78183,38400,39783,64297,13886,1.82%
3305604,3304,Baixadas,33009,Bacia de São João,Silva Jardim,RJ,17190,16828,18141,21265,21362,21360,10810,10550,16126,5234,0.04%
3305703,3303,Centro Fluminense,33007,Nova Friburgo,Sumidouro,RJ,11003,11386,12977,14176,14562,14920,7657,7263,5458,9462,0.51%
3305752,3306,Metropolitana do Rio de Janeiro,33018,Rio de Janeiro,Tanguá,RJ,,,,26057,28322,30731,15284,15447,27426,3305,1.66%
3305802,3306,Metropolitana do Rio de Janeiro,33015,Serrana,Teresópolis,RJ,73128,98705,120709,138081,150268,163805,78249,85556,145473,18332,1.72%
3305901,3303,Centro Fluminense,33008,Santa Maria Madalena,Trajano de Moraes,RJ,12738,10624,10640,10038,9706,10281,5260,5021,4776,5505,0.24%
3306008,3303,Centro Fluminense,33005,Três Rios,Três Rios,RJ,55871,71170,81248,71976,72848,77503,37068,40435,75233,2270,0.74%
3306107,3305,Sul Fluminense,33012,Barra do Piraí,Valença,RJ,48313,53583,60805,66308,70850,71894,34474,37420,62266,9628,0.81%
3306156,3301,Noroeste Fluminense,33001,Itaperuna,Varre-Sai,RJ,,,,7854,8308,9503,4778,4725,5805,3698,1.92%
3306206,3306,Metropolitana do Rio de Janeiro,33014,Vassouras,Vassouras,RJ,41148,44318,28649,31451,32495,34439,16404,18035,23192,11247,0.91%
3306305,3305,Sul Fluminense,33011,Vale do Paraíba Fluminense,Volta Redonda,RJ,125295,183620,220305,242063,255653,257996,122977,135019,257879,117,0.64%
2400109,2402,Central Potiguar,24012,Seridó Oriental,Acari,RN,10898,11018,10983,11189,10911,11035,5364,5671,8902,2133,-0.14%
2400208,2401,Oeste Potiguar,24004,Vale do Açu,Açu,RN,25038,34398,43591,47904,51262,53245,26158,27087,39369,13876,1.06%
2400307,2402,Central Potiguar,24009,Angicos,Afonso Bezerra,RN,8977,8601,10733,10867,10339,10879,5464,5415,5760,5119,0.01%
2400406,2401,Oeste Potiguar,24005,Serra de São Miguel,Água Nova,RN,1574,2040,2309,2678,2843,2984,1480,1504,1908,1076,1.09%
2400505,2401,Oeste Potiguar,24006,Pau dos Ferros,Alexandria,RN,13252,14337,14580,13772,13729,13475,6602,6873,9188,4287,-0.22%
2400604,2401,Oeste Potiguar,24007,Umarizal,Almino Afonso,RN,6021,5721,5698,5195,4948,4880,2499,2381,3488,1392,-0.62%
2400703,2401,Oeste Potiguar,24004,Vale do Açu,Alto do Rodrigues,RN,4804,5446,8247,9499,11443,12306,6163,6143,8875,3431,2.62%
2400802,2402,Central Potiguar,24009,Angicos,Angicos,RN,13987,12757,14476,11626,11227,11553,5657,5896,10089,1464,-0.06%
2400901,2401,Oeste Potiguar,24007,Umarizal,Antônio Martins,RN,8038,8751,7564,6757,6997,6907,3494,3413,3784,3123,0.22%
2401008,2401,Oeste Potiguar,24002,Chapada do Apodi,Apodi,RN,21056,27540,31175,34174,34632,34777,17376,17401,17545,17232,0.18%
2401107,2401,Oeste Potiguar,24001,Mossoró,Areia Branca,RN,15600,17228,21216,22530,24398,25263,12311,12952,20258,5005,1.15%
2401206,2404,Leste Potiguar,24019,Litoral Sul,Arês,RN,7962,9958,11140,11323,12236,12931,6405,6526,8080,4851,1.34%
2401305,2401,Oeste Potiguar,24003,Médio Oeste,Augusto Severo,RN,11189,12143,12437,9024,8936,9289,4708,4581,5002,4287,0.29%
2401404,2404,Leste Potiguar,24019,Litoral Sul,Baía Formosa,RN,3814,5155,7223,7821,8466,8569,4335,4234,7128,1441,0.92%
2401453,2401,Oeste Potiguar,24001,Mossoró,Baraúna,RN,,,15471,18922,23098,24187,12272,11915,15215,8972,2.49%
2401503,2403,Agreste Potiguar,24014,Borborema Potiguar,Barcelona,RN,4664,4428,3655,3990,3928,3957,2028,1929,1756,2201,-0.08%
2401602,2403,Agreste Potiguar,24013,Baixa Verde,Bento Fernandes,RN,4353,4641,4463,4709,5006,5110,2629,2481,2066,3044,0.82%
2401651,2402,Central Potiguar,24010,Serra de Santana,Bodó,RN,,,,2775,2542,2425,1260,1165,1393,1032,-1.34%
2401701,2403,Agreste Potiguar,24015,Agreste Potiguar,Bom Jesus,RN,3270,4594,7197,8608,8478,9432,4691,4741,6766,2666,0.92%
2401800,2403,Agreste Potiguar,24015,Agreste Potiguar,Brejinho,RN,5389,6081,8033,10317,11135,11577,5798,5779,9167,2410,1.16%
2401859,2402,Central Potiguar,24008,Macau,Caiçara do Norte,RN,,,,5842,6384,6016,3119,2897,5894,122,0.29%
2401909,2402,Central Potiguar,24009,Angicos,Caiçara do Rio do Vento,RN,2393,2599,2616,2867,3064,3304,1641,1663,2522,782,1.43%
2402006,2402,Central Potiguar,24011,Seridó Ocidental,Caicó,RN,36521,40030,50640,57002,60656,62727,30371,32356,57464,5263,0.96%
2402105,2403,Agreste Potiguar,24014,Borborema Potiguar,Campo Redondo,RN,9243,9180,9349,9201,10462,10266,5104,5162,5197,5069,1.10%
2402204,2404,Leste Potiguar,24019,Litoral Sul,Canguaretama,RN,15579,17980,22919,27011,29334,30900,15461,15439,20210,10690,1.35%
2402303,2401,Oeste Potiguar,24002,Chapada do Apodi,Caraúbas,RN,15545,18786,20248,18810,19739,19582,9571,10011,13709,5873,0.40%
2402402,2402,Central Potiguar,24012,Seridó Oriental,Carnaúba dos Dantas,RN,4515,5384,5608,6572,6836,7429,3716,3713,6028,1401,1.23%
2402501,2401,Oeste Potiguar,24004,Vale do Açu,Carnaubais,RN,12021,12133,10461,8192,9284,9775,4900,4875,4761,5014,1.78%
2402600,2404,Leste Potiguar,24017,Macaíba,Ceará-Mirim,RN,37930,40106,52157,62424,65450,67844,33570,34274,35474,32370,0.84%
2402709,2402,Central Potiguar,24010,Serra de Santana,Cerro Corá,RN,8459,8816,10526,10839,10890,10916,5458,5458,4740,6176,0.07%
2402808,2403,Agreste Potiguar,24014,Borborema Potiguar,Coronel Ezequiel,RN,6453,6634,5909,5409,5255,5405,2747,2658,2273,3132,-0.01%
2402907,2401,Oeste Potiguar,24005,Serra de São Miguel,Coronel João Pessoa,RN,3766,4094,4725,4703,4827,4774,2370,2404,1779,2995,0.15%
2403004,2402,Central Potiguar,24012,Seridó Oriental,Cruzeta,RN,6483,6819,7885,8138,7825,7968,3907,4061,6522,1446,-0.21%
2403103,2402,Central Potiguar,24012,Seridó Oriental,Currais Novos,RN,26179,34979,40227,40791,42066,42668,20381,22287,37793,4875,0.45%
2403202,2401,Oeste Potiguar,24005,Serra de São Miguel,Doutor Severiano,RN,4878,5339,6448,6552,6431,6495,3194,3301,2783,3712,-0.09%
2403251,2404,Leste Potiguar,24018,Natal,Parnamirim,RN,14502,26362,63312,124690,172751,202413,96938,105475,202413,0,4.96%
2403301,2401,Oeste Potiguar,24005,Serra de São Miguel,Encanto,RN,3433,4178,4720,4798,5158,5228,2563,2665,2127,3101,0.86%
2403400,2402,Central Potiguar,24012,Seridó Oriental,Equador,RN,4611,5025,5492,5664,5875,5822,2960,2862,4810,1012,0.28%
2403509,2404,Leste Potiguar,24019,Litoral Sul,Espírito Santo,RN,6143,7433,10121,10715,10132,10480,5319,5161,5007,5473,-0.22%
2403608,2404,Leste Potiguar,24018,Natal,Extremoz,RN,8991,8796,14941,19572,21792,24550,12192,12358,15780,8770,2.29%
2403707,2401,Oeste Potiguar,24002,Chapada do Apodi,Felipe Guerra,RN,3762,4751,6042,5534,5680,5734,2869,2865,3875,1859,0.36%
2403756,2402,Central Potiguar,24009,Angicos,Fernando Pedroza,RN,,,,2650,2876,2850,1458,1392,2430,420,0.73%
2403806,2402,Central Potiguar,24010,Serra de Santana,Florânia,RN,10229,11486,12424,8978,8313,8959,4492,4467,6857,2102,-0.02%
2403905,2401,Oeste Potiguar,24006,Pau dos Ferros,Francisco Dantas,RN,3158,3531,3267,3021,2928,2874,1457,1417,1647,1227,-0.50%
2404002,2401,Oeste Potiguar,24007,Umarizal,Frutuoso Gomes,RN,4052,4256,4642,4580,4360,4233,2072,2161,2812,1421,-0.78%
2404101,2402,Central Potiguar,24008,Macau,Galinhos,RN,1838,1272,1265,1767,2149,2150,1112,1038,1240,910,1.98%
2404200,2404,Leste Potiguar,24019,Litoral Sul,Goianinha,RN,9835,11903,17496,17661,20347,22467,11196,11271,15469,6998,2.44%
2404309,2401,Oeste Potiguar,24002,Chapada do Apodi,Governador Dix-Sept Rosado,RN,8768,9052,10447,11772,12374,12373,6321,6052,6804,5569,0.50%
2404408,2401,Oeste Potiguar,24001,Mossoró,Grossos,RN,7856,7894,9306,8249,9441,9393,4762,4631,7039,2354,1.31%
2404507,2402,Central Potiguar,24008,Macau,Guamaré,RN,2822,3262,6082,8149,11737,12431,6230,6201,4405,8026,4.31%
2404606,2403,Agreste Potiguar,24015,Agreste Potiguar,Ielmo Marinho,RN,9582,9225,9106,10249,11649,12188,6280,5908,1538,10650,1.75%
2404705,2401,Oeste Potiguar,24004,Vale do Açu,Ipanguaçu,RN,12210,12229,16021,11924,13444,13855,6999,6856,5382,8473,1.51%
2404804,2402,Central Potiguar,24011,Seridó Ocidental,Ipueira,RN,1481,1510,1701,1902,2035,2074,1036,1038,1886,188,0.87%
2404853,2401,Oeste Potiguar,24004,Vale do Açu,Itajá,RN,,,,6249,6410,6952,3546,3406,5704,1248,1.07%
2404903,2401,Oeste Potiguar,24006,Pau dos Ferros,Itaú,RN,3608,3347,4901,5271,5758,5568,2742,2826,4790,778,0.55%
2405009,2403,Agreste Potiguar,24014,Borborema Potiguar,Jaçanã,RN,3622,4689,6859,7677,7788,7925,3935,3990,5333,2592,0.32%
2405108,2403,Agreste Potiguar,24013,Baixa Verde,Jandaíra,RN,3144,4172,5444,6124,6447,6796,3513,3283,3954,2842,1.05%
2405207,2401,Oeste Potiguar,24003,Médio Oeste,Janduís,RN,6680,5433,5983,5597,5416,5350,2653,2697,3997,1353,-0.45%
2405306,2403,Agreste Potiguar,24015,Agreste Potiguar,Januário Cicco,RN,5243,6710,6659,7687,8294,9009,4635,4374,3210,5799,1.60%
2405405,2403,Agreste Potiguar,24014,Borborema Potiguar,Japi,RN,4034,5741,6072,6328,5610,5522,2806,2716,4107,1415,-1.35%
2405504,2402,Central Potiguar,24009,Angicos,Jardim de Angicos,RN,2829,2921,2439,2670,2536,2607,1353,1254,433,2174,-0.24%
2405603,2402,Central Potiguar,24011,Seridó Ocidental,Jardim de Piranhas,RN,7910,8487,9957,11994,13704,13511,6721,6790,10598,2913,1.20%
2405702,2402,Central Potiguar,24012,Seridó Oriental,Jardim do Seridó,RN,8906,10354,11840,12041,12013,12115,5886,6229,9835,2280,0.06%
2405801,2403,Agreste Potiguar,24013,Baixa Verde,João Câmara,RN,18310,22831,25854,29248,30423,32203,16033,16170,22631,9572,0.97%
2405900,2401,Oeste Potiguar,24007,Umarizal,João Dias,RN,2785,3250,2654,2596,2723,2601,1279,1322,1167,1434,0.02%
2406007,2401,Oeste Potiguar,24006,Pau dos Ferros,José da Penha,RN,5148,5577,5531,5908,5982,5868,2822,3046,3542,2326,-0.07%
2406106,2401,Oeste Potiguar,24004,Vale do Açu,Jucurutu,RN,12235,13277,14684,17319,17501,17692,8869,8823,10567,7125,0.21%
2406155,2403,Agreste Potiguar,24015,Agreste Potiguar,Jundiá,RN,,,,,3517,3585,1876,1709,962,2623,-
2406205,2403,Agreste Potiguar,24015,Agreste Potiguar,Lagoa d'Anta,RN,4132,4347,5071,5629,5940,6228,3132,3096,3983,2245,1.02%
2406304,2403,Agreste Potiguar,24015,Agreste Potiguar,Lagoa de Pedras,RN,4590,4616,5049,6395,6989,6992,3566,3426,2237,4755,0.90%
2406403,2403,Agreste Potiguar,24014,Borborema Potiguar,Lagoa de Velhos,RN,1629,2249,1968,2651,2699,2674,1365,1309,1795,879,0.09%
2406502,2402,Central Potiguar,24010,Serra de Santana,Lagoa Nova,RN,6014,8148,10786,12058,13167,13990,6927,7063,6805,7185,1.50%
2406601,2403,Agreste Potiguar,24015,Agreste Potiguar,Lagoa Salgada,RN,5314,5031,6130,6808,7179,7565,3800,3765,5006,2559,1.06%
2406700,2402,Central Potiguar,24009,Angicos,Lajes,RN,9323,8271,8687,9399,10412,10385,5163,5222,8076,2309,1.00%
2406809,2403,Agreste Potiguar,24014,Borborema Potiguar,Lajes Pintadas,RN,4088,3918,4459,4530,4217,4614,2349,2265,2392,2222,0.18%
2406908,2401,Oeste Potiguar,24007,Umarizal,Lucrécia,RN,1990,2589,2967,3218,3418,3633,1829,1804,2280,1353,1.22%
2407005,2401,Oeste Potiguar,24005,Serra de São Miguel,Luís Gomes,RN,8920,10001,11336,9154,9763,9612,4723,4889,6688,2924,0.49%
2407104,2404,Leste Potiguar,24017,Macaíba,Macaíba,RN,29126,31270,43450,54883,63337,69538,34485,35053,42686,26852,2.39%
2407203,2402,Central Potiguar,24008,Macau,Macau,RN,25800,24078,25985,25700,27132,28974,14200,14774,21986,6988,1.21%
2407252,2401,Oeste Potiguar,24005,Serra de São Miguel,Major Sales,RN,,,,2948,3459,3536,1749,1787,2900,636,1.84%
2407302,2401,Oeste Potiguar,24006,Pau dos Ferros,Marcelino Vieira,RN,7267,8043,8813,8373,8112,8265,4064,4201,4894,3371,-0.13%
2407401,2401,Oeste Potiguar,24007,Umarizal,Martins,RN,11907,13075,12299,7725,8089,8228,4045,4183,5046,3182,0.63%
2407500,2404,Leste Potiguar,24016,Litoral Nordeste,Maxaranguape,RN,9223,11139,13518,8001,8969,10442,5352,5090,3889,6553,2.70%
2407609,2401,Oeste Potiguar,24003,Médio Oeste,Messias Targino,RN,2618,3404,3413,3718,3795,4188,2119,2069,3638,550,1.20%
2407708,2404,Leste Potiguar,24019,Litoral Sul,Montanhas,RN,6527,7798,9624,11948,12393,11418,5666,5752,8875,2543,-0.45%
2407807,2403,Agreste Potiguar,24015,Agreste Potiguar,Monte Alegre,RN,10929,13819,15871,18874,20590,20670,10268,10402,8993,11677,0.91%
2407906,2403,Agreste Potiguar,24014,Borborema Potiguar,Monte das Gameleiras,RN,1831,2652,2761,2541,2394,2266,1154,1112,1283,983,-1.14%
2408003,2401,Oeste Potiguar,24001,Mossoró,Mossoró,RN,97245,145981,192267,213841,234390,259886,125694,134192,237281,22605,1.97%
2408102,2404,Leste Potiguar,24018,Natal,Natal,RN,264379,416892,606887,712317,774230,803811,378004,425807,803811,0,1.22%
2408201,2404,Leste Potiguar,24017,Macaíba,Nísia Floresta,RN,9412,9982,13934,19040,22906,23818,12326,11492,9380,14438,2.26%
2408300,2403,Agreste Potiguar,24015,Agreste Potiguar,Nova Cruz,RN,22285,26044,30053,33834,35280,35541,17534,18007,24427,11114,0.49%
2408409,2401,Oeste Potiguar,24007,Umarizal,Olho-d'Água do Borges,RN,3377,4849,4576,4461,4442,4301,2214,2087,3243,1058,-0.36%
2408508,2402,Central Potiguar,24012,Seridó Oriental,Ouro Branco,RN,4993,4543,4545,4667,4973,4699,2354,2345,3258,1441,0.07%
2408607,2401,Oeste Potiguar,24006,Pau dos Ferros,Paraná,RN,1932,2539,3510,3633,3886,3952,2041,1911,821,3131,0.85%
2408706,2401,Oeste Potiguar,24003,Médio Oeste,Paraú,RN,3426,3784,4008,4092,3880,3862,1923,1939,3338,524,-0.58%
2408805,2403,Agreste Potiguar,24013,Baixa Verde,Parazinho,RN,2527,3747,3980,4325,4772,4845,2434,2411,3137,1708,1.14%
2408904,2402,Central Potiguar,24012,Seridó Oriental,Parelhas,RN,12469,14482,17575,19319,19972,20347,9958,10389,17077,3270,0.52%
2408953,2404,Leste Potiguar,24016,Litoral Nordeste,Rio do Fogo,RN,,,,9217,9753,10060,5132,4928,3747,6313,0.88%
2409100,2403,Agreste Potiguar,24015,Agreste Potiguar,Passa e Fica,RN,4428,5702,6523,8329,10372,11111,5514,5597,6765,4346,2.92%
2409209,2403,Agreste Potiguar,24015,Agreste Potiguar,Passagem,RN,3017,2343,2449,2691,2629,2899,1455,1444,1193,1706,0.75%
2409308,2401,Oeste Potiguar,24007,Umarizal,Patu,RN,9016,11744,11741,11171,11303,11964,5886,6078,10159,1805,0.69%
2409332,2403,Agreste Potiguar,24015,Agreste Potiguar,Santa Maria,RN,,,,3778,4659,4762,2419,2343,3051,1711,2.34%
2409407,2401,Oeste Potiguar,24006,Pau dos Ferros,Pau dos Ferros,RN,12138,16216,20827,24758,26728,27733,13500,14233,25535,2198,1.14%
2409506,2404,Leste Potiguar,24016,Litoral Nordeste,Pedra Grande,RN,3352,3240,3489,4017,3918,3521,1772,1749,1161,2360,-1.31%
2409605,2402,Central Potiguar,24009,Angicos,Pedra Preta,RN,2629,2872,2710,2847,2659,2583,1337,1246,990,1593,-0.97%
2409704,2402,Central Potiguar,24009,Angicos,Pedro Avelino,RN,10334,9333,11447,8006,7405,7168,3697,3471,4119,3049,-1.10%
2409803,2404,Leste Potiguar,24019,Litoral Sul,Pedro Velho,RN,10054,10738,12756,13518,13673,14119,7162,6957,7252,6867,0.44%
2409902,2401,Oeste Potiguar,24004,Vale do Açu,Pendências,RN,8659,9383,11055,11401,12505,13436,6696,6740,10576,2860,1.66%
2410009,2401,Oeste Potiguar,24006,Pau dos Ferros,Pilões,RN,1868,1917,2161,3002,3381,3453,1729,1724,2533,920,1.41%
2410108,2403,Agreste Potiguar,24013,Baixa Verde,Poço Branco,RN,7084,8715,10455,12261,12288,13947,7051,6896,7413,6534,1.30%
2410207,2401,Oeste Potiguar,24006,Pau dos Ferros,Portalegre,RN,6136,5866,6357,6746,6855,7297,3573,3724,3838,3459,0.79%
2410256,2401,Oeste Potiguar,24004,Vale do Açu,Porto do Mangue,RN,,,,4064,4792,5217,2731,2486,3028,2189,2.53%
2410306,2403,Agreste Potiguar,24015,Agreste Potiguar,Presidente Juscelino,RN,4485,5020,5995,7005,8283,8774,4476,4298,5313,3461,2.28%
2410405,2404,Leste Potiguar,24016,Litoral Nordeste,Pureza,RN,5379,5659,6806,6963,8030,8432,4286,4146,2995,5437,1.93%
2410504,2401,Oeste Potiguar,24006,Pau dos Ferros,Rafael Fernandes,RN,2650,2688,3332,4247,4608,4692,2328,2364,2709,1983,1.00%
2410603,2401,Oeste Potiguar,24007,Umarizal,Rafael Godeiro,RN,3247,3549,2979,2953,3131,3070,1541,1529,1929,1141,0.39%
2410702,2401,Oeste Potiguar,24006,Pau dos Ferros,Riacho da Cruz,RN,2014,2336,2558,2667,3025,3165,1617,1548,2674,491,1.73%
2410801,2401,Oeste Potiguar,24005,Serra de São Miguel,Riacho de Santana,RN,3408,3873,3980,4200,4292,4157,2073,2084,1710,2447,-0.10%
2410900,2403,Agreste Potiguar,24015,Agreste Potiguar,Riachuelo,RN,6795,6032,5816,5760,6824,7067,3560,3507,4342,2725,2.07%
2411007,2401,Oeste Potiguar,24006,Pau dos Ferros,Rodolfo Fernandes,RN,3028,4924,5257,4467,4569,4417,2172,2245,3731,686,-0.11%
2411056,2401,Oeste Potiguar,24001,Mossoró,Tibau,RN,,,,3197,3750,3687,1847,1840,2835,852,1.44%
2411106,2403,Agreste Potiguar,24014,Borborema Potiguar,Ruy Barbosa,RN,4100,3944,3304,3686,3625,3595,1834,1761,1736,1859,-0.25%
2411205,2403,Agreste Potiguar,24014,Borborema Potiguar,Santa Cruz,RN,20323,22332,28654,31294,33736,35759,17449,18310,30461,5298,1.34%
2411403,2402,Central Potiguar,24010,Serra de Santana,Santana do Matos,RN,18808,17260,17188,15987,14312,13798,6860,6938,6893,6905,-1.46%
2411429,2402,Central Potiguar,24012,Seridó Oriental,Santana do Seridó,RN,2439,2488,2510,2377,2729,2526,1267,1259,1653,873,0.61%
2411502,2403,Agreste Potiguar,24015,Agreste Potiguar,Santo Antônio,RN,15689,17231,19217,20107,21263,22214,11098,11116,14278,7936,1.00%
2411601,2402,Central Potiguar,24008,Macau,São Bento do Norte,RN,6093,7966,8943,3378,3529,2974,1523,1451,1033,1941,-1.27%
2411700,2403,Agreste Potiguar,24014,Borborema Potiguar,São Bento do Trairí,RN,3615,3258,3239,3244,3702,3909,1940,1969,1886,2023,1.88%
2411809,2402,Central Potiguar,24011,Seridó Ocidental,São Fernando,RN,3830,3186,3504,3234,3381,3401,1737,1664,2297,1104,0.50%
2411908,2401,Oeste Potiguar,24006,Pau dos Ferros,São Francisco do Oeste,RN,1651,2332,2795,3480,3669,3874,1945,1929,2948,926,1.08%
2412005,2404,Leste Potiguar,24017,Macaíba,São Gonçalo do Amarante,RN,18826,30797,45461,69435,77363,87700,43208,44492,74136,13564,2.36%
2412104,2402,Central Potiguar,24011,Seridó Ocidental,São João do Sabugi,RN,4236,4540,5483,5698,5765,5914,2923,2991,4748,1166,0.37%
2412203,2404,Leste Potiguar,24017,Macaíba,São José de Mipibu,RN,17312,20441,28151,34912,36990,39771,19820,19951,18230,21541,1.31%
2412302,2403,Agreste Potiguar,24014,Borborema Potiguar,São José do Campestre,RN,11738,12241,11826,11982,11744,12359,6151,6208,10272,2087,0.31%
2412401,2402,Central Potiguar,24012,Seridó Oriental,São José do Seridó,RN,2887,3021,3177,3777,3925,4231,2122,2109,3302,929,1.14%
2412500,2401,Oeste Potiguar,24005,Serra de São Miguel,São Miguel,RN,15600,17800,21286,20124,22579,22159,10573,11586,14502,7657,0.97%
2412559,2404,Leste Potiguar,24016,Litoral Nordeste,São Miguel do Gostoso,RN,,,,7580,8810,8659,4476,4183,4127,4532,1.34%
2412609,2403,Agreste Potiguar,24015,Agreste Potiguar,São Paulo do Potengi,RN,12823,13553,14559,13822,14483,15866,7822,8044,11490,4376,1.39%
2412708,2403,Agreste Potiguar,24015,Agreste Potiguar,São Pedro,RN,7817,7074,7019,6776,6433,6223,3160,3063,3492,2731,-0.85%
2412807,2401,Oeste Potiguar,24004,Vale do Açu,São Rafael,RN,8686,7188,7843,8201,8116,8106,4128,3978,5538,2568,-0.12%
2412906,2403,Agreste Potiguar,24014,Borborema Potiguar,São Tomé,RN,13111,11352,11465,10798,11115,10868,5457,5411,5982,4886,0.06%
2413003,2402,Central Potiguar,24010,Serra de Santana,São Vicente,RN,4189,4929,4980,5633,5819,6030,2945,3085,3767,2263,0.68%
2413102,2403,Agreste Potiguar,24015,Agreste Potiguar,Senador Elói de Souza,RN,3687,4082,4309,5028,5906,5645,2866,2779,2434,3211,1.16%
2413201,2404,Leste Potiguar,24019,Litoral Sul,Senador Georgino Avelino,RN,1725,1981,2663,3302,3690,3924,1944,1980,3881,43,1.74%
2413300,2403,Agreste Potiguar,24014,Borborema Potiguar,Serra de São Bento,RN,5402,6462,6294,5870,5801,5746,2867,2879,3262,2484,-0.21%
2413359,2401,Oeste Potiguar,24001,Mossoró,Serra do Mel,RN,,,8016,8237,9216,10281,5392,4889,2698,7583,2.24%
2413409,2402,Central Potiguar,24011,Seridó Ocidental,Serra Negra do Norte,RN,7631,7811,7505,7543,7241,7770,3901,3869,4997,2773,0.30%
2413508,2403,Agreste Potiguar,24015,Agreste Potiguar,Serrinha,RN,7761,6321,6755,7253,6740,6581,3452,3129,2121,4460,-0.97%
2413557,2401,Oeste Potiguar,24007,Umarizal,Serrinha dos Pintos,RN,,,,4295,4360,4538,2291,2247,2402,2136,0.55%
2413607,2401,Oeste Potiguar,24006,Pau dos Ferros,Severiano Melo,RN,4961,6993,10397,10579,5671,5752,2865,2887,2118,3634,-5.91%
2413706,2403,Agreste Potiguar,24014,Borborema Potiguar,Sítio Novo,RN,4796,4894,4600,4448,5212,5020,2542,2478,2390,2630,1.22%
2413805,2401,Oeste Potiguar,24006,Pau dos Ferros,Taboleiro Grande,RN,1719,1743,2071,2029,2278,2317,1178,1139,1887,430,1.34%
2413904,2404,Leste Potiguar,24016,Litoral Nordeste,Taipu,RN,9758,9355,10450,11531,11768,11836,6112,5724,4084,7752,0.26%
2414001,2403,Agreste Potiguar,24014,Borborema Potiguar,Tangará,RN,7427,8661,10213,12118,13081,14175,7159,7016,9734,4441,1.58%
2414100,2401,Oeste Potiguar,24006,Pau dos Ferros,Tenente Ananias,RN,7414,9778,9529,8875,9311,9911,5003,4908,6833,3078,1.11%
2414159,2402,Central Potiguar,24010,Serra de Santana,Tenente Laurentino Cruz,RN,,,,4412,5120,5406,2746,2660,1152,4254,2.05%
2414209,2404,Leste Potiguar,24019,Litoral Sul,Tibau do Sul,RN,3897,4873,5964,7749,10959,11402,5762,5640,6870,4532,3.94%
2414308,2402,Central Potiguar,24011,Seridó Ocidental,Timbaúba dos Batistas,RN,1584,1501,1935,2189,2295,2295,1145,1150,1728,567,0.47%
2414407,2404,Leste Potiguar,24016,Litoral Nordeste,Touros,RN,19442,19817,27043,27879,29436,31076,16056,15020,7910,23166,1.09%
2414456,2401,Oeste Potiguar,24003,Médio Oeste,Triunfo Potiguar,RN,,,,3642,3272,3366,1768,1598,2197,1169,-0.78%
2414506,2401,Oeste Potiguar,24007,Umarizal,Umarizal,RN,8102,12358,11084,11092,10640,10669,5224,5445,9084,1585,-0.39%
2414605,2401,Oeste Potiguar,24003,Médio Oeste,Upanema,RN,6530,7460,8642,10991,12719,12985,6715,6270,6298,6687,1.68%
2414704,2403,Agreste Potiguar,24015,Agreste Potiguar,Várzea,RN,7120,6871,8531,8238,5276,5227,2614,2613,4311,916,-4.45%
2414753,2401,Oeste Potiguar,24005,Serra de São Miguel,Venha-Ver,RN,,,,3422,3494,3821,1952,1869,1199,2622,1.11%
2414803,2403,Agreste Potiguar,24015,Agreste Potiguar,Vera Cruz,RN,4857,6178,7970,8522,10313,10725,5352,5373,4691,6034,2.33%
2414902,2401,Oeste Potiguar,24006,Pau dos Ferros,Viçosa,RN,874,1128,1309,1521,1769,1618,806,812,1541,77,0.62%
2415008,2404,Leste Potiguar,24019,Litoral Sul,Vila Flor,RN,1152,1524,2297,2528,2647,2872,1460,1412,2784,88,1.28%
1100015,1102,Leste Rondoniense,11006,Cacoal,Alta Floresta D'Oeste,RO,,,31980,26533,23857,24422,12670,11752,13992,10430,-0.83%
1100023,1102,Leste Rondoniense,11003,Ariquemes,Ariquemes,RO,,53365,83684,74503,82388,90354,45538,44816,69606,20748,1.95%
1100031,1102,Leste Rondoniense,11008,Colorado do Oeste,Cabixi,RO,,,8174,7518,6575,6309,3262,3047,2693,3616,-1.74%
1100049,1102,Leste Rondoniense,11006,Cacoal,Cacoal,RO,,67030,78934,73568,76155,78601,39155,39446,61931,16670,0.66%
1100056,1102,Leste Rondoniense,11008,Colorado do Oeste,Cerejeiras,RO,,,21608,18207,16290,17030,8552,8478,14420,2610,-0.67%
1100064,1102,Leste Rondoniense,11008,Colorado do Oeste,Colorado do Oeste,RO,,,38993,21892,17644,18602,9333,9269,13666,4936,-1.62%
1100072,1102,Leste Rondoniense,11008,Colorado do Oeste,Corumbiara,RO,,,,10459,9476,8802,4722,4080,2590,6212,-1.71%
1100080,1101,Madeira-Guaporé,11002,Guajará-Mirim,Costa Marques,RO,,,10376,10208,13664,13700,7209,6491,7504,6196,2.99%
1100098,1102,Leste Rondoniense,11006,Cacoal,Espigão D'Oeste,RO,,,23156,25688,27867,28741,14633,14108,20629,8112,1.13%
1100106,1101,Madeira-Guaporé,11002,Guajará-Mirim,Guajará-Mirim,RO,27016,34751,32583,38045,39451,41646,20940,20706,35197,6449,0.91%
1100114,1102,Leste Rondoniense,11004,Ji-Paraná,Jaru,RO,,,63535,53600,52453,52043,26037,26006,35141,16902,-0.29%
1100122,1102,Leste Rondoniense,11004,Ji-Paraná,Ji-Paraná,RO,,121714,97799,106800,107679,116587,57834,58753,104841,11746,0.88%
1100130,1102,Leste Rondoniense,11003,Ariquemes,Machadinho D'Oeste,RO,,,16765,22739,31475,31107,16519,14588,16176,14931,3.18%
1100148,1102,Leste Rondoniense,11005,Alvorada D'Oeste,Nova Brasilândia D'Oeste,RO,,,15798,17067,17170,19845,10328,9517,8370,11475,1.52%
1100155,1102,Leste Rondoniense,11004,Ji-Paraná,Ouro Preto do Oeste,RO,,,83857,40884,36040,37941,18709,19232,28208,9733,-0.74%
1100189,1102,Leste Rondoniense,11007,Vilhena,Pimenta Bueno,RO,,29993,48759,31752,32893,33754,17010,16744,29358,4396,0.61%
1100205,1101,Madeira-Guaporé,11001,Porto Velho,Porto Velho,RO,84048,133882,287534,334661,369345,426558,215561,210997,391014,35544,2.46%
1100254,1102,Leste Rondoniense,11004,Ji-Paraná,Presidente Médici,RO,,,30064,26365,22197,22319,11316,11003,13296,9023,-1.65%
1100262,1102,Leste Rondoniense,11003,Ariquemes,Rio Crespo,RO,,,,2937,3174,3316,1767,1549,1064,2252,1.22%
1100288,1102,Leste Rondoniense,11006,Cacoal,Rolim de Moura,RO,,,59751,47382,48894,50672,25178,25494,41454,9218,0.67%
1100296,1102,Leste Rondoniense,11006,Cacoal,Santa Luzia D'Oeste,RO,,,12328,11603,9264,8886,4596,4290,4525,4361,-2.63%
1100304,1102,Leste Rondoniense,11007,Vilhena,Vilhena,RO,,50290,39263,53598,66746,76187,37779,38408,72212,3975,3.58%
1100320,1102,Leste Rondoniense,11005,Alvorada D'Oeste,São Miguel do Guaporé,RO,,,19458,23874,22622,21824,11327,10497,8471,13353,-0.89%
1100338,1101,Madeira-Guaporé,11001,Porto Velho,Nova Mamoré,RO,,,7248,14778,21162,22552,11738,10814,13069,9483,4.32%
1100346,1102,Leste Rondoniense,11005,Alvorada D'Oeste,Alvorada D'Oeste,RO,,,21045,19832,16485,16864,8677,8187,8837,8027,-1.61%
1100379,1102,Leste Rondoniense,11006,Cacoal,Alto Alegre dos Parecis,RO,,,,12708,11615,12826,6746,6080,3665,9161,0.09%
1100403,1102,Leste Rondoniense,11003,Ariquemes,Alto Paraíso,RO,,,,13118,16758,17144,9025,8119,8216,8928,2.71%
1100452,1101,Madeira-Guaporé,11001,Porto Velho,Buritis,RO,,,,25668,33072,32385,16746,15639,18113,14272,2.35%
1100502,1102,Leste Rondoniense,11006,Cacoal,Novo Horizonte do Oeste,RO,,,,12276,9648,10237,5333,4904,1732,8505,-1.80%
1100601,1102,Leste Rondoniense,11003,Ariquemes,Cacaulândia,RO,,,,5372,5553,5727,2960,2767,2068,3659,0.64%
1100700,1101,Madeira-Guaporé,11001,Porto Velho,Campo Novo de Rondônia,RO,,,,11463,12455,12669,6770,5899,3371,9298,1.01%
1100809,1101,Madeira-Guaporé,11001,Porto Velho,Candeias do Jamari,RO,,,,13107,16736,19782,10327,9455,12898,6884,4.20%
1100908,1102,Leste Rondoniense,11006,Cacoal,Castanheiras,RO,,,,4212,3624,3581,1831,1750,842,2739,-1.61%
1100924,1102,Leste Rondoniense,11007,Vilhena,Chupinguaia,RO,,,,5521,7456,8304,4409,3895,3670,4634,4.17%
1100940,1101,Madeira-Guaporé,11001,Porto Velho,Cujubim,RO,,,,6536,13857,15873,8476,7397,11065,4808,9.28%
1101005,1102,Leste Rondoniense,11004,Ji-Paraná,Governador Jorge Teixeira,RO,,,,13641,11432,10513,5471,5042,2361,8152,-2.57%
1101104,1101,Madeira-Guaporé,11001,Porto Velho,Itapuã do Oeste,RO,,,,6822,7905,8561,4563,3998,5220,3341,2.30%
1101203,1102,Leste Rondoniense,11006,Cacoal,Ministro Andreazza,RO,,,,11342,10343,10354,5306,5048,3074,7280,-0.91%
1101302,1102,Leste Rondoniense,11004,Ji-Paraná,Mirante da Serra,RO,,,,13154,12086,11869,6057,5812,6432,5437,-1.02%
1101401,1102,Leste Rondoniense,11003,Ariquemes,Monte Negro,RO,,,,12627,12357,14090,7407,6683,7387,6703,1.10%
1101435,1102,Leste Rondoniense,11004,Ji-Paraná,Nova União,RO,,,,8233,7750,7498,4003,3495,1540,5958,-0.93%
1101450,1102,Leste Rondoniense,11007,Vilhena,Parecis,RO,,,,3622,4583,4810,2596,2214,1774,3036,2.88%
1101468,1102,Leste Rondoniense,11008,Colorado do Oeste,Pimenteiras do Oeste,RO,,,,2527,2358,2322,1223,1099,1297,1025,-0.84%
1101476,1102,Leste Rondoniense,11007,Vilhena,Primavera de Rondônia,RO,,,,4311,3704,3523,1856,1667,1282,2241,-2.00%
1101484,1102,Leste Rondoniense,11007,Vilhena,São Felipe D'Oeste,RO,,,,7056,6286,6018,3086,2932,1444,4574,-1.58%
1101492,1101,Madeira-Guaporé,11002,Guajará-Mirim,São Francisco do Guaporé,RO,,,,11085,15710,16019,8410,7609,8227,7792,3.75%
1101500,1102,Leste Rondoniense,11005,Alvorada D'Oeste,Seringueiras,RO,,,,11655,11757,11649,6090,5559,4407,7242,-0.01%
1101559,1102,Leste Rondoniense,11004,Ji-Paraná,Teixeirópolis,RO,,,,5618,4919,4893,2544,2349,1718,3175,-1.37%
1101609,1102,Leste Rondoniense,11004,Ji-Paraná,Theobroma,RO,,,,11140,9952,10644,5649,4995,1980,8664,-0.45%
1101708,1102,Leste Rondoniense,11004,Ji-Paraná,Urupá,RO,,,,14880,13381,12969,6729,6240,5141,7828,-1.37%
1101757,1102,Leste Rondoniense,11003,Ariquemes,Vale do Anari,RO,,,,7737,8751,9361,4972,4389,3184,6177,1.92%
1101807,1102,Leste Rondoniense,11004,Ji-Paraná,Vale do Paraíso,RO,,,,9863,8742,8218,4249,3969,2276,5942,-1.81%
1400027,1401,Norte de Roraima,14001,Boa Vista,Amajari,RR,,,,5294,7586,9330,4995,4335,1219,8111,5.83%
1400050,1401,Norte de Roraima,14001,Boa Vista,Alto Alegre,RR,,,11211,17907,14386,16286,8592,7694,4780,11506,-0.94%
1400100,1401,Norte de Roraima,14001,Boa Vista,Boa Vista,RR,36464,67017,144249,200568,249853,284258,140808,143450,277754,6504,3.55%
1400159,1401,Norte de Roraima,14002,Nordeste de Roraima,Bonfim,RR,,,9478,9326,10231,10951,5883,5068,3716,7235,1.62%
1400175,1401,Norte de Roraima,14002,Nordeste de Roraima,Cantá,RR,,,,8571,11119,13778,7470,6308,2257,11521,4.86%
1400209,1402,Sul de Roraima,14003,Caracaraí,Caracaraí,RR,4421,12104,8900,14286,17981,18384,9725,8659,10889,7495,2.55%
1400233,1402,Sul de Roraima,14004,Sudeste de Roraima,Caroebe,RR,,,,5692,7086,8114,4309,3805,3324,4790,3.61%
1400282,1402,Sul de Roraima,14003,Caracaraí,Iracema,RR,,,,4781,5863,8676,4593,4083,4078,4598,6.14%
1400308,1402,Sul de Roraima,14003,Caracaraí,Mucajaí,RR,,,13308,11247,12546,14814,7872,6942,8944,5870,2.79%
1400407,1401,Norte de Roraima,14002,Nordeste de Roraima,Normandia,RR,,,11188,6138,7118,8926,4670,4256,2311,6615,3.82%
1400456,1401,Norte de Roraima,14001,Boa Vista,Pacaraima,RR,,,,6990,8640,10448,5418,5030,4516,5932,4.10%
1400472,1402,Sul de Roraima,14004,Sudeste de Roraima,Rorainópolis,RR,,,,17393,24466,25587,13672,11915,10679,14908,3.94%
1400506,1402,Sul de Roraima,14004,Sudeste de Roraima,São João da Baliza,RR,,,10143,5091,5727,6778,3556,3222,4775,2003,2.90%
1400605,1402,Sul de Roraima,14004,Sudeste de Roraima,São Luiz,RR,,,9106,5311,5720,6750,3568,3182,4455,2295,2.43%
1400704,1401,Norte de Roraima,14002,Nordeste de Roraima,Uiramutã,RR,,,,5802,7403,8147,4212,3935,1083,7064,3.45%
4300034,4306,Sudoeste Rio-grandense,43031,Campanha Meridional,Aceguá,RS,,,,,4138,4394,2303,2091,1059,3335,-
4300059,4301,Noroeste Rio-grandense,43010,Passo Fundo,Água Santa,RS,,,4082,4127,3565,3726,1880,1846,1447,2279,-1.02%
4300109,4303,Centro Ocidental Rio-grandense,43019,Restinga Seca,Agudo,RS,14186,15658,16718,17455,16714,16729,8353,8376,6894,9835,-0.42%
4300208,4301,Noroeste Rio-grandense,43008,Ijuí,Ajuricaba,RS,11649,11729,11059,7709,7261,7255,3585,3670,4108,3147,-0.61%
4300307,4301,Noroeste Rio-grandense,43001,Santa Rosa,Alecrim,RS,15412,13923,10379,8487,7357,7045,3512,3533,2165,4880,-1.84%
4300406,4306,Sudoeste Rio-grandense,43029,Campanha Ocidental,Alegrete,RS,65030,69466,78918,84338,78188,77673,38055,39618,69611,8062,-0.82%
4300455,4301,Noroeste Rio-grandense,43008,Ijuí,Alegria,RS,,,6247,5367,4789,4301,2149,2152,1585,2716,-2.19%
4300471,4301,Noroeste Rio-grandense,43009,Carazinho,Almirante Tamandaré do Sul,RS,,,,,2158,2062,1038,1024,834,1228,-
4300505,4301,Noroeste Rio-grandense,43003,Frederico Westphalen,Alpestre,RS,13499,15303,13567,10266,8972,8027,4129,3898,2211,5816,-2.43%
4300554,4301,Noroeste Rio-grandense,43011,Cruz Alta,Alto Alegre,RS,,,2139,2137,1940,1848,943,905,743,1105,-1.44%
4300570,4305,Metropolitana de Porto Alegre,43023,Montenegro,Alto Feliz,RS,,,,2834,2934,2908,1503,1405,813,2095,0.26%
4300604,4305,Metropolitana de Porto Alegre,43026,Porto Alegre,Alvorada,RS,40322,91384,142046,183968,207142,195718,95105,100613,195718,0,0.62%
4300638,4307,Sudeste Rio-grandense,43032,Serras de Sudeste,Amaral Ferrador,RS,,,5917,5740,6232,6355,3282,3073,1866,4489,1.02%
4300646,4301,Noroeste Rio-grandense,43003,Frederico Westphalen,Ametista do Sul,RS,,,,7414,8058,7323,3732,3591,3811,3512,-0.12%
4300661,4302,Nordeste Rio-grandense,43014,Guaporé,André da Rocha,RS,,,1047,1113,1206,1216,620,596,496,720,0.89%
4300703,4302,Nordeste Rio-grandense,43014,Guaporé,Anta Gorda,RS,8375,7136,6947,6327,6163,6073,3027,3046,2331,3742,-0.41%
4300802,4302,Nordeste Rio-grandense,43016,Caxias do Sul,Antônio Prado,RS,14751,13030,10989,12918,13591,12837,6407,6430,9235,3602,-0.06%
4300851,4305,Metropolitana de Porto Alegre,43028,Camaquã,Arambaré,RS,,,,3917,3825,3693,1854,1839,2913,780,-0.59%
4300877,4305,Metropolitana de Porto Alegre,43026,Porto Alegre,Araricá,RS,,,,4032,4781,4868,2458,2410,4000,868,1.90%
4300901,4301,Noroeste Rio-grandense,43004,Erechim,Aratiba,RS,13905,11765,10714,7116,6616,6568,3341,3227,3316,3252,-0.80%
4301008,4304,Centro Oriental Rio-grandense,43021,Lajeado-Estrela,Arroio do Meio,RS,19515,19131,19072,16951,18079,18783,9353,9430,14663,4120,1.03%
4301057,4305,Metropolitana de Porto Alegre,43027,Osório,Arroio do Sal,RS,,,3031,5273,6635,7744,3832,3912,7513,231,3.92%
4301073,4307,Sudeste Rio-grandense,43033,Pelotas,Arroio do Padre,RS,,,,,2734,2730,1415,1315,454,2276,-
4301107,4305,Metropolitana de Porto Alegre,43025,São Jerônimo,Arroio dos Ratos,RS,7904,9580,11824,13335,13619,13608,6636,6972,12958,650,0.20%
4301206,4304,Centro Oriental Rio-grandense,43020,Santa Cruz do Sul,Arroio do Tigre,RS,16105,16183,15581,12216,12638,12648,6384,6264,5962,6686,0.35%
4301305,4307,Sudeste Rio-grandense,43034,Jaguarão,Arroio Grande,RS,18210,16653,18150,19152,18358,18469,9175,9294,16086,2383,-0.36%
4301404,4302,Nordeste Rio-grandense,43014,Guaporé,Arvorezinha,RS,14475,14886,12636,10262,10210,10229,5138,5091,6277,3952,-0.03%
4301503,4301,Noroeste Rio-grandense,43008,Ijuí,Augusto Pestana,RS,9232,8925,8615,8173,7273,7097,3487,3610,3657,3440,-1.40%
4301552,4301,Noroeste Rio-grandense,43004,Erechim,Áurea,RS,,,7423,3889,3715,3665,1807,1858,1537,2128,-0.59%
4301602,4306,Sudoeste Rio-grandense,43031,Campanha Meridional,Bagé,RS,90280,100133,118967,118767,112550,116792,55794,60998,97762,19030,-0.17%
4301636,4305,Metropolitana de Porto Alegre,43027,Osório,Balneário Pinhal,RS,,,,7452,10517,10855,5346,5509,10742,113,3.83%
4301651,4305,Metropolitana de Porto Alegre,43023,Montenegro,Barão,RS,,,6835,5397,5293,5742,2910,2832,2967,2775,0.62%
4301701,4301,Noroeste Rio-grandense,43004,Erechim,Barão de Cotegipe,RS,8665,7503,7370,6927,6519,6529,3296,3233,3966,2563,-0.59%
4301750,4305,Metropolitana de Porto Alegre,43025,São Jerônimo,Barão do Triunfo,RS,,,,6662,6924,7018,3740,3278,697,6321,0.52%
4301800,4301,Noroeste Rio-grandense,43005,Sananduva,Barracão,RS,8635,7168,6233,5592,5306,5355,2691,2664,3035,2320,-0.43%
4301859,4301,Noroeste Rio-grandense,43002,Três Passos,Barra do Guarita,RS,,,,2987,2969,3089,1550,1539,1371,1718,0.34%
4301875,4306,Sudoeste Rio-grandense,43029,Campanha Ocidental,Barra do Quaraí,RS,,,,3884,3776,4016,2130,1886,2840,1176,0.33%
4301909,4305,Metropolitana de Porto Alegre,43028,Camaquã,Barra do Ribeiro,RS,9382,10491,11775,11845,11478,12568,6252,6316,9291,3277,0.59%
4301925,4301,Noroeste Rio-grandense,43004,Erechim,Barra do Rio Azul,RS,,,,2414,2028,2003,1049,954,403,1600,-1.85%
4301958,4301,Noroeste Rio-grandense,43009,Carazinho,Barra Funda,RS,,,,2231,2338,2367,1177,1190,1522,845,0.59%
4302006,4301,Noroeste Rio-grandense,43013,Soledade,Barros Cassal,RS,15502,14059,13271,11347,11450,11133,5729,5404,3531,7602,-0.19%
4302055,4301,Noroeste Rio-grandense,43004,Erechim,Benjamin Constant do Sul,RS,,,,2727,2256,2307,1195,1112,341,1966,-1.66%
4302105,4302,Nordeste Rio-grandense,43016,Caxias do Sul,Bento Gonçalves,RS,41979,58936,78643,91486,100643,107341,52713,54628,99121,8220,1.61%
4302154,4301,Noroeste Rio-grandense,43009,Carazinho,Boa Vista das Missões,RS,,,,2188,2066,2114,1056,1058,886,1228,-0.34%
4302204,4301,Noroeste Rio-grandense,43002,Três Passos,Boa Vista do Buricá,RS,8747,8829,9086,6587,6468,6576,3294,3282,4368,2208,-0.02%
4302220,4301,Noroeste Rio-grandense,43011,Cruz Alta,Boa Vista do Cadeado,RS,,,,,2447,2441,1257,1184,472,1969,-
4302238,4301,Noroeste Rio-grandense,43011,Cruz Alta,Boa Vista do Incra,RS,,,,,2447,2425,1243,1182,724,1701,-
4302253,4302,Nordeste Rio-grandense,43016,Caxias do Sul,Boa Vista do Sul,RS,,,,2840,2663,2778,1467,1311,391,2387,-0.22%
4302303,4302,Nordeste Rio-grandense,43015,Vacaria,Bom Jesus,RS,24023,16739,16190,12014,11843,11556,5720,5836,8595,2961,-0.39%
4302352,4305,Metropolitana de Porto Alegre,43023,Montenegro,Bom Princípio,RS,,,7471,9494,10910,11792,6031,5761,9201,2591,2.19%
4302378,4301,Noroeste Rio-grandense,43002,Três Passos,Bom Progresso,RS,,,,2831,2441,2328,1167,1161,1146,1182,-1.94%
4302402,4304,Centro Oriental Rio-grandense,43021,Lajeado-Estrela,Bom Retiro do Sul,RS,8914,8852,11470,10788,11130,11472,5655,5817,9162,2310,0.62%
4302451,4304,Centro Oriental Rio-grandense,43021,Lajeado-Estrela,Boqueirão do Leão,RS,,,7359,7825,7825,7673,3937,3736,1672,6001,-0.20%
4302501,4301,Noroeste Rio-grandense,43007,Santo Ângelo,Bossoroca,RS,7043,7435,7934,7757,7652,6887,3510,3377,3682,3205,-1.18%
4302584,4301,Noroeste Rio-grandense,43008,Ijuí,Bozano,RS,,,,,2296,2200,1100,1100,629,1571,-
4302600,4301,Noroeste Rio-grandense,43002,Três Passos,Braga,RS,6700,5780,4924,4198,3826,3702,1866,1836,2282,1420,-1.25%
4302659,4305,Metropolitana de Porto Alegre,43023,Montenegro,Brochier,RS,,,6066,4372,4701,4677,2399,2278,2296,2381,0.68%
4302709,4305,Metropolitana de Porto Alegre,43025,São Jerônimo,Butiá,RS,21947,21212,25534,20322,19717,20405,10032,10373,19331,1074,0.04%
4302808,4307,Sudeste Rio-grandense,43032,Serras de Sudeste,Caçapava do Sul,RS,33829,32977,34618,34643,32574,33700,16333,17367,25420,8280,-0.28%
4302907,4303,Centro Ocidental Rio-grandense,43018,Santa Maria,Cacequi,RS,18676,15205,15834,15311,13629,13685,6839,6846,11964,1721,-1.12%
4303004,4304,Centro Oriental Rio-grandense,43022,Cachoeira do Sul,Cachoeira do Sul,RS,94261,93341,89148,87873,84629,83827,40381,43446,71699,12128,-0.47%
4303103,4305,Metropolitana de Porto Alegre,43026,Porto Alegre,Cachoeirinha,RS,31002,63196,88195,107564,112603,118294,57162,61132,118294,0,0.96%
4303202,4301,Noroeste Rio-grandense,43005,Sananduva,Cacique Doble,RS,6497,5997,5704,4770,4824,4865,2412,2453,1626,3239,0.20%
4303301,4301,Noroeste Rio-grandense,43006,Cerro Largo,Caibaté,RS,7893,8382,7830,7243,5080,4954,2532,2422,2745,2209,-3.73%
4303400,4301,Noroeste Rio-grandense,43003,Frederico Westphalen,Caiçara,RS,9045,6952,6202,5580,5184,5071,2585,2486,1594,3477,-0.95%
4303509,4305,Metropolitana de Porto Alegre,43028,Camaquã,Camaquã,RS,57288,57353,61704,60383,60563,62759,30895,31864,49355,13404,0.39%
4303558,4301,Noroeste Rio-grandense,43010,Passo Fundo,Camargo,RS,,,2526,2498,2471,2591,1291,1300,1095,1496,0.37%
4303608,4302,Nordeste Rio-grandense,43015,Vacaria,Cambará do Sul,RS,8578,6778,7092,6840,6959,6545,3350,3195,3041,3504,-0.44%
4303673,4302,Nordeste Rio-grandense,43015,Vacaria,Campestre da Serra,RS,,,,3170,3205,3247,1674,1573,1232,2015,0.24%
4303707,4301,Noroeste Rio-grandense,43006,Cerro Largo,Campina das Missões,RS,7801,8277,8056,7014,6342,6117,3055,3062,2188,3929,-1.36%
4303806,4301,Noroeste Rio-grandense,43004,Erechim,Campinas do Sul,RS,10136,8680,8554,8258,5588,5509,2651,2858,4220,1289,-3.97%
4303905,4305,Metropolitana de Porto Alegre,43026,Porto Alegre,Campo Bom,RS,16617,33785,47876,54018,56595,60081,29474,30607,57345,2736,1.07%
4304002,4301,Noroeste Rio-grandense,43002,Três Passos,Campo Novo,RS,10332,10717,9410,6721,5581,5459,2684,2775,4109,1350,-2.06%
4304101,4301,Noroeste Rio-grandense,43011,Cruz Alta,Campos Borges,RS,,,3868,3785,3564,3494,1754,1740,2006,1488,-0.80%
4304200,4304,Centro Oriental Rio-grandense,43020,Santa Cruz do Sul,Candelária,RS,26559,26371,28012,29585,29444,30176,14756,15420,15715,14461,0.20%
4304309,4301,Noroeste Rio-grandense,43001,Santa Rosa,Cândido Godói,RS,7690,8008,7454,7092,6634,6535,3318,3217,1846,4689,-0.81%
4304358,4307,Sudeste Rio-grandense,43032,Serras de Sudeste,Candiota,RS,,,,8065,8236,8776,4486,4290,2600,6176,0.85%
4304408,4305,Metropolitana de Porto Alegre,43024,Gramado-Canela,Canela,RS,13909,19273,24801,33625,38318,39238,19127,20111,35840,3398,1.56%
4304507,4307,Sudeste Rio-grandense,43033,Pelotas,Canguçu,RS,62451,55822,50367,51447,53547,53268,26857,26411,19696,33572,0.35%
4304606,4305,Metropolitana de Porto Alegre,43026,Porto Alegre,Canoas,RS,153730,220446,279127,306093,326458,324025,156014,168011,324025,0,0.57%
4304614,4304,Centro Oriental Rio-grandense,43021,Lajeado-Estrela,Canudos do Vale,RS,,,,,1941,1807,959,848,411,1396,-
4304622,4302,Nordeste Rio-grandense,43015,Vacaria,Capão Bonito do Sul,RS,,,,,1837,1753,942,811,499,1254,-
4304630,4305,Metropolitana de Porto Alegre,43027,Osório,Capão da Canoa,RS,,,24755,30498,37405,42047,20625,21422,41794,253,3.26%
4304655,4303,Centro Ocidental Rio-grandense,43017,Santiago,Capão do Cipó,RS,,,,,3180,3107,1625,1482,519,2588,-
4304663,4307,Sudeste Rio-grandense,43033,Pelotas,Capão do Leão,RS,,,18894,23718,23655,24294,11962,12332,22378,1916,0.24%
4304671,4305,Metropolitana de Porto Alegre,43027,Osório,Capivari do Sul,RS,,,,3107,3339,3890,1935,1955,3230,660,2.27%
4304689,4305,Metropolitana de Porto Alegre,43023,Montenegro,Capela de Santana,RS,,,7476,10032,10950,11613,5845,5768,6915,4698,1.47%
4304697,4304,Centro Oriental Rio-grandense,43021,Lajeado-Estrela,Capitão,RS,,,,2565,2595,2636,1353,1283,1147,1489,0.27%
4304705,4301,Noroeste Rio-grandense,43009,Carazinho,Carazinho,RS,42504,53681,58767,59894,58196,59301,28267,31034,58237,1064,-0.10%
4304713,4305,Metropolitana de Porto Alegre,43027,Osório,Caraá,RS,,,,6403,7131,7313,3798,3515,1058,6255,1.34%
4304804,4302,Nordeste Rio-grandense,43016,Caxias do Sul,Carlos Barbosa,RS,12374,13651,15921,20519,23960,25193,12663,12530,19993,5200,2.07%
4304853,4301,Noroeste Rio-grandense,43004,Erechim,Carlos Gomes,RS,,,,1912,1719,1607,833,774,378,1229,-1.72%
4304903,4301,Noroeste Rio-grandense,43010,Passo Fundo,Casca,RS,15539,14301,10232,8440,8381,8648,4241,4407,5087,3561,0.24%
4304952,4301,Noroeste Rio-grandense,43010,Passo Fundo,Caseiros,RS,,,2867,2899,2989,3007,1517,1490,1488,1519,0.37%
4305009,4301,Noroeste Rio-grandense,43007,Santo Ângelo,Catuípe,RS,15594,14667,10988,10198,9499,9323,4590,4733,5998,3325,-0.89%
4305108,4302,Nordeste Rio-grandense,43016,Caxias do Sul,Caxias do Sul,RS,144871,220553,290925,360419,399038,435482,213547,221935,419321,16161,1.91%
4305116,4301,Noroeste Rio-grandense,43004,Erechim,Centenário,RS,,,,3127,3026,2967,1542,1425,949,2018,-0.52%
4305124,4307,Sudeste Rio-grandense,43033,Pelotas,Cerrito,RS,,,,6925,6629,6404,3214,3190,3747,2657,-0.78%
4305132,4304,Centro Oriental Rio-grandense,43022,Cachoeira do Sul,Cerro Branco,RS,,,3901,4297,4465,4454,2225,2229,1274,3180,0.36%
4305157,4301,Noroeste Rio-grandense,43009,Carazinho,Cerro Grande,RS,,,2973,2601,2577,2417,1209,1208,830,1587,-0.73%
4305173,4305,Metropolitana de Porto Alegre,43028,Camaquã,Cerro Grande do Sul,RS,,,8023,8273,9233,10280,5361,4919,2486,7794,2.20%
4305207,4301,Noroeste Rio-grandense,43006,Cerro Largo,Cerro Largo,RS,18002,19241,18901,12665,12484,13289,6617,6672,10571,2718,0.48%
4305306,4301,Noroeste Rio-grandense,43009,Carazinho,Chapada,RS,10573,10217,10538,9746,9440,9377,4593,4784,5573,3804,-0.39%
4305355,4305,Metropolitana de Porto Alegre,43025,São Jerônimo,Charqueadas,RS,,,24756,29961,33705,35363,19574,15789,34533,830,1.67%
4305371,4301,Noroeste Rio-grandense,43010,Passo Fundo,Charrua,RS,,,,3783,3581,3471,1728,1743,584,2887,-0.86%
4305405,4301,Noroeste Rio-grandense,43008,Ijuí,Chiapetta,RS,4405,4419,6670,4481,4078,4044,1975,2069,2470,1574,-1.02%
4305439,4307,Sudeste Rio-grandense,43035,Litoral Lagunar,Chuí,RS,,,,5167,5278,5919,2922,2997,5699,220,1.37%
4305447,4305,Metropolitana de Porto Alegre,43028,Camaquã,Chuvisca,RS,,,,4502,4874,4944,2603,2341,273,4671,0.94%
4305454,4305,Metropolitana de Porto Alegre,43027,Osório,Cidreira,RS,,,8967,8882,10883,12654,6231,6423,12251,403,3.60%
4305504,4301,Noroeste Rio-grandense,43010,Passo Fundo,Ciríaco,RS,7587,7792,7154,5252,4945,4922,2512,2410,2494,2428,-0.65%
4305587,4304,Centro Oriental Rio-grandense,43021,Lajeado-Estrela,Colinas,RS,,,,2462,2404,2420,1209,1211,1105,1315,-0.17%
4305603,4301,Noroeste Rio-grandense,43012,Não-Me-Toque,Colorado,RS,5558,4488,4395,4072,3744,3550,1727,1823,1844,1706,-1.36%
4305702,4301,Noroeste Rio-grandense,43008,Ijuí,Condor,RS,5911,6401,6421,6491,6607,6552,3217,3335,4034,2518,0.09%
4305801,4301,Noroeste Rio-grandense,43003,Frederico Westphalen,Constantina,RS,15521,17034,15063,11667,9842,9741,4769,4972,6497,3244,-1.79%
4305835,4304,Centro Oriental Rio-grandense,43021,Lajeado-Estrela,Coqueiro Baixo,RS,,,,,1566,1528,791,737,282,1246,-
4305850,4301,Noroeste Rio-grandense,43009,Carazinho,Coqueiros do Sul,RS,,,,2695,3106,2457,1255,1202,904,1553,-0.92%
4305871,4301,Noroeste Rio-grandense,43008,Ijuí,Coronel Barros,RS,,,,2454,2441,2459,1219,1240,1093,1366,0.02%
4305900,4301,Noroeste Rio-grandense,43008,Ijuí,Coronel Bicaco,RS,8437,9237,9598,8435,7873,7748,3801,3947,5068,2680,-0.85%
4305934,4302,Nordeste Rio-grandense,43016,Caxias do Sul,Coronel Pilar,RS,,,,,1658,1725,893,832,174,1551,-
4305959,4302,Nordeste Rio-grandense,43016,Caxias do Sul,Cotiporã,RS,,,4159,4093,4577,3917,2033,1884,2048,1869,-0.44%
4305975,4301,Noroeste Rio-grandense,43010,Passo Fundo,Coxilha,RS,,,,2979,2916,2826,1388,1438,1739,1087,-0.53%
4306007,4301,Noroeste Rio-grandense,43002,Três Passos,Crissiumal,RS,19275,19577,18183,15180,14726,14085,6914,7171,6124,7961,-0.75%
4306056,4307,Sudeste Rio-grandense,43033,Pelotas,Cristal,RS,,,6075,6632,7026,7280,3686,3594,4077,3203,0.94%
4306072,4301,Noroeste Rio-grandense,43003,Frederico Westphalen,Cristal do Sul,RS,,,,2874,2967,2826,1441,1385,931,1895,-0.17%
4306106,4301,Noroeste Rio-grandense,43011,Cruz Alta,Cruz Alta,RS,57930,66170,68793,71254,63450,62825,29744,33081,60598,2227,-1.25%
4306130,4301,Noroeste Rio-grandense,43004,Erechim,Cruzaltense,RS,,,,,2273,2141,1101,1040,489,1652,-
4306205,4304,Centro Oriental Rio-grandense,43021,Lajeado-Estrela,Cruzeiro do Sul,RS,8771,9335,10798,11664,12171,12331,6160,6171,7478,4853,0.56%
4306304,4301,Noroeste Rio-grandense,43010,Passo Fundo,David Canabarro,RS,6281,5295,5093,4740,4704,4683,2410,2273,1912,2771,-0.12%
4306320,4301,Noroeste Rio-grandense,43002,Três Passos,Derrubadas,RS,,,,3715,3378,3190,1604,1586,901,2289,-1.51%
4306353,4301,Noroeste Rio-grandense,43007,Santo Ângelo,Dezesseis de Novembro,RS,,,3978,3444,2968,2866,1469,1397,667,2199,-1.82%
4306379,4303,Centro Ocidental Rio-grandense,43018,Santa Maria,Dilermando de Aguiar,RS,,,,3200,3129,3064,1579,1485,991,2073,-0.43%
4306403,4305,Metropolitana de Porto Alegre,43024,Gramado-Canela,Dois Irmãos,RS,13803,15205,18951,22435,24815,27572,13651,13921,27276,296,2.08%
4306429,4301,Noroeste Rio-grandense,43003,Frederico Westphalen,Dois Irmãos das Missões,RS,,,,2365,2362,2157,1080,1077,1094,1063,-0.92%
4306452,4302,Nordeste Rio-grandense,43014,Guaporé,Dois Lajeados,RS,,,5615,3224,3334,3280,1654,1626,1563,1717,0.17%
4306502,4305,Metropolitana de Porto Alegre,43028,Camaquã,Dom Feliciano,RS,14409,12620,12407,13297,14504,14380,7398,6982,3334,11046,0.79%
4306551,4305,Metropolitana de Porto Alegre,43027,Osório,Dom Pedro de Alcântara,RS,,,,2636,2728,2550,1342,1208,739,1811,-0.33%
4306601,4306,Sudoeste Rio-grandense,43031,Campanha Meridional,Dom Pedrito,RS,32801,35150,38054,40410,38148,38916,19119,19797,35275,3641,-0.38%
4306700,4303,Centro Ocidental Rio-grandense,43019,Restinga Seca,Dona Francisca,RS,3473,3121,3586,3902,3572,3401,1678,1723,2146,1255,-1.36%
4306734,4301,Noroeste Rio-grandense,43002,Três Passos,Doutor Maurício Cardoso,RS,,,7208,6329,5494,5313,2646,2667,2619,2694,-1.73%
4306759,4304,Centro Oriental Rio-grandense,43021,Lajeado-Estrela,Doutor Ricardo,RS,,,,2128,2053,2030,1035,995,693,1337,-0.47%
4306767,4305,Metropolitana de Porto Alegre,43026,Porto Alegre,Eldorado do Sul,RS,,,17703,27268,31316,34335,16997,17338,30792,3543,2.33%
4306809,4304,Centro Oriental Rio-grandense,43021,Lajeado-Estrela,Encantado,RS,18605,17801,18156,18528,19536,20514,9931,10583,17883,2631,1.02%
4306908,4307,Sudeste Rio-grandense,43032,Serras de Sudeste,Encruzilhada do Sul,RS,34548,27698,21479,23902,24152,24537,12321,12216,17117,7420,0.26%
4306924,4301,Noroeste Rio-grandense,43003,Frederico Westphalen,Engenho Velho,RS,,,,2134,1584,1530,744,786,602,928,-3.27%
4306932,4301,Noroeste Rio-grandense,43007,Santo Ângelo,Entre-Ijuís,RS,,,9955,9702,9126,8938,4415,4523,4893,4045,-0.82%
4306957,4301,Noroeste Rio-grandense,43004,Erechim,Entre Rios do Sul,RS,,,4041,3491,3101,3080,1556,1524,2130,950,-1.24%
4306973,4301,Noroeste Rio-grandense,43004,Erechim,Erebango,RS,,,3209,3023,2881,2970,1490,1480,1958,1012,-0.18%
4307005,4301,Noroeste Rio-grandense,43004,Erechim,Erechim,RS,48677,61115,72318,90347,92945,96105,46232,49873,90570,5535,0.62%
4307054,4301,Noroeste Rio-grandense,43010,Passo Fundo,Ernestina,RS,,,3849,3941,3010,3088,1562,1526,1671,1417,-2.41%
4307104,4307,Sudeste Rio-grandense,43034,Jaguarão,Herval,RS,7954,7280,7169,8487,6873,6757,3487,3270,4523,2234,-2.25%
4307203,4301,Noroeste Rio-grandense,43004,Erechim,Erval Grande,RS,10512,7968,7272,5647,5294,5167,2624,2543,2690,2477,-0.88%
4307302,4301,Noroeste Rio-grandense,43003,Frederico Westphalen,Erval Seco,RS,13496,14824,13021,9177,8212,7878,3920,3958,3437,4441,-1.51%
4307401,4302,Nordeste Rio-grandense,43015,Vacaria,Esmeralda,RS,8672,6405,5800,5521,3234,3169,1573,1596,2128,1041,-5.40%
4307450,4301,Noroeste Rio-grandense,43002,Três Passos,Esperança do Sul,RS,,,,3755,3445,3272,1650,1622,844,2428,-1.37%
4307500,4301,Noroeste Rio-grandense,43011,Cruz Alta,Espumoso,RS,34965,31999,17010,16185,14991,15240,7530,7710,11131,4109,-0.60%
4307559,4301,Noroeste Rio-grandense,43004,Erechim,Estação,RS,,,5531,6228,6086,6011,2951,3060,5119,892,-0.35%
4307609,4305,Metropolitana de Porto Alegre,43026,Porto Alegre,Estância Velha,RS,8916,14229,28190,35132,40740,42589,21045,21544,41496,1093,1.94%
4307708,4305,Metropolitana de Porto Alegre,43026,Porto Alegre,Esteio,RS,34597,50963,70547,80048,78816,80669,38945,41724,80562,107,0.08%
4307807,4304,Centro Oriental Rio-grandense,43021,Lajeado-Estrela,Estrela,RS,30752,37408,26686,27401,29071,30628,15126,15502,25922,4706,1.12%
4307815,4304,Centro Oriental Rio-grandense,43020,Santa Cruz do Sul,Estrela Velha,RS,,,,3691,3659,3628,1846,1782,1167,2461,-0.17%
4307831,4301,Noroeste Rio-grandense,43007,Santo Ângelo,Eugênio de Castro,RS,,,3541,3313,3057,2797,1415,1382,1480,1317,-1.68%
4307864,4302,Nordeste Rio-grandense,43016,Caxias do Sul,Fagundes Varela,RS,,,2553,2471,2508,2579,1300,1279,1293,1286,0.43%
4307906,4302,Nordeste Rio-grandense,43016,Caxias do Sul,Farroupilha,RS,19318,29000,45364,55308,59871,63641,31305,32336,55057,8584,1.41%
4308003,4303,Centro Ocidental Rio-grandense,43019,Restinga Seca,Faxinal do Soturno,RS,9058,8783,9084,6841,6343,6672,3274,3398,4175,2497,-0.25%
4308052,4301,Noroeste Rio-grandense,43004,Erechim,Faxinalzinho,RS,,,3085,2923,2613,2567,1283,1284,1273,1294,-1.29%
4308078,4304,Centro Oriental Rio-grandense,43021,Lajeado-Estrela,Fazenda Vilanova,RS,,,,2833,3068,3697,1856,1841,2013,1684,2.70%
4308102,4305,Metropolitana de Porto Alegre,43023,Montenegro,Feliz,RS,12727,13305,15565,11316,11679,12359,6161,6198,9416,2943,0.89%
4308201,4302,Nordeste Rio-grandense,43016,Caxias do Sul,Flores da Cunha,RS,14626,15486,19869,23678,25307,27135,13556,13579,20862,6273,1.37%
4308250,4301,Noroeste Rio-grandense,43004,Erechim,Floriano Peixoto,RS,,,,2361,2148,2018,1081,937,292,1726,-1.56%
4308300,4301,Noroeste Rio-grandense,43013,Soledade,Fontoura Xavier,RS,15312,14064,12092,11473,11074,10712,5458,5254,4093,6619,-0.68%
4308409,4303,Centro Ocidental Rio-grandense,43019,Restinga Seca,Formigueiro,RS,9706,7876,7696,7598,7116,7014,3570,3444,2769,4245,-0.80%
4308433,4304,Centro Oriental Rio-grandense,43021,Lajeado-Estrela,Forquetinha,RS,,,,,2548,2473,1261,1212,465,2008,-
4308458,4301,Noroeste Rio-grandense,43011,Cruz Alta,Fortaleza dos Valos,RS,,,4660,5079,4597,4577,2241,2336,2993,1584,-1.04%
4308508,4301,Noroeste Rio-grandense,43003,Frederico Westphalen,Frederico Westphalen,RS,25567,29933,24935,26759,27308,28848,14132,14716,23338,5510,0.75%
4308607,4302,Nordeste Rio-grandense,43016,Caxias do Sul,Garibaldi,RS,20812,23038,25926,28337,28791,30692,15223,15469,27638,3054,0.80%
4308656,4306,Sudoeste Rio-grandense,43029,Campanha Ocidental,Garruchos,RS,,,,3675,3457,3233,1683,1550,1056,2177,-1.27%
4308706,4301,Noroeste Rio-grandense,43004,Erechim,Gaurama,RS,14787,14222,6499,6391,6108,5862,2832,3030,3388,2474,-0.86%
4308805,4305,Metropolitana de Porto Alegre,43025,São Jerônimo,General Câmara,RS,13242,11696,11548,8737,8782,8452,4237,4215,4971,3481,-0.33%
4308854,4301,Noroeste Rio-grandense,43010,Passo Fundo,Gentil,RS,,,,1771,1579,1677,889,788,723,954,-0.54%
4308904,4301,Noroeste Rio-grandense,43004,Erechim,Getúlio Vargas,RS,27189,28116,20042,16509,15961,16156,7850,8306,13864,2292,-0.22%
4309001,4301,Noroeste Rio-grandense,43007,Santo Ângelo,Giruá,RS,25425,28597,26828,18749,17070,17085,8341,8744,12917,4168,-0.93%
4309050,4305,Metropolitana de Porto Alegre,43026,Porto Alegre,Glorinha,RS,,,4587,5684,6908,6885,3531,3354,2068,4817,1.94%
4309100,4305,Metropolitana de Porto Alegre,43024,Gramado-Canela,Gramado,RS,12378,16322,22095,28593,31652,32300,15685,16615,29039,3261,1.23%
4309126,4301,Noroeste Rio-grandense,43003,Frederico Westphalen,Gramado dos Loureiros,RS,,,,2543,2370,2269,1151,1118,526,1743,-1.13%
4309159,4304,Centro Oriental Rio-grandense,43020,Santa Cruz do Sul,Gramado Xavier,RS,,,,3666,3911,3970,2044,1926,529,3441,0.80%
4309209,4305,Metropolitana de Porto Alegre,43026,Porto Alegre,Gravataí,RS,52462,107437,181035,232629,261150,255762,124946,130816,243590,12172,0.95%
4309258,4302,Nordeste Rio-grandense,43014,Guaporé,Guabiju,RS,,,1737,1749,1669,1598,806,792,738,860,-0.90%
4309308,4305,Metropolitana de Porto Alegre,43026,Porto Alegre,Guaíba,RS,33680,55041,83102,94307,93578,95230,46163,49067,93081,2149,0.10%
4309407,4302,Nordeste Rio-grandense,43014,Guaporé,Guaporé,RS,25227,24630,19825,20064,21421,22810,11120,11690,20828,1982,1.29%
4309506,4301,Noroeste Rio-grandense,43006,Cerro Largo,Guarani das Missões,RS,10416,11301,11500,8990,8331,8115,3951,4164,5030,3085,-1.02%
4309555,4305,Metropolitana de Porto Alegre,43023,Montenegro,Harmonia,RS,,,3074,3659,3658,4254,2150,2104,2456,1798,1.52%
4309571,4304,Centro Oriental Rio-grandense,43020,Santa Cruz do Sul,Herveiras,RS,,,,2957,2825,2954,1543,1411,384,2570,-0.01%
4309605,4301,Noroeste Rio-grandense,43002,Três Passos,Horizontina,RS,20996,24678,17023,17699,18305,18350,8947,9403,14571,3779,0.36%
4309654,4306,Sudoeste Rio-grandense,43031,Campanha Meridional,Hulha Negra,RS,,,,5359,6030,6048,3129,2919,2914,3134,1.22%
4309704,4301,Noroeste Rio-grandense,43002,Três Passos,Humaitá,RS,11262,9948,6030,5228,4923,4919,2387,2532,2911,2008,-0.61%
4309753,4304,Centro Oriental Rio-grandense,43020,Santa Cruz do Sul,Ibarama,RS,,,5111,4454,4331,4371,2230,2141,1053,3318,-0.19%
4309803,4301,Noroeste Rio-grandense,43005,Sananduva,Ibiaçá,RS,7323,6735,5893,5233,4681,4710,2290,2420,2849,1861,-1.05%
4309902,4301,Noroeste Rio-grandense,43010,Passo Fundo,Ibiraiaras,RS,8495,7617,7806,7163,7094,7175,3589,3586,3815,3360,0.02%
4309951,4301,Noroeste Rio-grandense,43013,Soledade,Ibirapuitã,RS,,,5897,5170,4182,4061,2061,2000,2391,1670,-2.39%
4310009,4301,Noroeste Rio-grandense,43011,Cruz Alta,Ibirubá,RS,19339,19886,17816,18633,18690,19312,9472,9840,15344,3968,0.36%
4310108,4305,Metropolitana de Porto Alegre,43024,Gramado-Canela,Igrejinha,RS,7062,12027,20514,26767,31113,31663,15461,16202,30193,1470,1.69%
4310207,4301,Noroeste Rio-grandense,43008,Ijuí,Ijuí,RS,52738,70929,75157,78461,76739,78920,38116,40804,71555,7365,0.06%
4310306,4302,Nordeste Rio-grandense,43014,Guaporé,Ilópolis,RS,3424,3633,3860,4255,4202,4098,2055,2043,2203,1895,-0.38%
4310330,4305,Metropolitana de Porto Alegre,43027,Osório,Imbé,RS,,,7352,12242,14940,17667,8662,9005,17658,9,3.74%
4310363,4304,Centro Oriental Rio-grandense,43021,Lajeado-Estrela,Imigrante,RS,,,3961,3850,3013,3025,1496,1529,1501,1524,-2.38%
4310405,4301,Noroeste Rio-grandense,43001,Santa Rosa,Independência,RS,9046,8317,7491,7308,6679,6618,3293,3325,4157,2461,-0.99%
4310413,4301,Noroeste Rio-grandense,43008,Ijuí,Inhacorá,RS,,,,2378,2290,2267,1148,1119,1346,921,-0.48%
4310439,4302,Nordeste Rio-grandense,43015,Vacaria,Ipê,RS,,,5718,5456,5875,6017,3082,2935,2914,3103,0.98%
4310462,4301,Noroeste Rio-grandense,43004,Erechim,Ipiranga do Sul,RS,,,2348,2057,1983,1944,972,972,679,1265,-0.56%
4310504,4301,Noroeste Rio-grandense,43003,Frederico Westphalen,Iraí,RS,13012,13129,11583,9250,8468,8078,4075,4003,4457,3621,-1.35%
4310538,4303,Centro Ocidental Rio-grandense,43018,Santa Maria,Itaara,RS,,,,4578,4633,5011,2543,2468,3968,1043,0.91%
4310553,4303,Centro Ocidental Rio-grandense,43017,Santiago,Itacurubi,RS,,,3370,3503,3568,3441,1778,1663,1184,2257,-0.18%
4310579,4302,Nordeste Rio-grandense,43014,Guaporé,Itapuca,RS,,,,2691,2454,2337,1229,1108,551,1786,-1.40%
4310603,4306,Sudoeste Rio-grandense,43029,Campanha Ocidental,Itaqui,RS,28402,33303,40057,39770,36361,38166,19035,19131,33318,4848,-0.41%
4310652,4305,Metropolitana de Porto Alegre,43027,Osório,Itati,RS,,,,,2677,2589,1343,1246,212,2377,-
4310702,4301,Noroeste Rio-grandense,43004,Erechim,Itatiba do Sul,RS,8069,6683,6657,5252,4574,4171,2178,1993,1729,2442,-2.28%
4310751,4303,Centro Ocidental Rio-grandense,43019,Restinga Seca,Ivorá,RS,,,2563,2495,2378,2156,1097,1059,705,1451,-1.45%
4310801,4305,Metropolitana de Porto Alegre,43024,Gramado-Canela,Ivoti,RS,7070,8878,16326,15318,18517,19877,9800,10077,18065,1812,2.64%
4310850,4301,Noroeste Rio-grandense,43009,Carazinho,Jaboticaba,RS,,,5748,4536,4173,4111,2087,2024,1487,2624,-0.98%
4310876,4301,Noroeste Rio-grandense,43011,Cruz Alta,Jacuizinho,RS,,,,,2619,2507,1282,1225,562,1945,-
4310900,4301,Noroeste Rio-grandense,43004,Erechim,Jacutinga,RS,6999,6532,6307,4248,3567,3630,1780,1850,2570,1060,-1.56%
4311007,4307,Sudeste Rio-grandense,43034,Jaguarão,Jaguarão,RS,22451,23272,27755,30093,27944,27942,13600,14342,26101,1841,-0.74%
4311106,4303,Centro Ocidental Rio-grandense,43018,Santa Maria,Jaguari,RS,17825,15949,12749,12488,11626,11478,5737,5741,6531,4947,-0.84%
4311122,4302,Nordeste Rio-grandense,43015,Vacaria,Jaquirana,RS,,,4053,4814,4404,4177,2141,2036,2430,1747,-1.41%
4311130,4303,Centro Ocidental Rio-grandense,43017,Santiago,Jari,RS,,,,3751,3692,3575,1884,1691,613,2962,-0.48%
4311155,4301,Noroeste Rio-grandense,43011,Cruz Alta,Jóia,RS,,,7507,8284,8279,8329,4305,4024,2089,6240,0.05%
4311205,4303,Centro Ocidental Rio-grandense,43017,Santiago,Júlio de Castilhos,RS,24539,25620,25133,20416,19541,19579,9626,9953,16106,3473,-0.42%
4311239,4304,Centro Oriental Rio-grandense,43020,Santa Cruz do Sul,Lagoa Bonita do Sul,RS,,,,,2617,2662,1403,1259,384,2278,-
4311254,4301,Noroeste Rio-grandense,43013,Soledade,Lagoão,RS,,,6037,6098,6389,6185,3194,2991,1655,4530,0.14%
4311270,4301,Noroeste Rio-grandense,43012,Não-Me-Toque,Lagoa dos Três Cantos,RS,,,,1627,1590,1598,776,822,807,791,-0.18%
4311304,4302,Nordeste Rio-grandense,43015,Vacaria,Lagoa Vermelha,RS,28791,28259,28733,29833,27434,27529,13569,13960,24140,3389,-0.80%
4311403,4304,Centro Oriental Rio-grandense,43021,Lajeado-Estrela,Lajeado,RS,56992,63737,63944,64133,67474,71481,34750,36731,71216,265,1.09%
4311429,4301,Noroeste Rio-grandense,43009,Carazinho,Lajeado do Bugre,RS,,,,2463,2536,2487,1253,1234,706,1781,0.10%
4311502,4306,Sudoeste Rio-grandense,43031,Campanha Meridional,Lavras do Sul,RS,11494,9225,8830,8109,8115,7669,3770,3899,4748,2921,-0.56%
4311601,4301,Noroeste Rio-grandense,43003,Frederico Westphalen,Liberato Salzano,RS,10149,10631,8662,6574,6102,5780,2948,2832,1297,4483,-1.28%
4311627,4305,Metropolitana de Porto Alegre,43024,Gramado-Canela,Lindolfo Collor,RS,,,,4414,5279,5229,2680,2549,4289,940,1.71%
4311643,4305,Metropolitana de Porto Alegre,43023,Montenegro,Linha Nova,RS,,,,1564,1488,1624,807,817,416,1208,0.38%
4311700,4301,Noroeste Rio-grandense,43005,Sananduva,Machadinho,RS,10044,8098,7338,5728,5503,5515,2762,2753,3385,2130,-0.38%
4311718,4306,Sudoeste Rio-grandense,43029,Campanha Ocidental,Maçambará,RS,,,,5035,4415,4742,2419,2323,1312,3430,-0.60%
4311734,4305,Metropolitana de Porto Alegre,43027,Osório,Mampituba,RS,,,,3106,2926,2997,1551,1446,568,2429,-0.36%
4311759,4306,Sudoeste Rio-grandense,43029,Campanha Ocidental,Manoel Viana,RS,,,,6995,6784,7074,3558,3516,5364,1710,0.11%
4311775,4305,Metropolitana de Porto Alegre,43027,Osório,Maquiné,RS,,,,7304,7374,6908,3525,3383,2067,4841,-0.56%
4311791,4305,Metropolitana de Porto Alegre,43023,Montenegro,Maratá,RS,,,,2513,2444,2527,1272,1255,753,1774,0.06%
4311809,4301,Noroeste Rio-grandense,43010,Passo Fundo,Marau,RS,26418,26997,25167,28361,33778,36383,18034,18349,31577,4806,2.52%
4311908,4301,Noroeste Rio-grandense,43004,Erechim,Marcelino Ramos,RS,8828,7769,7080,6108,5372,5134,2555,2579,2722,2412,-1.72%
4311981,4305,Metropolitana de Porto Alegre,43026,Porto Alegre,Mariana Pimentel,RS,,,,3733,3964,3768,1970,1798,638,3130,0.09%
4312005,4301,Noroeste Rio-grandense,43004,Erechim,Mariano Moro,RS,4142,3345,2997,2474,2284,2210,1133,1077,1153,1057,-1.12%
4312054,4304,Centro Oriental Rio-grandense,43021,Lajeado-Estrela,Marques de Souza,RS,,,,4241,4043,4068,2039,2029,1545,2523,-0.42%
4312104,4303,Centro Ocidental Rio-grandense,43018,Santa Maria,Mata,RS,7347,6166,5578,5575,5291,5111,2575,2536,2618,2493,-0.87%
4312138,4301,Noroeste Rio-grandense,43010,Passo Fundo,Mato Castelhano,RS,,,,2454,2608,2470,1292,1178,521,1949,0.07%
4312153,4304,Centro Oriental Rio-grandense,43020,Santa Cruz do Sul,Mato Leitão,RS,,,,3210,3585,3869,1940,1929,1621,2248,1.88%
4312179,4301,Noroeste Rio-grandense,43006,Cerro Largo,Mato Queimado,RS,,,,,1865,1799,902,897,479,1320,-
4312203,4301,Noroeste Rio-grandense,43005,Sananduva,Maximiliano de Almeida,RS,7044,6951,6633,5651,5059,4907,2464,2443,2969,1938,-1.40%
4312252,4305,Metropolitana de Porto Alegre,43025,São Jerônimo,Minas do Leão,RS,,,,7321,7728,7631,3778,3853,7340,291,0.42%
4312302,4301,Noroeste Rio-grandense,43002,Três Passos,Miraguaí,RS,8400,7681,5999,5034,4869,4855,2413,2442,2069,2786,-0.36%
4312351,4302,Nordeste Rio-grandense,43014,Guaporé,Montauri,RS,,,1786,1684,1583,1542,794,748,644,898,-0.88%
4312377,4302,Nordeste Rio-grandense,43015,Vacaria,Monte Alegre dos Campos,RS,,,,3040,3122,3098,1657,1441,645,2453,0.19%
4312385,4302,Nordeste Rio-grandense,43016,Caxias do Sul,Monte Belo do Sul,RS,,,,2880,2766,2670,1345,1325,770,1900,-0.75%
4312401,4305,Metropolitana de Porto Alegre,43023,Montenegro,Montenegro,RS,46676,48816,49099,54692,56790,59436,29248,30188,53645,5791,0.84%
4312427,4301,Noroeste Rio-grandense,43013,Soledade,Mormaço,RS,,,,2435,2578,2749,1395,1354,600,2149,1.22%
4312443,4305,Metropolitana de Porto Alegre,43027,Osório,Morrinhos do Sul,RS,,,,3533,3241,3185,1617,1568,1300,1885,-1.03%
4312450,4307,Sudeste Rio-grandense,43033,Pelotas,Morro Redondo,RS,,,6070,5998,6199,6231,3137,3094,2648,3583,0.38%
4312476,4305,Metropolitana de Porto Alegre,43024,Gramado-Canela,Morro Reuter,RS,,,,4984,5599,5680,2851,2829,4845,835,1.32%
4312500,4305,Metropolitana de Porto Alegre,43027,Osório,Mostardas,RS,14290,12969,9089,11658,11903,12130,6189,5941,8149,3981,0.40%
4312609,4304,Centro Oriental Rio-grandense,43021,Lajeado-Estrela,Muçum,RS,7923,7910,7127,4728,4574,4791,2300,2491,4044,747,0.13%
4312617,4302,Nordeste Rio-grandense,43015,Vacaria,Muitos Capões,RS,,,,2867,2969,2977,1534,1443,964,2013,0.38%
4312625,4301,Noroeste Rio-grandense,43010,Passo Fundo,Muliterno,RS,,,,1768,1800,1813,923,890,508,1305,0.25%
4312658,4301,Noroeste Rio-grandense,43012,Não-Me-Toque,Não-Me-Toque,RS,10968,12771,14028,14413,15228,15938,7857,8081,13966,1972,1.01%
4312674,4301,Noroeste Rio-grandense,43010,Passo Fundo,Nicolau Vergueiro,RS,,,,1812,1759,1721,862,859,636,1085,-0.51%
4312708,4301,Noroeste Rio-grandense,43003,Frederico Westphalen,Nonoai,RS,29757,28439,20929,12822,12327,12076,5932,6144,9067,3009,-0.60%
4312757,4302,Nordeste Rio-grandense,43014,Guaporé,Nova Alvorada,RS,,,2653,2757,3058,3177,1595,1582,1332,1845,1.43%
4312807,4302,Nordeste Rio-grandense,43014,Guaporé,Nova Araçá,RS,2296,2251,2868,3236,3775,4003,1958,2045,2882,1121,2.15%
4312906,4302,Nordeste Rio-grandense,43014,Guaporé,Nova Bassano,RS,6381,6269,6762,7836,8683,8840,4480,4360,5514,3326,1.21%
4312955,4301,Noroeste Rio-grandense,43009,Carazinho,Nova Boa Vista,RS,,,,2222,2083,1960,981,979,578,1382,-1.25%
4313003,4304,Centro Oriental Rio-grandense,43021,Lajeado-Estrela,Nova Bréscia,RS,9360,6996,5174,4564,3162,3184,1629,1555,1511,1673,-3.54%
4313011,4301,Noroeste Rio-grandense,43002,Três Passos,Nova Candelária,RS,,,,2883,2739,2751,1405,1346,709,2042,-0.47%
4313037,4303,Centro Ocidental Rio-grandense,43018,Santa Maria,Nova Esperança do Sul,RS,,,3589,4010,4775,4671,2306,2365,3599,1072,1.54%
4313060,4305,Metropolitana de Porto Alegre,43026,Porto Alegre,Nova Hartz,RS,,,10013,15071,16688,18346,9072,9274,15269,3077,1.99%
4313086,4302,Nordeste Rio-grandense,43016,Caxias do Sul,Nova Pádua,RS,,,,2396,2484,2445,1256,1189,732,1713,0.20%
4313102,4303,Centro Ocidental Rio-grandense,43019,Restinga Seca,Nova Palma,RS,7995,8031,7656,6312,6432,6345,3219,3126,3083,3262,0.05%
4313201,4305,Metropolitana de Porto Alegre,43024,Gramado-Canela,Nova Petrópolis,RS,13223,13873,16767,16891,17747,19058,9375,9683,14146,4912,1.21%
4313300,4302,Nordeste Rio-grandense,43014,Guaporé,Nova Prata,RS,20818,21116,15076,18344,22257,22830,11303,11527,18659,4171,2.21%
4313334,4301,Noroeste Rio-grandense,43008,Ijuí,Nova Ramada,RS,,,,2723,2461,2437,1246,1191,670,1767,-1.10%
4313359,4302,Nordeste Rio-grandense,43016,Caxias do Sul,Nova Roma do Sul,RS,,,2959,3032,3490,3347,1711,1636,1589,1758,0.99%
4313375,4305,Metropolitana de Porto Alegre,43026,Porto Alegre,Nova Santa Rita,RS,,,,15750,20591,22706,11440,11266,19465,3241,3.73%
4313391,4304,Centro Oriental Rio-grandense,43022,Cachoeira do Sul,Novo Cabrais,RS,,,,3565,3766,3855,1946,1909,545,3310,0.79%
4313409,4305,Metropolitana de Porto Alegre,43026,Porto Alegre,Novo Hamburgo,RS,85364,136494,205668,236193,253067,239051,115810,123241,234909,4142,0.12%
4313425,4301,Noroeste Rio-grandense,43001,Santa Rosa,Novo Machado,RS,,,,4718,4246,3927,1949,1978,1553,2374,-1.82%
4313441,4301,Noroeste Rio-grandense,43003,Frederico Westphalen,Novo Tiradentes,RS,,,,2412,2331,2277,1191,1086,654,1623,-0.57%
4313466,4301,Noroeste Rio-grandense,43003,Frederico Westphalen,Novo Xingu,RS,,,,,1858,1757,861,896,559,1198,-
4313490,4301,Noroeste Rio-grandense,43009,Carazinho,Novo Barreiro,RS,,,,3867,3858,3978,2032,1946,1306,2672,0.28%
4313508,4305,Metropolitana de Porto Alegre,43027,Osório,Osório,RS,55569,60512,36857,36131,39290,40941,20186,20755,37951,2990,1.26%
4313607,4301,Noroeste Rio-grandense,43005,Sananduva,Paim Filho,RS,10692,10644,5395,4831,4480,4243,2111,2132,2253,1990,-1.29%
4313656,4305,Metropolitana de Porto Alegre,43027,Osório,Palmares do Sul,RS,,,11248,10854,11423,10971,5462,5509,9805,1166,0.11%
4313706,4301,Noroeste Rio-grandense,43009,Carazinho,Palmeira das Missões,RS,58658,65996,52968,38192,33846,34335,16643,17692,29836,4499,-1.06%
4313805,4301,Noroeste Rio-grandense,43003,Frederico Westphalen,Palmitinho,RS,13247,13576,11669,6943,6905,6920,3494,3426,3393,3527,-0.03%
4313904,4301,Noroeste Rio-grandense,43008,Ijuí,Panambi,RS,16193,23870,29379,32610,36360,38068,19018,19050,34572,3496,1.56%
4313953,4304,Centro Oriental Rio-grandense,43022,Cachoeira do Sul,Pantano Grande,RS,,,10017,10979,9816,9895,4909,4986,8314,1581,-1.03%
4314001,4302,Nordeste Rio-grandense,43014,Guaporé,Paraí,RS,4167,4527,5110,6020,6577,6812,3451,3361,3816,2996,1.24%
4314027,4304,Centro Oriental Rio-grandense,43022,Cachoeira do Sul,Paraíso do Sul,RS,,,6565,7212,7346,7336,3694,3642,2852,4484,0.17%
4314035,4305,Metropolitana de Porto Alegre,43023,Montenegro,Pareci Novo,RS,,,,3242,3151,3511,1784,1727,981,2530,0.80%
4314050,4305,Metropolitana de Porto Alegre,43026,Porto Alegre,Parobé,RS,,,31995,44776,48713,51481,25438,26043,48612,2869,1.41%
4314068,4304,Centro Oriental Rio-grandense,43020,Santa Cruz do Sul,Passa Sete,RS,,,,4644,4996,5159,2681,2478,555,4604,1.06%
4314076,4304,Centro Oriental Rio-grandense,43022,Cachoeira do Sul,Passo do Sobrado,RS,,,,5566,5967,6011,2996,3015,1429,4582,0.77%
4314100,4301,Noroeste Rio-grandense,43010,Passo Fundo,Passo Fundo,RS,93850,121155,147318,168458,183300,184869,88076,96793,180159,4710,0.93%
4314134,4301,Noroeste Rio-grandense,43004,Erechim,Paulo Bento,RS,,,,,2090,2196,1126,1070,594,1602,-
4314159,4304,Centro Oriental Rio-grandense,43021,Lajeado-Estrela,Paverama,RS,,,7202,7744,7616,8047,4052,3995,4101,3946,0.38%
4314175,4307,Sudeste Rio-grandense,43032,Serras de Sudeste,Pedras Altas,RS,,,,,2546,2218,1163,1055,772,1446,-
4314209,4307,Sudeste Rio-grandense,43033,Pelotas,Pedro Osório,RS,16261,15020,14862,8107,8039,7817,3834,3983,7309,508,-0.36%
4314308,4301,Noroeste Rio-grandense,43008,Ijuí,Pejuçara,RS,3418,3573,4039,4189,3900,3973,2008,1965,2672,1301,-0.53%
4314407,4307,Sudeste Rio-grandense,43033,Pelotas,Pelotas,RS,207869,259994,291100,323158,339934,327778,153898,173880,305696,22082,0.14%
4314423,4305,Metropolitana de Porto Alegre,43024,Gramado-Canela,Picada Café,RS,,,,4673,4824,5182,2594,2588,4559,623,1.04%
4314456,4301,Noroeste Rio-grandense,43009,Carazinho,Pinhal,RS,,,2740,2503,2362,2515,1274,1241,1290,1225,0.05%
4314464,4302,Nordeste Rio-grandense,43015,Vacaria,Pinhal da Serra,RS,,,,,2058,2130,1109,1021,478,1652,-
4314472,4303,Centro Ocidental Rio-grandense,43017,Santiago,Pinhal Grande,RS,,,,4725,4496,4471,2314,2157,1895,2576,-0.55%
4314498,4301,Noroeste Rio-grandense,43003,Frederico Westphalen,Pinheirinho do Vale,RS,,,,4184,4411,4503,2280,2223,915,3588,0.74%
4314506,4307,Sudeste Rio-grandense,43032,Serras de Sudeste,Pinheiro Machado,RS,14260,14359,15396,14594,12939,12787,6389,6398,9791,2996,-1.31%
4314555,4301,Noroeste Rio-grandense,43007,Santo Ângelo,Pirapó,RS,,,3819,3349,2988,2757,1398,1359,777,1980,-1.93%
4314605,4307,Sudeste Rio-grandense,43032,Serras de Sudeste,Piratini,RS,24444,20124,17655,19414,20225,19831,10101,9730,11564,8267,0.21%
4314704,4301,Noroeste Rio-grandense,43003,Frederico Westphalen,Planalto,RS,17584,17700,17875,11302,10589,10524,5209,5315,5932,4592,-0.71%
4314753,4305,Metropolitana de Porto Alegre,43023,Montenegro,Poço das Antas,RS,,,1558,1946,1976,2017,1023,994,861,1156,0.36%
4314779,4301,Noroeste Rio-grandense,43010,Passo Fundo,Pontão,RS,,,,3904,3904,3857,1983,1874,1559,2298,-0.12%
4314787,4301,Noroeste Rio-grandense,43004,Erechim,Ponte Preta,RS,,,,2153,1840,1750,924,826,512,1238,-2.05%
4314803,4305,Metropolitana de Porto Alegre,43023,Montenegro,Portão,RS,7501,10729,19489,24657,28583,30881,15490,15391,25233,5648,2.28%
4314902,4305,Metropolitana de Porto Alegre,43026,Porto Alegre,Porto Alegre,RS,885545,1125478,1263403,1360590,1420667,1409939,654022,755917,1409939,0,0.36%
4315008,4301,Noroeste Rio-grandense,43001,Santa Rosa,Porto Lucena,RS,13007,12211,9415,6398,5631,5421,2701,2720,2337,3084,-1.64%
4315057,4301,Noroeste Rio-grandense,43001,Santa Rosa,Porto Mauá,RS,,,,2802,2565,2544,1265,1279,956,1588,-0.96%
4315073,4301,Noroeste Rio-grandense,43001,Santa Rosa,Porto Vera Cruz,RS,,,,2464,2084,1852,936,916,440,1412,-2.81%
4315107,4301,Noroeste Rio-grandense,43006,Cerro Largo,Porto Xavier,RS,12406,12193,10934,11190,10857,10560,5301,5259,5210,5350,-0.58%
4315131,4304,Centro Oriental Rio-grandense,43021,Lajeado-Estrela,Pouso Novo,RS,,,2215,2195,1992,1875,953,922,630,1245,-1.56%
4315149,4305,Metropolitana de Porto Alegre,43024,Gramado-Canela,Presidente Lucena,RS,,,,2069,2355,2485,1312,1173,1511,974,1.85%
4315156,4304,Centro Oriental Rio-grandense,43021,Lajeado-Estrela,Progresso,RS,,,6923,6497,6210,6161,3176,2985,1871,4290,-0.53%
4315172,4302,Nordeste Rio-grandense,43014,Guaporé,Protásio Alves,RS,,,2340,2112,2114,2000,1079,921,427,1573,-0.54%
4315206,4302,Nordeste Rio-grandense,43014,Guaporé,Putinga,RS,6841,6146,5243,4629,4192,4147,2100,2047,1583,2564,-1.09%
4315305,4306,Sudoeste Rio-grandense,43029,Campanha Ocidental,Quaraí,RS,19741,19442,22083,24002,22552,23021,11228,11793,21310,1711,-0.42%
4315313,4301,Noroeste Rio-grandense,43004,Erechim,Quatro Irmãos,RS,,,,,1735,1778,891,887,919,859,-
4315321,4303,Centro Ocidental Rio-grandense,43017,Santiago,Quevedos,RS,,,,2691,2732,2710,1447,1263,852,1858,0.07%
4315354,4301,Noroeste Rio-grandense,43011,Cruz Alta,Quinze de Novembro,RS,,,3430,3582,3561,3653,1799,1854,1961,1692,0.20%
4315404,4301,Noroeste Rio-grandense,43002,Três Passos,Redentora,RS,11543,10340,9176,8846,9600,10222,5210,5012,3002,7220,1.46%
4315453,4304,Centro Oriental Rio-grandense,43021,Lajeado-Estrela,Relvado,RS,,,2566,2294,2196,2155,1071,1084,734,1421,-0.62%
4315503,4303,Centro Ocidental Rio-grandense,43019,Restinga Seca,Restinga Seca,RS,15795,14435,15242,16400,15595,15850,7815,8035,8982,6868,-0.34%
4315552,4301,Noroeste Rio-grandense,43003,Frederico Westphalen,Rio dos Índios,RS,,,,4702,4202,3616,1860,1756,755,2861,-2.59%
4315602,4307,Sudeste Rio-grandense,43035,Litoral Lagunar,Rio Grande,RS,116488,146114,172422,186544,194351,197253,94997,102256,189472,7781,0.56%
4315701,4304,Centro Oriental Rio-grandense,43022,Cachoeira do Sul,Rio Pardo,RS,53699,50147,42924,37783,37704,37602,18320,19282,25614,11988,-0.05%
4315750,4305,Metropolitana de Porto Alegre,43024,Gramado-Canela,Riozinho,RS,,,3389,4071,4406,4327,2201,2126,2748,1579,0.61%
4315800,4304,Centro Oriental Rio-grandense,43021,Lajeado-Estrela,Roca Sales,RS,10706,8824,9557,9284,9922,10287,5089,5198,6602,3685,1.03%
4315909,4301,Noroeste Rio-grandense,43003,Frederico Westphalen,Rodeio Bonito,RS,13830,13518,10852,5751,5698,5743,2846,2897,4310,1433,-0.01%
4315958,4301,Noroeste Rio-grandense,43007,Santo Ângelo,Rolador,RS,,,,,2795,2546,1318,1228,608,1938,-
4316006,4305,Metropolitana de Porto Alegre,43024,Gramado-Canela,Rolante,RS,14866,11769,13420,17851,19213,19493,9771,9722,15318,4175,0.88%
4316105,4301,Noroeste Rio-grandense,43010,Passo Fundo,Ronda Alta,RS,16028,16648,11689,10051,9654,10228,5008,5220,6875,3353,0.17%
4316204,4301,Noroeste Rio-grandense,43003,Frederico Westphalen,Rondinha,RS,8308,8505,7126,6107,5674,5520,2722,2798,2317,3203,-1.01%
4316303,4301,Noroeste Rio-grandense,43006,Cerro Largo,Roque Gonzales,RS,10589,9758,8808,7799,7297,7206,3623,3583,3090,4116,-0.79%
4316402,4306,Sudoeste Rio-grandense,43030,Campanha Central,Rosário do Sul,RS,37788,39258,40464,41058,40509,39751,19342,20409,34938,4813,-0.32%
4316428,4301,Noroeste Rio-grandense,43009,Carazinho,Sagrada Família,RS,,,,2648,2595,2595,1339,1256,785,1810,-0.20%
4316436,4301,Noroeste Rio-grandense,43011,Cruz Alta,Saldanha Marinho,RS,,,3330,3195,2982,2869,1390,1479,1927,942,-1.07%
4316451,4301,Noroeste Rio-grandense,43011,Cruz Alta,Salto do Jacuí,RS,,,10876,12948,12154,11880,5878,6002,10208,1672,-0.86%
4316477,4301,Noroeste Rio-grandense,43006,Cerro Largo,Salvador das Missões,RS,,,,2665,2601,2669,1377,1292,1094,1575,0.01%
4316501,4305,Metropolitana de Porto Alegre,43023,Montenegro,Salvador do Sul,RS,15213,14326,8388,6913,6644,6747,3412,3335,4009,2738,-0.24%
4316600,4301,Noroeste Rio-grandense,43005,Sananduva,Sananduva,RS,13299,14159,14448,14744,14714,15373,7604,7769,10697,4676,0.42%
4316709,4301,Noroeste Rio-grandense,43011,Cruz Alta,Santa Bárbara do Sul,RS,9191,12372,9941,10003,9122,8829,4341,4488,6985,1844,-1.24%
4316733,4301,Noroeste Rio-grandense,43010,Passo Fundo,Santa Cecília do Sul,RS,,,,,1716,1655,839,816,480,1175,-
4316758,4304,Centro Oriental Rio-grandense,43021,Lajeado-Estrela,Santa Clara do Sul,RS,,,,4806,5471,5692,2845,2847,2849,2843,1.71%
4316808,4304,Centro Oriental Rio-grandense,43020,Santa Cruz do Sul,Santa Cruz do Sul,RS,86787,99645,117773,107632,115857,118287,56892,61395,105184,13103,0.95%
4316907,4303,Centro Ocidental Rio-grandense,43018,Santa Maria,Santa Maria,RS,156609,181571,217592,243611,263403,261027,123636,137391,248334,12693,0.69%
4316956,4305,Metropolitana de Porto Alegre,43024,Gramado-Canela,Santa Maria do Herval,RS,,,5185,5891,6173,6053,3101,2952,4362,1691,0.27%
4316972,4306,Sudoeste Rio-grandense,43030,Campanha Central,Santa Margarida do Sul,RS,,,,,2163,2352,1273,1079,552,1800,-
4317004,4307,Sudeste Rio-grandense,43032,Serras de Sudeste,Santana da Boa Vista,RS,11643,8911,8408,8621,8599,8244,4171,4073,3725,4519,-0.45%
4317103,4306,Sudoeste Rio-grandense,43030,Campanha Central,Sant'Ana do Livramento,RS,63388,68105,80252,90849,83479,82513,39409,43104,74440,8073,-0.96%
4317202,4301,Noroeste Rio-grandense,43001,Santa Rosa,Santa Rosa,RS,39550,52227,58287,65016,64113,68595,33484,35111,60374,8221,0.54%
4317251,4302,Nordeste Rio-grandense,43016,Caxias do Sul,Santa Tereza,RS,,,,1768,1815,1717,887,830,624,1093,-0.29%
4317301,4307,Sudeste Rio-grandense,43035,Litoral Lagunar,Santa Vitória do Palmar,RS,23458,27172,34462,33304,31183,31002,15464,15538,26890,4112,-0.71%
4317400,4303,Centro Ocidental Rio-grandense,43017,Santiago,Santiago,RS,41054,46624,51755,52138,49558,49082,23578,25504,44746,4336,-0.60%
4317509,4301,Noroeste Rio-grandense,43007,Santo Ângelo,Santo Ângelo,RS,80754,93667,76592,76745,73800,76304,36596,39708,71829,4475,-0.06%
4317558,4301,Noroeste Rio-grandense,43010,Passo Fundo,Santo Antônio do Palma,RS,,,,2207,2216,2139,1112,1027,681,1458,-0.31%
4317608,4305,Metropolitana de Porto Alegre,43027,Osório,Santo Antônio da Patrulha,RS,53626,41363,40607,37035,37910,39679,19752,19927,28105,11574,0.69%
4317707,4301,Noroeste Rio-grandense,43007,Santo Ângelo,Santo Antônio das Missões,RS,11589,12679,13257,12691,11863,11210,5579,5631,6788,4422,-1.23%
4317756,4301,Noroeste Rio-grandense,43009,Carazinho,Santo Antônio do Planalto,RS,,,,2001,2029,1987,979,1008,1233,754,-0.07%
4317806,4301,Noroeste Rio-grandense,43008,Ijuí,Santo Augusto,RS,14812,17462,17832,14426,13622,13970,6812,7158,11382,2588,-0.32%
4317905,4301,Noroeste Rio-grandense,43001,Santa Rosa,Santo Cristo,RS,15076,15314,15147,14890,14280,14378,7189,7189,7781,6597,-0.35%
4317954,4301,Noroeste Rio-grandense,43005,Sananduva,Santo Expedito do Sul,RS,,,,2683,2614,2461,1239,1222,872,1589,-0.86%
4318002,4306,Sudoeste Rio-grandense,43029,Campanha Ocidental,São Borja,RS,52392,58217,63783,64869,61834,61662,30251,31411,55139,6523,-0.51%
4318051,4301,Noroeste Rio-grandense,43010,Passo Fundo,São Domingos do Sul,RS,,,2561,2831,2854,2926,1470,1456,1748,1178,0.33%
4318101,4306,Sudoeste Rio-grandense,43029,Campanha Ocidental,São Francisco de Assis,RS,27422,25734,26667,20810,19523,19258,9494,9764,13499,5759,-0.77%
4318200,4302,Nordeste Rio-grandense,43015,Vacaria,São Francisco de Paula,RS,31805,23137,19251,19725,21278,20540,10402,10138,13007,7533,0.41%
4318309,4306,Sudoeste Rio-grandense,43030,Campanha Central,São Gabriel,RS,51934,56736,59040,62249,57978,60508,29474,31034,53860,6648,-0.28%
4318408,4305,Metropolitana de Porto Alegre,43025,São Jerônimo,São Jerônimo,RS,38279,46867,27684,20283,20506,22141,11029,11112,17062,5079,0.88%
4318424,4301,Noroeste Rio-grandense,43005,Sananduva,São João da Urtiga,RS,,,5212,4929,4946,4726,2401,2325,2291,2435,-0.42%
4318432,4303,Centro Ocidental Rio-grandense,43019,Restinga Seca,São João do Polêsine,RS,,,,2745,2702,2635,1272,1363,1354,1281,-0.41%
4318440,4302,Nordeste Rio-grandense,43014,Guaporé,São Jorge,RS,,,2874,2875,2764,2774,1379,1395,1451,1323,-0.36%
4318457,4301,Noroeste Rio-grandense,43009,Carazinho,São José das Missões,RS,,,,3000,2952,2720,1377,1343,828,1892,-0.98%
4318465,4301,Noroeste Rio-grandense,43013,Soledade,São José do Herval,RS,,,2456,2530,2479,2204,1137,1067,867,1337,-1.37%
4318481,4305,Metropolitana de Porto Alegre,43023,Montenegro,São José do Hortêncio,RS,,,2800,3387,3883,4094,2088,2006,2645,1449,1.91%
4318499,4301,Noroeste Rio-grandense,43001,Santa Rosa,São José do Inhacorá,RS,,,,2402,2132,2200,1125,1075,832,1368,-0.87%
4318507,4307,Sudeste Rio-grandense,43035,Litoral Lagunar,São José do Norte,RS,18824,21751,22071,23796,24905,25523,13011,12512,17403,8120,0.70%
4318606,4301,Noroeste Rio-grandense,43005,Sananduva,São José do Ouro,RS,14304,12257,11464,7051,6973,6906,3382,3524,4425,2481,-0.21%
4318614,4305,Metropolitana de Porto Alegre,43023,Montenegro,São José do Sul,RS,,,,,1899,2082,1052,1030,720,1362,-
4318622,4302,Nordeste Rio-grandense,43015,Vacaria,São José dos Ausentes,RS,,,,3104,3180,3290,1693,1597,2062,1228,0.58%
4318705,4305,Metropolitana de Porto Alegre,43026,Porto Alegre,São Leopoldo,RS,64433,98588,167907,193547,207721,214210,104319,109891,213361,849,1.02%
4318804,4307,Sudeste Rio-grandense,43033,Pelotas,São Lourenço do Sul,RS,39886,41597,41420,43691,42339,43114,21619,21495,24234,18880,-0.13%
4318903,4301,Noroeste Rio-grandense,43007,Santo Ângelo,São Luiz Gonzaga,RS,41061,47533,41671,39553,34487,34558,16828,17730,30511,4047,-1.34%
4319000,4302,Nordeste Rio-grandense,43016,Caxias do Sul,São Marcos,RS,9169,11813,15857,18958,19641,20105,9856,10249,17601,2504,0.59%
4319109,4301,Noroeste Rio-grandense,43002,Três Passos,São Martinho,RS,8763,8037,7352,6321,5853,5773,2838,2935,3441,2332,-0.90%
4319125,4303,Centro Ocidental Rio-grandense,43018,Santa Maria,São Martinho da Serra,RS,,,,3246,3409,3201,1647,1554,942,2259,-0.14%
4319158,4301,Noroeste Rio-grandense,43007,Santo Ângelo,São Miguel das Missões,RS,,,7413,7682,7382,7421,3880,3541,3727,3694,-0.35%
4319208,4301,Noroeste Rio-grandense,43007,Santo Ângelo,São Nicolau,RS,10961,11980,6874,6406,5909,5727,2906,2821,3692,2035,-1.11%
4319307,4301,Noroeste Rio-grandense,43006,Cerro Largo,São Paulo das Missões,RS,9354,9565,8523,7187,6690,6367,3230,3137,2199,4168,-1.20%
4319356,4305,Metropolitana de Porto Alegre,43023,Montenegro,São Pedro da Serra,RS,,,,2843,3117,3317,1684,1633,1431,1886,1.55%
4319364,4301,Noroeste Rio-grandense,43009,Carazinho,São Pedro das Missões,RS,,,,,1939,1886,932,954,532,1354,-
4319372,4301,Noroeste Rio-grandense,43006,Cerro Largo,São Pedro do Butiá,RS,,,,2862,2744,2873,1456,1417,1209,1664,0.04%
4319406,4303,Centro Ocidental Rio-grandense,43018,Santa Maria,São Pedro do Sul,RS,21815,20992,20381,16989,16613,16371,8052,8319,11932,4439,-0.37%
4319505,4305,Metropolitana de Porto Alegre,43023,Montenegro,São Sebastião do Caí,RS,25252,27180,16833,19700,20359,21944,10744,11200,17611,4333,1.08%
4319604,4303,Centro Ocidental Rio-grandense,43018,Santa Maria,São Sepé,RS,26674,26866,28075,24621,23787,23798,11776,12022,18821,4977,-0.34%
4319703,4301,Noroeste Rio-grandense,43004,Erechim,São Valentim,RS,20216,15795,7709,4109,3919,3632,1811,1821,1744,1888,-1.23%
4319711,4302,Nordeste Rio-grandense,43014,Guaporé,São Valentim do Sul,RS,,,,2140,2230,2168,1112,1056,746,1422,0.13%
4319737,4301,Noroeste Rio-grandense,43008,Ijuí,São Valério do Sul,RS,,,,2625,2635,2647,1375,1272,510,2137,0.08%
4319752,4305,Metropolitana de Porto Alegre,43023,Montenegro,São Vendelino,RS,,,1458,1682,1794,1944,994,950,1353,591,1.46%
4319802,4303,Centro Ocidental Rio-grandense,43018,Santa Maria,São Vicente do Sul,RS,7976,7349,7576,8336,8361,8440,4205,4235,5881,2559,0.12%
4319901,4305,Metropolitana de Porto Alegre,43026,Porto Alegre,Sapiranga,RS,16402,37288,58675,69189,73979,75020,37012,38008,72323,2697,0.81%
4320008,4305,Metropolitana de Porto Alegre,43026,Porto Alegre,Sapucaia do Sul,RS,41742,79361,104885,122751,122231,130988,63756,67232,130500,488,0.65%
4320107,4301,Noroeste Rio-grandense,43009,Carazinho,Sarandi,RS,17957,20546,22351,18162,20415,21312,10272,11040,17957,3355,1.61%
4320206,4301,Noroeste Rio-grandense,43003,Frederico Westphalen,Seberi,RS,14326,15502,13532,11349,10870,10902,5352,5550,5923,4979,-0.40%
4320230,4301,Noroeste Rio-grandense,43002,Três Passos,Sede Nova,RS,,,3734,3208,2968,3011,1531,1480,1581,1430,-0.63%
4320263,4304,Centro Oriental Rio-grandense,43020,Santa Cruz do Sul,Segredo,RS,,,6950,6911,7022,7158,3696,3462,1807,5351,0.35%
4320305,4301,Noroeste Rio-grandense,43012,Não-Me-Toque,Selbach,RS,4509,4471,4579,4861,4773,4929,2403,2526,3450,1479,0.14%
4320321,4301,Noroeste Rio-grandense,43007,Santo Ângelo,Senador Salgado Filho,RS,,,,2927,2861,2814,1407,1407,880,1934,-0.39%
4320354,4305,Metropolitana de Porto Alegre,43028,Camaquã,Sentinela do Sul,RS,,,,4892,5290,5197,2666,2531,1279,3918,0.61%
4320404,4302,Nordeste Rio-grandense,43014,Guaporé,Serafina Corrêa,RS,8065,9320,8458,10894,13463,14243,7098,7145,12054,2189,2.72%
4320453,4304,Centro Oriental Rio-grandense,43021,Lajeado-Estrela,Sério,RS,,,,2706,2399,2281,1190,1091,530,1751,-1.69%
4320503,4301,Noroeste Rio-grandense,43010,Passo Fundo,Sertão,RS,10041,9032,8938,7466,6663,6294,3045,3249,3387,2907,-1.69%
4320552,4305,Metropolitana de Porto Alegre,43026,Porto Alegre,Sertão Santana,RS,,,,5272,5791,5850,2934,2916,1278,4572,1.05%
4320578,4301,Noroeste Rio-grandense,43006,Cerro Largo,Sete de Setembro,RS,,,,2357,2131,2126,1081,1045,494,1632,-1.03%
4320602,4301,Noroeste Rio-grandense,43004,Erechim,Severiano de Almeida,RS,5255,4430,4430,4153,3907,3842,1942,1900,1399,2443,-0.78%
4320651,4303,Centro Ocidental Rio-grandense,43019,Restinga Seca,Silveira Martins,RS,,,2380,2571,2479,2452,1229,1223,1091,1361,-0.47%
4320677,4304,Centro Oriental Rio-grandense,43020,Santa Cruz do Sul,Sinimbu,RS,,,,10210,10315,10067,5216,4851,1437,8630,-0.14%
4320701,4304,Centro Oriental Rio-grandense,43020,Santa Cruz do Sul,Sobradinho,RS,28250,29042,20140,16328,14162,14285,6992,7293,11349,2936,-1.33%
4320800,4301,Noroeste Rio-grandense,43013,Soledade,Soledade,RS,46443,47576,30582,29727,29926,30065,14723,15342,24040,6025,0.11%
4320859,4304,Centro Oriental Rio-grandense,43021,Lajeado-Estrela,Tabaí,RS,,,,3563,4046,4131,2102,2029,1246,2885,1.49%
4320909,4301,Noroeste Rio-grandense,43010,Passo Fundo,Tapejara,RS,22566,21138,18887,15115,17500,19252,9396,9856,17082,2170,2.45%
4321006,4301,Noroeste Rio-grandense,43012,Não-Me-Toque,Tapera,RS,8618,10361,10937,10564,10457,10452,5095,5357,8824,1628,-0.11%
4321105,4305,Metropolitana de Porto Alegre,43028,Camaquã,Tapes,RS,25334,23729,19762,16291,16557,16649,8181,8468,14494,2155,0.22%
4321204,4305,Metropolitana de Porto Alegre,43024,Gramado-Canela,Taquara,RS,31167,41376,42467,52825,53428,54656,26875,27781,45276,9380,0.34%
4321303,4304,Centro Oriental Rio-grandense,43021,Lajeado-Estrela,Taquari,RS,26786,28922,25024,25887,25768,26135,12705,13430,21920,4215,0.10%
4321329,4301,Noroeste Rio-grandense,43003,Frederico Westphalen,Taquaruçu do Sul,RS,,,3060,2921,2849,2970,1519,1451,1164,1806,0.17%
4321352,4305,Metropolitana de Porto Alegre,43027,Osório,Tavares,RS,,,5075,5342,5160,5351,2777,2574,3299,2052,0.02%
4321402,4301,Noroeste Rio-grandense,43002,Três Passos,Tenente Portela,RS,34227,30643,23674,14343,13906,13716,6711,7005,8847,4869,-0.45%
4321436,4305,Metropolitana de Porto Alegre,43027,Osório,Terra de Areia,RS,,,10407,11453,9709,9878,4960,4918,5195,4683,-1.47%
4321451,4304,Centro Oriental Rio-grandense,43021,Lajeado-Estrela,Teutônia,RS,,,17578,22891,25105,27265,13516,13749,23317,3948,1.76%
4321469,4301,Noroeste Rio-grandense,43012,Não-Me-Toque,Tio Hugo,RS,,,,,2593,2724,1372,1352,1164,1560,-
4321477,4301,Noroeste Rio-grandense,43002,Três Passos,Tiradentes do Sul,RS,,,,7497,6928,6461,3268,3193,2098,4363,-1.48%
4321493,4303,Centro Ocidental Rio-grandense,43018,Santa Maria,Toropi,RS,,,,3196,3070,2952,1561,1391,611,2341,-0.79%
4321501,4305,Metropolitana de Porto Alegre,43027,Osório,Torres,RS,41129,41619,37474,30880,32358,34646,16841,17805,33329,1317,1.16%
4321600,4305,Metropolitana de Porto Alegre,43027,Osório,Tramandaí,RS,12353,19217,20130,31040,39891,41655,20169,21486,40652,1003,2.99%
4321626,4304,Centro Oriental Rio-grandense,43021,Lajeado-Estrela,Travesseiro,RS,,,,2349,2379,2314,1171,1143,887,1427,-0.15%
4321634,4301,Noroeste Rio-grandense,43004,Erechim,Três Arroios,RS,,,3288,3144,3015,2855,1428,1427,1027,1828,-0.96%
4321667,4305,Metropolitana de Porto Alegre,43027,Osório,Três Cachoeiras,RS,,,7999,9523,10390,10239,5172,5067,7523,2716,0.73%
4321709,4305,Metropolitana de Porto Alegre,43024,Gramado-Canela,Três Coroas,RS,6370,10470,15087,19430,22905,23855,11843,12012,20553,3302,2.07%
4321808,4301,Noroeste Rio-grandense,43001,Santa Rosa,Três de Maio,RS,31363,33051,26535,24136,23333,23726,11484,12242,18962,4764,-0.17%
4321832,4305,Metropolitana de Porto Alegre,43027,Osório,Três Forquilhas,RS,,,,3239,3073,2912,1510,1402,385,2527,-1.06%
4321857,4301,Noroeste Rio-grandense,43003,Frederico Westphalen,Três Palmeiras,RS,,,5030,4620,4388,4381,2210,2171,2090,2291,-0.53%
4321907,4301,Noroeste Rio-grandense,43002,Três Passos,Três Passos,RS,43228,45623,40761,24656,23467,23973,11753,12220,19060,4913,-0.28%
4321956,4301,Noroeste Rio-grandense,43003,Frederico Westphalen,Trindade do Sul,RS,,,6927,5922,5905,5787,2884,2903,2899,2888,-0.23%
4322004,4305,Metropolitana de Porto Alegre,43025,São Jerônimo,Triunfo,RS,14608,13854,17923,22166,23976,25811,12953,12858,16882,8929,1.53%
4322103,4301,Noroeste Rio-grandense,43001,Santa Rosa,Tucunduva,RS,15289,13864,12538,6305,5907,5901,2818,3083,4038,1863,-0.66%
4322152,4301,Noroeste Rio-grandense,43013,Soledade,Tunas,RS,,,4388,4310,4378,4395,2278,2117,1375,3020,0.20%
4322186,4301,Noroeste Rio-grandense,43005,Sananduva,Tupanci do Sul,RS,,,,1728,1723,1574,815,759,473,1101,-0.93%
4322202,4303,Centro Ocidental Rio-grandense,43017,Santiago,Tupanciretã,RS,24835,26644,23240,20947,22556,22286,10867,11419,18025,4261,0.62%
4322251,4305,Metropolitana de Porto Alegre,43023,Montenegro,Tupandi,RS,,,2325,2958,3604,3919,2063,1856,2716,1203,2.85%
4322301,4301,Noroeste Rio-grandense,43001,Santa Rosa,Tuparendi,RS,14639,13905,12481,9542,8793,8557,4146,4411,5294,3263,-1.08%
4322327,4307,Sudeste Rio-grandense,43033,Pelotas,Turuçu,RS,,,,3710,3829,3522,1778,1744,1487,2035,-0.52%
4322343,4301,Noroeste Rio-grandense,43007,Santo Ângelo,Ubiretama,RS,,,,2677,2440,2296,1183,1113,500,1796,-1.52%
4322350,4302,Nordeste Rio-grandense,43014,Guaporé,União da Serra,RS,,,,1908,1666,1487,797,690,280,1207,-2.46%
4322376,4303,Centro Ocidental Rio-grandense,43017,Santiago,Unistalda,RS,,,,2644,2392,2453,1247,1206,913,1540,-0.75%
4322400,4306,Sudoeste Rio-grandense,43029,Campanha Ocidental,Uruguaiana,RS,74613,91498,117456,126936,123743,125507,61057,64450,117461,8046,-0.11%
4322509,4302,Nordeste Rio-grandense,43015,Vacaria,Vacaria,RS,57107,58562,58610,57341,59938,61345,30089,31256,57337,4008,0.68%
4322525,4305,Metropolitana de Porto Alegre,43025,São Jerônimo,Vale Verde,RS,,,,3057,3227,3253,1652,1601,882,2371,0.62%
4322533,4304,Centro Oriental Rio-grandense,43020,Santa Cruz do Sul,Vale do Sol,RS,,,,10558,10817,11077,5597,5480,1249,9828,0.48%
4322541,4305,Metropolitana de Porto Alegre,43023,Montenegro,Vale Real,RS,,,,4340,4741,5121,2576,2545,4569,552,1.67%
4322558,4301,Noroeste Rio-grandense,43010,Passo Fundo,Vanini,RS,,,1826,1887,1956,1984,993,991,1001,983,0.50%
4322608,4304,Centro Oriental Rio-grandense,43020,Santa Cruz do Sul,Venâncio Aires,RS,43734,48274,55482,61234,64442,65964,32648,33316,41416,24548,0.75%
4322707,4304,Centro Oriental Rio-grandense,43020,Santa Cruz do Sul,Vera Cruz,RS,11527,13932,17912,21300,22702,23986,11751,12235,13320,10666,1.19%
4322806,4302,Nordeste Rio-grandense,43016,Caxias do Sul,Veranópolis,RS,23399,23239,16916,19466,23904,22815,11101,11714,19847,2968,1.60%
4322855,4304,Centro Oriental Rio-grandense,43021,Lajeado-Estrela,Vespasiano Correa,RS,,,,2209,1973,1974,1024,950,406,1568,-1.12%
4322905,4301,Noroeste Rio-grandense,43004,Erechim,Viadutos,RS,9609,8754,8889,6087,5663,5311,2620,2691,2643,2668,-1.35%
4323002,4305,Metropolitana de Porto Alegre,43026,Porto Alegre,Viamão,RS,66443,117670,169176,227429,253264,239234,116344,122890,224962,14272,0.51%
4323101,4301,Noroeste Rio-grandense,43003,Frederico Westphalen,Vicente Dutra,RS,9812,8584,6624,6128,5569,5285,2701,2584,2351,2934,-1.47%
4323200,4301,Noroeste Rio-grandense,43012,Não-Me-Toque,Victor Graeff,RS,4955,4125,3872,3924,3080,3036,1512,1524,1284,1752,-2.53%
4323309,4302,Nordeste Rio-grandense,43016,Caxias do Sul,Vila Flores,RS,,,2650,3086,3169,3207,1617,1590,1348,1859,0.39%
4323358,4301,Noroeste Rio-grandense,43010,Passo Fundo,Vila Lângaro,RS,,,,2277,2230,2152,1123,1029,366,1786,-0.56%
4323408,4301,Noroeste Rio-grandense,43010,Passo Fundo,Vila Maria,RS,,,4059,4173,4159,4221,2116,2105,2249,1972,0.11%
4323457,4303,Centro Ocidental Rio-grandense,43018,Santa Maria,Vila Nova do Sul,RS,,,,4263,4255,4221,2102,2119,2194,2027,-0.10%
4323507,4301,Noroeste Rio-grandense,43003,Frederico Westphalen,Vista Alegre,RS,,,3148,2996,2871,2832,1400,1432,1185,1647,-0.56%
4323606,4302,Nordeste Rio-grandense,43014,Guaporé,Vista Alegre do Prata,RS,,,1783,1618,1492,1569,819,750,463,1106,-0.31%
4323705,4301,Noroeste Rio-grandense,43002,Três Passos,Vista Gaúcha,RS,,,2749,2725,2713,2759,1395,1364,965,1794,0.12%
4323754,4301,Noroeste Rio-grandense,43007,Santo Ângelo,Vitória das Missões,RS,,,,3979,3652,3485,1794,1691,669,2816,-1.32%
4323770,4304,Centro Oriental Rio-grandense,43021,Lajeado-Estrela,Westfalia,RS,,,,,2716,2793,1406,1387,1130,1663,-
4323804,4305,Metropolitana de Porto Alegre,43027,Osório,Xangri-lá,RS,,,,8197,10602,12405,6190,6215,12350,55,4.23%
4200051,4203,Serrana,42009,Curitibanos,Abdon Batista,SC,,,3245,2775,2726,2653,1382,1271,724,1929,-0.45%
4200101,4201,Oeste Catarinense,42003,Xanxerê,Abelardo Luz,SC,18253,17582,19236,16440,16374,17100,8628,8472,9570,7530,0.39%
4200200,4204,Vale do Itajaí,42014,Ituporanga,Agrolândia,SC,5766,6139,7181,7810,9080,9328,4703,4625,5964,3364,1.79%
4200309,4204,Vale do Itajaí,42011,Rio do Sul,Agronômica,SC,4775,4549,3772,4257,4677,4901,2496,2405,1855,3046,1.42%
4200408,4201,Oeste Catarinense,42004,Joaçaba,Água Doce,SC,8563,8001,7133,6843,6756,6960,3551,3409,3436,3524,0.17%
4200507,4201,Oeste Catarinense,42002,Chapecó,Águas de Chapecó,SC,6803,6603,6443,5782,6086,6109,3124,2985,3236,2873,0.55%
4200556,4201,Oeste Catarinense,42002,Chapecó,Águas Frias,SC,,,,2525,2551,2424,1279,1145,981,1443,-0.41%
4200606,4205,Grande Florianópolis,42017,Tabuleiro,Águas Mornas,SC,4675,4626,4611,5390,4410,5546,2808,2738,2327,3219,0.29%
4200705,4205,Grande Florianópolis,42017,Tabuleiro,Alfredo Wagner,SC,9756,9492,9795,8857,9754,9410,4784,4626,2868,6542,0.61%
4200754,4201,Oeste Catarinense,42005,Concórdia,Alto Bela Vista,SC,,,,2098,2021,2005,1005,1000,605,1400,-0.45%
4200804,4201,Oeste Catarinense,42001,São Miguel do Oeste,Anchieta,SC,5604,10111,9599,7133,6587,6378,3231,3147,2588,3790,-1.11%
4200903,4205,Grande Florianópolis,42015,Tijucas,Angelina,SC,7555,6669,6268,5776,5322,5250,2765,2485,1123,4127,-0.95%
4201000,4203,Serrana,42010,Campos de Lages,Anita Garibaldi,SC,18486,15803,11021,10273,9141,8627,4342,4285,4555,4072,-1.73%
4201109,4205,Grande Florianópolis,42017,Tabuleiro,Anitápolis,SC,4623,4598,3564,3234,3175,3214,1675,1539,1315,1899,-0.06%
4201208,4205,Grande Florianópolis,42016,Florianópolis,Antônio Carlos,SC,5624,5412,5613,6434,7087,7455,3754,3701,2338,5117,1.48%
4201257,4204,Vale do Itajaí,42012,Blumenau,Apiúna,SC,,,7731,8520,10270,9605,4880,4725,4295,5310,1.21%
4201273,4201,Oeste Catarinense,42005,Concórdia,Arabutã,SC,,,,4160,3962,4193,2133,2060,1307,2886,0.08%
4201307,4202,Norte Catarinense,42008,Joinville,Araquari,SC,9374,9674,15998,23645,21278,24814,12640,12174,23359,1455,0.48%
4201406,4206,Sul Catarinense,42020,Araranguá,Araranguá,SC,26211,33679,48415,54706,57119,61339,30154,31185,50551,10788,1.15%
4201505,4206,Sul Catarinense,42018,Tubarão,Armazém,SC,7117,5989,6096,6873,7312,7730,3912,3818,4871,2859,1.18%
4201604,4201,Oeste Catarinense,42004,Joaçaba,Arroio Trinta,SC,2642,2945,3335,3490,3516,3500,1746,1754,2397,1103,0.03%
4201653,4201,Oeste Catarinense,42005,Concórdia,Arvoredo,SC,,,,2305,2193,2256,1226,1030,497,1759,-0.21%
4201703,4204,Vale do Itajaí,42012,Blumenau,Ascurra,SC,3970,5420,6162,6934,6761,7419,3682,3737,6460,959,0.68%
4201802,4204,Vale do Itajaí,42014,Ituporanga,Atalanta,SC,3474,3487,3702,3429,3317,3300,1661,1639,1368,1932,-0.38%
4201901,4204,Vale do Itajaí,42011,Rio do Sul,Aurora,SC,5610,5275,6066,5474,5399,5552,2825,2727,1931,3621,0.14%
4201950,4206,Sul Catarinense,42020,Araranguá,Balneário Arroio do Silva,SC,,,,6043,8089,9590,4745,4845,9395,195,4.73%
4202008,4204,Vale do Itajaí,42013,Itajaí,Balneário Camboriú,SC,10839,21854,40308,73455,94344,108107,51393,56714,108107,0,3.94%
4202057,4202,Norte Catarinense,42008,Joinville,Balneário Barra do Sul,SC,,,,6045,7278,8423,4170,4253,8029,394,3.37%
4202073,4206,Sul Catarinense,42020,Araranguá,Balneário Gaivota,SC,,,,5450,7307,8244,4091,4153,6371,1873,4.23%
4202081,4201,Oeste Catarinense,42001,São Miguel do Oeste,Bandeirante,SC,,,,3177,3028,2906,1534,1372,932,1974,-0.89%
4202099,4201,Oeste Catarinense,42001,São Miguel do Oeste,Barra Bonita,SC,,,,2118,2064,1878,976,902,279,1599,-1.20%
4202107,4204,Vale do Itajaí,42013,Itajaí,Barra Velha,SC,11118,11721,13231,15530,18575,22403,11122,11281,21337,1066,3.73%
4202131,4202,Norte Catarinense,42006,Canoinhas,Bela Vista do Toldo,SC,,,,5721,5909,6004,3104,2900,847,5157,0.48%
4202156,4201,Oeste Catarinense,42001,São Miguel do Oeste,Belmonte,SC,,,,2588,2681,2635,1358,1277,1273,1362,0.18%
4202206,4204,Vale do Itajaí,42012,Blumenau,Benedito Novo,SC,11637,10714,8385,9071,9841,10331,5279,5052,5803,4528,1.31%
4202305,4205,Grande Florianópolis,42016,Florianópolis,Biguaçu,SC,15337,21441,34063,48077,53444,58238,28691,29547,52806,5432,1.94%
4202404,4204,Vale do Itajaí,42012,Blumenau,Blumenau,SC,100275,157251,212025,261808,292972,309214,151648,157566,294968,14246,1.68%
4202438,4203,Serrana,42010,Campos de Lages,Bocaina do Sul,SC,,,,2980,3047,3290,1700,1590,967,2323,0.99%
4202453,4204,Vale do Itajaí,42013,Itajaí,Bombinhas,SC,,,,8716,12456,14312,7207,7105,14312,0,5.08%
4202503,4203,Serrana,42010,Campos de Lages,Bom Jardim da Serra,SC,6500,6413,4153,4079,4214,4400,2254,2146,2397,2003,0.76%
4202537,4201,Oeste Catarinense,42003,Xanxerê,Bom Jesus,SC,,,,2046,2296,2526,1253,1273,1495,1031,2.13%
4202578,4201,Oeste Catarinense,42002,Chapecó,Bom Jesus do Oeste,SC,,,,2150,2026,2132,1078,1054,647,1485,-0.08%
4202602,4203,Serrana,42010,Campos de Lages,Bom Retiro,SC,7782,7946,7253,7967,8258,8942,4513,4429,6417,2525,1.16%
4202701,4204,Vale do Itajaí,42012,Blumenau,Botuverá,SC,3762,3587,4287,3756,4127,4468,2278,2190,1310,3158,1.75%
4202800,4206,Sul Catarinense,42018,Tubarão,Braço do Norte,SC,10540,11967,16540,24802,27730,29018,14535,14483,23383,5635,1.58%
4202859,4204,Vale do Itajaí,42011,Rio do Sul,Braço do Trombudo,SC,,,,3187,3288,3457,1765,1692,1898,1559,0.82%
4202875,4203,Serrana,42009,Curitibanos,Brunópolis,SC,,,,3331,2934,2852,1451,1401,707,2145,-1.54%
4202909,4204,Vale do Itajaí,42012,Blumenau,Brusque,SC,35200,41228,57971,76058,94962,105495,52400,53095,102017,3478,3.33%
4203006,4201,Oeste Catarinense,42004,Joaçaba,Caçador,SC,32892,39278,52684,63322,67556,70735,35026,35709,64431,6304,1.11%
4203105,4201,Oeste Catarinense,42002,Chapecó,Caibi,SC,5414,7288,7428,6354,6217,6218,3143,3075,3578,2640,-0.22%
4203154,4201,Oeste Catarinense,42004,Joaçaba,Calmon,SC,,,,3467,4012,3380,1752,1628,2109,1271,-0.25%
4203204,4204,Vale do Itajaí,42013,Itajaí,Camboriú,SC,9862,14038,25806,41445,53388,62289,31111,31178,59157,3132,4.16%
4203253,4203,Serrana,42010,Campos de Lages,Capão Alto,SC,,,,3020,3210,2753,1431,1322,962,1791,-0.92%
4203303,4202,Norte Catarinense,42007,São Bento do Sul,Campo Alegre,SC,7133,8311,10074,11634,11391,11748,5971,5777,7237,4511,0.10%
4203402,4203,Serrana,42010,Campos de Lages,Campo Belo do Sul,SC,13810,13569,12811,8051,7968,7486,3850,3636,4410,3076,-0.72%
4203501,4201,Oeste Catarinense,42002,Chapecó,Campo Erê,SC,16959,25335,26272,10353,9590,9370,4686,4684,6252,3118,-0.99%
4203600,4203,Serrana,42009,Curitibanos,Campos Novos,SC,43135,43159,42811,28729,28447,32829,16257,16572,27065,5764,1.34%
4203709,4205,Grande Florianópolis,42015,Tijucas,Canelinha,SC,7434,7156,8165,9004,9696,10603,5372,5231,6726,3877,1.65%
4203808,4202,Norte Catarinense,42006,Canoinhas,Canoinhas,SC,35458,47272,55376,51631,52677,52775,26052,26723,39283,13492,0.22%
4203907,4201,Oeste Catarinense,42004,Joaçaba,Capinzal,SC,7791,10395,13694,19955,18465,20771,10236,10535,17756,3015,0.40%
4203956,4206,Sul Catarinense,42018,Tubarão,Capivari de Baixo,SC,,,,18561,20064,21689,10503,11186,19828,1861,1.57%
4204004,4201,Oeste Catarinense,42004,Joaçaba,Catanduvas,SC,7975,10490,12180,8291,8733,9558,4770,4788,8094,1464,1.43%
4204103,4201,Oeste Catarinense,42002,Chapecó,Caxambu do Sul,SC,8584,9009,8532,5263,4885,4406,2218,2188,2150,2256,-1.76%
4204152,4203,Serrana,42010,Campos de Lages,Celso Ramos,SC,,,3457,2844,2671,2773,1396,1377,872,1901,-0.25%
4204178,4203,Serrana,42010,Campos de Lages,Cerro Negro,SC,,,,4098,3948,3585,1875,1710,764,2821,-1.33%
4204194,4204,Vale do Itajaí,42014,Ituporanga,Chapadão do Lageado,SC,,,,2561,2749,2764,1426,1338,515,2249,0.77%
4204202,4201,Oeste Catarinense,42002,Chapecó,Chapecó,SC,49865,83772,123050,146967,164803,183561,90638,92923,168159,15402,2.25%
4204251,4206,Sul Catarinense,42019,Criciúma,Cocal do Sul,SC,,,,13726,14563,15171,7530,7641,12706,2465,1.01%
4204301,4201,Oeste Catarinense,42005,Concórdia,Concórdia,SC,45465,59426,64338,63058,67249,68627,33776,34851,54872,13755,0.85%
4204350,4201,Oeste Catarinense,42002,Chapecó,Cordilheira Alta,SC,,,,3093,3361,3787,1938,1849,1468,2319,2.04%
4204400,4201,Oeste Catarinense,42002,Chapecó,Coronel Freitas,SC,16185,19168,11886,10535,10246,10213,5189,5024,6067,4146,-0.31%
4204459,4201,Oeste Catarinense,42003,Xanxerê,Coronel Martins,SC,,,,2388,2481,2458,1260,1198,685,1773,0.29%
4204509,4202,Norte Catarinense,42008,Joinville,Corupá,SC,8312,8783,10389,11847,12758,13852,7002,6850,10669,3183,1.58%
4204558,4203,Serrana,42010,Campos de Lages,Correia Pinto,SC,,,17092,17026,14838,14794,7381,7413,12021,2773,-1.40%
4204608,4206,Sul Catarinense,42019,Criciúma,Criciúma,SC,81452,110597,146320,170420,185506,192236,94554,97682,189558,2678,1.21%
4204707,4201,Oeste Catarinense,42002,Chapecó,Cunha Porã,SC,13083,16055,10776,10229,10638,10613,5259,5354,6519,4094,0.37%
4204756,4201,Oeste Catarinense,42002,Chapecó,Cunhataí,SC,,,,1822,1874,1882,1004,878,569,1313,0.32%
4204806,4203,Serrana,42009,Curitibanos,Curitibanos,SC,30977,37712,42234,36061,37493,37774,18536,19238,34796,2978,0.47%
4204905,4201,Oeste Catarinense,42001,São Miguel do Oeste,Descanso,SC,13369,17261,17028,9129,8705,8638,4357,4281,4297,4341,-0.55%
4205001,4201,Oeste Catarinense,42001,São Miguel do Oeste,Dionísio Cerqueira,SC,12802,16036,13720,14250,14792,14801,7407,7394,10182,4619,0.38%
4205100,4204,Vale do Itajaí,42011,Rio do Sul,Dona Emma,SC,3882,3482,3616,3309,3441,3723,1912,1811,1868,1855,1.19%
4205159,4204,Vale do Itajaí,42012,Blumenau,Doutor Pedrinho,SC,,,2997,3082,3280,3604,1794,1810,2019,1585,1.58%
4205175,4201,Oeste Catarinense,42003,Xanxerê,Entre Rios,SC,,,,2857,2979,3018,1557,1461,928,2090,0.55%
4205191,4206,Sul Catarinense,42020,Araranguá,Ermo,SC,,,,2057,1843,2050,1066,984,619,1431,-0.03%
4205209,4201,Oeste Catarinense,42004,Joaçaba,Erval Velho,SC,5774,4955,4626,4269,4098,4353,2151,2202,2842,1511,0.20%
4205308,4201,Oeste Catarinense,42003,Xanxerê,Faxinal dos Guedes,SC,6594,8476,9266,10767,10339,10658,5355,5303,7715,2943,-0.10%
4205357,4201,Oeste Catarinense,42002,Chapecó,Flor do Sertão,SC,,,,1612,1640,1588,827,761,328,1260,-0.15%
4205407,4205,Grande Florianópolis,42016,Florianópolis,Florianópolis,SC,138337,187880,255390,342315,396723,421203,203093,218110,405243,15960,2.10%
4205431,4201,Oeste Catarinense,42002,Chapecó,Formosa do Sul,SC,,,,2725,2620,2601,1327,1274,1084,1517,-0.46%
4205456,4206,Sul Catarinense,42019,Criciúma,Forquilhinha,SC,,,14059,18348,20719,22548,11309,11239,18426,4122,2.08%
4205506,4201,Oeste Catarinense,42004,Joaçaba,Fraiburgo,SC,10148,15031,26649,32948,34889,34555,17161,17394,30294,4261,0.48%
4205555,4203,Serrana,42009,Curitibanos,Frei Rogério,SC,,,,2971,2655,2480,1290,1190,706,1774,-1.79%
4205605,4201,Oeste Catarinense,42003,Xanxerê,Galvão,SC,6609,7991,7069,4235,3493,3475,1721,1754,2350,1125,-1.96%
4205704,4206,Sul Catarinense,42018,Tubarão,Garopaba,SC,7458,8238,9918,13164,16399,18144,9133,9011,15326,2818,3.26%
4205803,4202,Norte Catarinense,42008,Joinville,Garuva,SC,6504,7986,8771,11378,13393,14762,7539,7223,11462,3300,2.64%
4205902,4204,Vale do Itajaí,42012,Blumenau,Gaspar,SC,18417,25609,35614,46414,52428,57958,28675,29283,47107,10851,2.25%
4206009,4205,Grande Florianópolis,42016,Florianópolis,Governador Celso Ramos,SC,7521,7814,9629,11598,12175,13012,6634,6378,12264,748,1.16%
4206108,4206,Sul Catarinense,42018,Tubarão,Grão Pará,SC,7025,6097,5387,5817,6051,6223,3235,2988,3019,3204,0.68%
4206207,4206,Sul Catarinense,42018,Tubarão,Gravatal,SC,8438,8084,8272,10799,10510,10636,5283,5353,4444,6192,-0.15%
4206306,4204,Vale do Itajaí,42012,Blumenau,Guabiruba,SC,6279,7150,9905,12976,16095,18433,9352,9081,17069,1364,3.57%
4206405,4201,Oeste Catarinense,42001,São Miguel do Oeste,Guaraciaba,SC,10046,11893,12434,11038,10604,10498,5298,5200,4919,5579,-0.50%
4206504,4202,Norte Catarinense,42008,Joinville,Guaramirim,SC,10102,10867,17640,23794,29932,35186,17849,17337,28055,7131,3.99%
4206603,4201,Oeste Catarinense,42001,São Miguel do Oeste,Guarujá do Sul,SC,3837,4838,4776,4696,4711,4908,2402,2506,2655,2253,0.44%
4206652,4201,Oeste Catarinense,42002,Chapecó,Guatambú,SC,,,,4702,4505,4675,2467,2208,1749,2926,-0.06%
4206702,4201,Oeste Catarinense,42004,Joaçaba,Herval d'Oeste,SC,13125,15465,17832,20044,18942,21233,10494,10739,18845,2388,0.58%
4206751,4201,Oeste Catarinense,42004,Joaçaba,Ibiam,SC,,,,1955,1987,1945,981,964,695,1250,-0.05%
4206801,4201,Oeste Catarinense,42004,Joaçaba,Ibicaré,SC,4642,4212,3936,3587,3390,3373,1775,1598,1557,1816,-0.61%
4206900,4204,Vale do Itajaí,42011,Rio do Sul,Ibirama,SC,21008,23529,13773,15802,16716,17342,8672,8670,14825,2517,0.93%
4207007,4206,Sul Catarinense,42019,Criciúma,Içara,SC,17098,24493,38095,48634,54107,58859,29316,29543,53939,4920,1.93%
4207106,4204,Vale do Itajaí,42013,Itajaí,Ilhota,SC,8535,8053,9448,10574,11552,12356,6225,6131,7899,4457,1.57%
4207205,4206,Sul Catarinense,42018,Tubarão,Imaruí,SC,21041,18973,15431,13404,11675,11672,5855,5817,4003,7669,-1.37%
4207304,4206,Sul Catarinense,42018,Tubarão,Imbituba,SC,20498,25155,30942,35700,36231,40200,19799,20401,40200,0,1.19%
4207403,4204,Vale do Itajaí,42014,Ituporanga,Imbuia,SC,2709,3574,4614,5246,5501,5709,2891,2818,2517,3192,0.85%
4207502,4204,Vale do Itajaí,42012,Blumenau,Indaial,SC,22349,28584,30158,40194,47686,54794,27382,27412,52871,1923,3.15%
4207577,4201,Oeste Catarinense,42004,Joaçaba,Iomerê,SC,,,,2553,2558,2743,1394,1349,911,1832,0.72%
4207601,4201,Oeste Catarinense,42005,Concórdia,Ipira,SC,4917,4899,4765,4979,4705,4752,2366,2386,2521,2231,-0.47%
4207650,4201,Oeste Catarinense,42001,São Miguel do Oeste,Iporã do Oeste,SC,,,7718,7877,8091,8413,4263,4150,4126,4287,0.66%
4207684,4201,Oeste Catarinense,42003,Xanxerê,Ipuaçu,SC,,,,6122,6566,6802,3475,3327,1381,5421,1.06%
4207700,4201,Oeste Catarinense,42005,Concórdia,Ipumirim,SC,7403,7112,7253,6907,7118,7220,3665,3555,3148,4072,0.44%
4207759,4201,Oeste Catarinense,42002,Chapecó,Iraceminha,SC,,,5727,4592,4261,4253,2172,2081,1468,2785,-0.76%
4207809,4201,Oeste Catarinense,42005,Concórdia,Irani,SC,6190,6268,7600,8602,9313,9534,4862,4672,6522,3012,1.03%
4207858,4201,Oeste Catarinense,42002,Chapecó,Irati,SC,,,,2202,2025,2096,1072,1024,449,1647,-0.49%
4207908,4202,Norte Catarinense,42006,Canoinhas,Irineópolis,SC,8999,8761,9762,9734,10287,10450,5347,5103,3521,6929,0.71%
4208005,4201,Oeste Catarinense,42005,Concórdia,Itá,SC,7242,7815,8426,6764,6417,6427,3218,3209,4058,2369,-0.51%
4208104,4202,Norte Catarinense,42006,Canoinhas,Itaiópolis,SC,24102,24538,26240,19086,19752,20315,10422,9893,10742,9573,0.63%
4208203,4204,Vale do Itajaí,42013,Itajaí,Itajaí,SC,63139,86456,119631,147494,163218,183388,90141,93247,173465,9923,2.20%
4208302,4204,Vale do Itajaí,42013,Itajaí,Itapema,SC,3492,6585,12176,25869,33766,45814,22387,23427,44676,1138,5.88%
4208401,4201,Oeste Catarinense,42001,São Miguel do Oeste,Itapiranga,SC,20277,26487,21355,13998,15238,15430,7868,7562,7635,7795,0.98%
4208450,4202,Norte Catarinense,42008,Joinville,Itapoá,SC,,,4007,8839,10719,14775,7454,7321,14182,593,5.27%
4208500,4204,Vale do Itajaí,42014,Ituporanga,Ituporanga,SC,15134,17143,21152,19492,20577,22255,11096,11159,14834,7421,1.33%
4208609,4201,Oeste Catarinense,42004,Joaçaba,Jaborá,SC,5042,4931,4407,4194,4032,4041,2013,2028,1605,2436,-0.37%
4208708,4206,Sul Catarinense,42020,Araranguá,Jacinto Machado,SC,13689,12334,11514,10923,10738,10608,5262,5346,5132,5476,-0.29%
4208807,4206,Sul Catarinense,42018,Tubarão,Jaguaruna,SC,14397,14699,18427,14613,15668,17291,8624,8667,13199,4092,1.70%
4208906,4202,Norte Catarinense,42008,Joinville,Jaraguá do Sul,SC,30246,48538,76968,108489,129973,143206,71864,71342,132918,10288,2.82%
4208955,4201,Oeste Catarinense,42002,Chapecó,Jardinópolis,SC,,,,1994,1851,1766,900,866,799,967,-1.21%
4209003,4201,Oeste Catarinense,42004,Joaçaba,Joaçaba,SC,20794,24725,28139,24066,24435,27005,13008,13997,24918,2087,1.16%
4209102,4202,Norte Catarinense,42008,Joinville,Joinville,SC,126058,235803,347151,429604,487003,515250,255763,259487,497788,17462,1.83%
4209151,4204,Vale do Itajaí,42011,Rio do Sul,José Boiteux,SC,,,4044,4594,4840,4720,2391,2329,1610,3110,0.27%
4209177,4201,Oeste Catarinense,42003,Xanxerê,Jupiá,SC,,,,2220,2134,2148,1094,1054,1044,1104,-0.33%
4209201,4201,Oeste Catarinense,42004,Joaçaba,Lacerdópolis,SC,3122,2135,2080,2173,2190,2197,1099,1098,1158,1039,0.11%
4209300,4203,Serrana,42010,Campos de Lages,Lages,SC,128728,155295,151235,157682,161583,156737,75952,80785,153944,2793,-0.06%
4209409,4206,Sul Catarinense,42018,Tubarão,Laguna,SC,35042,39531,44862,47568,50179,51554,25308,26246,40659,10895,0.81%
4209458,4201,Oeste Catarinense,42003,Xanxerê,Lajeado Grande,SC,,,,1572,1461,1490,756,734,648,842,-0.53%
4209508,4204,Vale do Itajaí,42011,Rio do Sul,Laurentino,SC,3981,4016,4326,5062,5483,6005,3002,3003,4375,1630,1.72%
4209607,4206,Sul Catarinense,42019,Criciúma,Lauro Muller,SC,15574,13220,13936,13604,13700,14366,7185,7181,11105,3261,0.55%
4209706,4201,Oeste Catarinense,42004,Joaçaba,Lebon Régis,SC,9187,8595,10804,11682,11735,11862,6092,5770,7522,4340,0.15%
4209805,4205,Grande Florianópolis,42015,Tijucas,Leoberto Leal,SC,4389,4237,4268,3739,3589,3365,1754,1611,820,2545,-1.05%
4209854,4201,Oeste Catarinense,42005,Concórdia,Lindóia do Sul,SC,,,5278,4877,4560,4642,2394,2248,1930,2712,-0.49%
4209904,4204,Vale do Itajaí,42011,Rio do Sul,Lontras,SC,7006,7335,7578,8381,9180,10248,5128,5120,7018,3230,2.03%
4210001,4204,Vale do Itajaí,42012,Blumenau,Luiz Alves,SC,7651,6480,6440,7974,8986,10449,5390,5059,3256,7193,2.74%
4210035,4201,Oeste Catarinense,42004,Joaçaba,Luzerna,SC,,,,5572,5391,5599,2738,2861,4258,1341,0.05%
4210050,4201,Oeste Catarinense,42004,Joaçaba,Macieira,SC,,,,1900,1760,1826,948,878,501,1325,-0.40%
4210100,4202,Norte Catarinense,42006,Canoinhas,Mafra,SC,36021,40637,47042,49940,51014,52920,26262,26658,41336,11584,0.58%
4210209,4205,Grande Florianópolis,42015,Tijucas,Major Gercino,SC,4554,3846,3785,3143,2842,3279,1672,1607,1249,2030,0.42%
4210308,4202,Norte Catarinense,42006,Canoinhas,Major Vieira,SC,7358,6550,7326,6906,7337,7479,3799,3680,2961,4518,0.80%
4210407,4206,Sul Catarinense,42020,Araranguá,Maracajá,SC,4079,4165,4642,5541,5909,6409,3248,3161,4260,2149,1.47%
4210506,4201,Oeste Catarinense,42002,Chapecó,Maravilha,SC,17657,22236,24107,18521,21684,22104,10910,11194,18090,4014,1.78%
4210555,4201,Oeste Catarinense,42003,Xanxerê,Marema,SC,,,6644,2651,2282,2203,1135,1068,760,1443,-1.83%
4210605,4202,Norte Catarinense,42008,Joinville,Massaranduba,SC,11874,11986,11168,12562,13777,14668,7443,7225,7607,7061,1.56%
4210704,4201,Oeste Catarinense,42004,Joaçaba,Matos Costa,SC,5695,4582,4995,3204,2818,2838,1473,1365,1462,1376,-1.21%
4210803,4206,Sul Catarinense,42020,Araranguá,Meleiro,SC,11306,10697,9755,7080,6880,7002,3458,3544,3651,3351,-0.11%
4210852,4204,Vale do Itajaí,42011,Rio do Sul,Mirim Doce,SC,,,,2753,2545,2513,1273,1240,1202,1311,-0.91%
4210902,4201,Oeste Catarinense,42002,Chapecó,Modelo,SC,12356,13869,9798,3930,3772,4047,2070,1977,2694,1353,0.29%
4211009,4201,Oeste Catarinense,42001,São Miguel do Oeste,Mondaí,SC,19023,23928,16436,8728,9126,10231,5424,4807,6305,3926,1.60%
4211058,4203,Serrana,42009,Curitibanos,Monte Carlo,SC,,,,8579,8854,9312,4740,4572,8076,1236,0.82%
4211108,4202,Norte Catarinense,42006,Canoinhas,Monte Castelo,SC,7237,7680,8600,8350,8113,8348,4281,4067,4850,3498,-0.00%
4211207,4206,Sul Catarinense,42019,Criciúma,Morro da Fumaça,SC,4758,9071,12373,14551,15426,16126,8078,8048,13863,2263,1.03%
4211256,4206,Sul Catarinense,42020,Araranguá,Morro Grande,SC,,,,2917,2727,2890,1513,1377,756,2134,-0.09%
4211306,4204,Vale do Itajaí,42013,Itajaí,Navegantes,SC,10050,13532,23662,39317,52638,60588,30166,30422,57435,3153,4.42%
4211405,4201,Oeste Catarinense,42002,Chapecó,Nova Erechim,SC,2557,3252,3114,3543,4118,4275,2205,2070,3211,1064,1.90%
4211454,4201,Oeste Catarinense,42002,Chapecó,Nova Itaberaba,SC,,,,4256,4117,4267,2210,2057,1530,2737,0.03%
4211504,4205,Grande Florianópolis,42015,Tijucas,Nova Trento,SC,10035,9110,9122,9852,11325,12179,6177,6002,9121,3058,2.14%
4211603,4206,Sul Catarinense,42019,Criciúma,Nova Veneza,SC,8135,9160,10376,11511,12536,13316,6720,6596,8928,4388,1.47%
4211652,4201,Oeste Catarinense,42002,Chapecó,Novo Horizonte,SC,,,,3101,2902,2750,1450,1300,921,1829,-1.19%
4211702,4206,Sul Catarinense,42018,Tubarão,Orleans,SC,15773,16382,20041,20031,20859,21395,10635,10760,16086,5309,0.66%
4211751,4203,Serrana,42010,Campos de Lages,Otacílio Costa,SC,,,14576,13993,15693,16348,8265,8083,14902,1446,1.57%
4211801,4201,Oeste Catarinense,42004,Joaçaba,Ouro,SC,6117,5806,6977,7419,7095,7371,3670,3701,4843,2528,-0.06%
4211850,4201,Oeste Catarinense,42003,Xanxerê,Ouro Verde,SC,,,,2352,2152,2271,1150,1121,715,1556,-0.35%
4211876,4201,Oeste Catarinense,42005,Concórdia,Paial,SC,,,,2052,1821,1763,939,824,336,1427,-1.51%
4211892,4203,Serrana,42010,Campos de Lages,Painel,SC,,,,2384,2297,2353,1232,1121,945,1408,-0.13%
4211900,4205,Grande Florianópolis,42016,Florianópolis,Palhoça,SC,20652,38023,68430,102742,122471,137199,68332,68867,135229,1970,2.93%
4212007,4201,Oeste Catarinense,42001,São Miguel do Oeste,Palma Sola,SC,4573,7333,8857,8206,7942,7765,3957,3808,4468,3297,-0.55%
4212056,4203,Serrana,42010,Campos de Lages,Palmeira,SC,,,,2133,2334,2376,1224,1152,925,1451,1.08%
4212106,4201,Oeste Catarinense,42002,Chapecó,Palmitos,SC,14165,17748,17749,16034,16061,16021,8016,8005,9871,6150,-0.01%
4212205,4202,Norte Catarinense,42006,Canoinhas,Papanduva,SC,11468,13457,16232,16822,17056,17931,9184,8747,9185,8746,0.64%
4212239,4201,Oeste Catarinense,42001,São Miguel do Oeste,Paraíso,SC,,,,4796,4195,4080,2091,1989,1451,2629,-1.60%
4212254,4206,Sul Catarinense,42020,Araranguá,Passo de Torres,SC,,,,4400,5313,6631,3354,3277,5877,754,4.19%
4212270,4201,Oeste Catarinense,42003,Xanxerê,Passos Maia,SC,,,,4763,4472,4429,2246,2183,1102,3327,-0.72%
4212304,4205,Grande Florianópolis,42016,Florianópolis,Paulo Lopes,SC,5711,5490,5530,5924,6830,6692,3404,3288,4820,1872,1.23%
4212403,4206,Sul Catarinense,42018,Tubarão,Pedras Grandes,SC,5912,5249,5062,4921,4817,4107,2098,2009,1261,2846,-1.79%
4212502,4204,Vale do Itajaí,42013,Itajaí,Penha,SC,7502,9961,13108,17678,20868,25140,12541,12599,23058,2082,3.58%
4212601,4201,Oeste Catarinense,42005,Concórdia,Peritiba,SC,2652,2731,3189,3230,2944,2988,1484,1504,1481,1507,-0.78%
4212700,4204,Vale do Itajaí,42014,Ituporanga,Petrolândia,SC,6944,6907,7067,6406,6064,6131,3166,2965,2225,3906,-0.44%
4212809,4204,Vale do Itajaí,42013,Itajaí,Balneário Piçarras,SC,4416,5593,7935,10911,13760,17074,8521,8553,15502,1572,4.58%
4212908,4201,Oeste Catarinense,42002,Chapecó,Pinhalzinho,SC,8044,9954,10673,12356,14691,16335,8180,8155,13618,2717,2.83%
4213005,4201,Oeste Catarinense,42004,Joaçaba,Pinheiro Preto,SC,1901,2183,2374,2729,2912,3147,1615,1532,1700,1447,1.44%
4213104,4201,Oeste Catarinense,42005,Concórdia,Piratuba,SC,5426,4803,4909,5812,4570,4786,2374,2412,2855,1931,-1.92%
4213153,4201,Oeste Catarinense,42002,Chapecó,Planalto Alegre,SC,,,,2452,2639,2659,1383,1276,1066,1593,0.81%
4213203,4204,Vale do Itajaí,42012,Blumenau,Pomerode,SC,12070,14377,18771,22127,25261,27772,13906,13866,23836,3936,2.30%
4213302,4203,Serrana,42009,Curitibanos,Ponte Alta,SC,5945,4926,4752,5168,5080,4895,2454,2441,3577,1318,-0.54%
4213351,4203,Serrana,42009,Curitibanos,Ponte Alta do Norte,SC,,,,3221,3500,3303,1644,1659,3007,296,0.25%
4213401,4201,Oeste Catarinense,42003,Xanxerê,Ponte Serrada,SC,9285,12337,12259,10561,11210,11031,5537,5494,7624,3407,0.44%
4213500,4204,Vale do Itajaí,42013,Itajaí,Porto Belo,SC,7298,8419,11689,10704,13232,16118,8013,8105,15203,915,4.18%
4213609,4202,Norte Catarinense,42006,Canoinhas,Porto União,SC,22796,27713,29883,31858,32256,33497,16452,17045,28280,5217,0.50%
4213708,4204,Vale do Itajaí,42011,Rio do Sul,Pouso Redondo,SC,10666,10771,11465,12203,13722,14812,7504,7308,9026,5786,1.96%
4213807,4206,Sul Catarinense,42020,Araranguá,Praia Grande,SC,8140,7608,7579,7286,7120,7270,3659,3611,4300,2970,-0.02%
4213906,4201,Oeste Catarinense,42005,Concórdia,Presidente Castello Branco,SC,1906,1725,1796,2160,1757,1724,880,844,552,1172,-2.23%
4214003,4204,Vale do Itajaí,42011,Rio do Sul,Presidente Getúlio,SC,9399,10114,11372,12333,13651,14886,7405,7481,10533,4353,1.90%
4214102,4204,Vale do Itajaí,42011,Rio do Sul,Presidente Nereu,SC,4088,3185,2775,2305,2259,2284,1167,1117,808,1476,-0.09%
4214151,4201,Oeste Catarinense,42001,São Miguel do Oeste,Princesa,SC,,,,2613,2604,2758,1421,1337,1004,1754,0.54%
4214201,4201,Oeste Catarinense,42002,Chapecó,Quilombo,SC,15914,21453,19362,10736,10871,10251,5170,5081,5749,4502,-0.46%
4214300,4205,Grande Florianópolis,42017,Tabuleiro,Rancho Queimado,SC,2371,2514,2359,2637,2772,2748,1398,1350,1290,1458,0.41%
4214409,4201,Oeste Catarinense,42004,Joaçaba,Rio das Antas,SC,6245,5447,5753,6129,6054,6147,3162,2985,2741,3406,0.03%
4214508,4204,Vale do Itajaí,42011,Rio do Sul,Rio do Campo,SC,6078,5795,6887,6522,6042,6195,3180,3015,2632,3563,-0.51%
4214607,4204,Vale do Itajaí,42011,Rio do Sul,Rio do Oeste,SC,8440,7406,6966,6730,6795,7094,3608,3486,3390,3704,0.53%
4214706,4204,Vale do Itajaí,42012,Blumenau,Rio dos Cedros,SC,9718,8466,8642,8939,9685,10280,5267,5013,5122,5158,1.41%
4214805,4204,Vale do Itajaí,42011,Rio do Sul,Rio do Sul,SC,27538,36247,45679,51650,56919,61196,29972,31224,56783,4413,1.71%
4214904,4206,Sul Catarinense,42018,Tubarão,Rio Fortuna,SC,4440,4010,4174,4320,4468,4446,2294,2152,1523,2923,0.29%
4215000,4202,Norte Catarinense,42007,São Bento do Sul,Rio Negrinho,SC,13123,21008,28460,37707,42237,39849,19980,19869,36351,3498,0.55%
4215059,4203,Serrana,42010,Campos de Lages,Rio Rufino,SC,,,,2414,2433,2436,1245,1191,688,1748,0.09%
4215075,4201,Oeste Catarinense,42001,São Miguel do Oeste,Riqueza,SC,,,,5166,4998,4838,2498,2340,2154,2684,-0.65%
4215109,4204,Vale do Itajaí,42012,Blumenau,Rodeio,SC,7954,7972,9371,10380,10773,10914,5484,5430,9416,1498,0.50%
4215208,4201,Oeste Catarinense,42001,São Miguel do Oeste,Romelândia,SC,5525,9468,9419,6491,5738,5551,2793,2758,2008,3543,-1.55%
4215307,4204,Vale do Itajaí,42011,Rio do Sul,Salete,SC,4879,5577,7129,7163,7432,7357,3770,3587,4978,2379,0.27%
4215356,4201,Oeste Catarinense,42002,Chapecó,Saltinho,SC,,,,4196,4072,3961,2040,1921,1255,2706,-0.57%
4215406,4201,Oeste Catarinense,42004,Joaçaba,Salto Veloso,SC,2959,3317,3510,3910,4172,4301,2189,2112,3402,899,0.96%
4215455,4206,Sul Catarinense,42018,Tubarão,Sangão,SC,,,,8128,10300,10402,5324,5078,4856,5546,2.50%
4215505,4203,Serrana,42009,Curitibanos,Santa Cecília,SC,14717,15566,12611,14802,15311,15740,7836,7904,13644,2096,0.62%
4215554,4201,Oeste Catarinense,42001,São Miguel do Oeste,Santa Helena,SC,,,,2588,2437,2382,1236,1146,882,1500,-0.83%
4215604,4206,Sul Catarinense,42018,Tubarão,Santa Rosa de Lima,SC,1772,1723,1896,2007,2031,2065,1092,973,518,1547,0.29%
4215653,4206,Sul Catarinense,42020,Araranguá,Santa Rosa do Sul,SC,,,7227,7810,7949,8054,4050,4004,3746,4308,0.31%
4215679,4202,Norte Catarinense,42006,Canoinhas,Santa Terezinha,SC,,,,8840,9025,8767,4700,4067,1513,7254,-0.08%
4215687,4201,Oeste Catarinense,42002,Chapecó,Santa Terezinha do Progresso,SC,,,,3416,3044,2896,1493,1403,539,2357,-1.64%
4215695,4201,Oeste Catarinense,42002,Chapecó,Santiago do Sul,SC,,,,1696,1450,1465,754,711,650,815,-1.45%
4215703,4205,Grande Florianópolis,42016,Florianópolis,Santo Amaro da Imperatriz,SC,10362,11316,13392,15708,17602,19830,9986,9844,14977,4853,2.36%
4215752,4201,Oeste Catarinense,42002,Chapecó,São Bernardino,SC,,,,3140,2653,2679,1408,1271,719,1960,-1.58%
4215802,4202,Norte Catarinense,42007,São Bento do Sul,São Bento do Sul,SC,16656,35206,50328,65437,72548,74797,37229,37568,71230,3567,1.35%
4215901,4205,Grande Florianópolis,42017,Tabuleiro,São Bonifácio,SC,3403,3534,3373,3218,3178,3008,1551,1457,685,2323,-0.67%
4216008,4201,Oeste Catarinense,42002,Chapecó,São Carlos,SC,10358,11625,12230,9364,10372,10284,5172,5112,6899,3385,0.94%
4216057,4203,Serrana,42009,Curitibanos,São Cristovão do Sul,SC,,,,4504,4850,5019,2853,2166,3806,1213,1.09%
4216107,4201,Oeste Catarinense,42003,Xanxerê,São Domingos,SC,10787,14035,14093,9540,9346,9496,4783,4713,6313,3183,-0.05%
4216206,4202,Norte Catarinense,42008,Joinville,São Francisco do Sul,SC,19057,20599,29593,32301,37613,42569,21191,21378,39536,3033,2.80%
4216255,4201,Oeste Catarinense,42001,São Miguel do Oeste,São João do Oeste,SC,,,,5789,6020,6035,3098,2937,2118,3917,0.42%
4216305,4205,Grande Florianópolis,42015,Tijucas,São João Batista,SC,10386,10693,12765,14861,22089,26260,13287,12973,23551,2709,5.86%
4216354,4204,Vale do Itajaí,42013,Itajaí,São João do Itaperiú,SC,,,,3161,3289,3438,1792,1646,1928,1510,0.84%
4216404,4206,Sul Catarinense,42020,Araranguá,São João do Sul,SC,8577,7408,8985,6784,6916,7002,3530,3472,1572,5430,0.32%
4216503,4203,Serrana,42010,Campos de Lages,São Joaquim,SC,26640,23624,22295,22836,24058,24812,12434,12378,17573,7239,0.83%
4216602,4205,Grande Florianópolis,42016,Florianópolis,São José,SC,42535,87822,139493,173559,196887,210513,101794,108719,208017,2496,1.95%
4216701,4201,Oeste Catarinense,42001,São Miguel do Oeste,São José do Cedro,SC,12500,17881,17673,13678,13699,13672,6887,6785,8431,5241,-0.00%
4216800,4203,Serrana,42010,Campos de Lages,São José do Cerrito,SC,15039,13368,11595,10393,10304,9273,4801,4472,2492,6781,-1.13%
4216909,4201,Oeste Catarinense,42002,Chapecó,São Lourenço do Oeste,SC,16753,23891,23181,19647,21799,21797,10830,10967,16885,4912,1.04%
4217006,4206,Sul Catarinense,42018,Tubarão,São Ludgero,SC,4597,4564,6007,8587,10246,10993,5625,5368,9863,1130,2.50%
4217105,4206,Sul Catarinense,42018,Tubarão,São Martinho,SC,3470,3036,3378,3274,3194,3211,1661,1550,1229,1982,-0.19%
4217154,4201,Oeste Catarinense,42002,Chapecó,São Miguel da Boa Vista,SC,,,,2018,1972,1904,979,925,439,1465,-0.58%
4217204,4201,Oeste Catarinense,42001,São Miguel do Oeste,São Miguel do Oeste,SC,22355,35772,42242,32324,33806,36295,17639,18656,32052,4243,1.17%
4217253,4205,Grande Florianópolis,42016,Florianópolis,São Pedro de Alcântara,SC,,,,3584,4765,4710,2994,1716,3735,975,2.77%
4217303,4201,Oeste Catarinense,42002,Chapecó,Saudades,SC,8787,9293,9072,8324,8587,9016,4618,4398,5123,3893,0.80%
4217402,4202,Norte Catarinense,42008,Joinville,Schroeder,SC,3364,3990,6607,10811,12776,15316,7801,7515,13703,1613,3.54%
4217501,4201,Oeste Catarinense,42005,Concórdia,Seara,SC,13374,15996,18093,16484,17121,16922,8518,8404,11589,5333,0.26%
4217550,4201,Oeste Catarinense,42002,Chapecó,Serra Alta,SC,,,3861,3330,3200,3285,1634,1651,1835,1450,-0.14%
4217600,4206,Sul Catarinense,42019,Criciúma,Siderópolis,SC,13341,12394,13388,12082,12470,12995,6479,6516,10051,2944,0.73%
4217709,4206,Sul Catarinense,42020,Araranguá,Sombrio,SC,18049,17293,22253,22962,24424,26626,13080,13546,19650,6976,1.49%
4217758,4201,Oeste Catarinense,42002,Chapecó,Sul Brasil,SC,,,,3116,3061,2766,1438,1328,1011,1755,-1.18%
4217808,4204,Vale do Itajaí,42011,Rio do Sul,Taió,SC,18711,18607,19369,16257,16838,17265,8691,8574,9973,7292,0.60%
4217907,4201,Oeste Catarinense,42004,Joaçaba,Tangará,SC,13313,11644,11833,8754,8410,8674,4470,4204,4984,3690,-0.09%
4217956,4201,Oeste Catarinense,42002,Chapecó,Tigrinhos,SC,,,,1878,1741,1757,902,855,343,1414,-0.66%
4218004,4205,Grande Florianópolis,42015,Tijucas,Tijucas,SC,12774,14608,19650,23499,27804,30973,15497,15476,26012,4961,2.80%
4218103,4206,Sul Catarinense,42020,Araranguá,Timbé do Sul,SC,6300,5878,5705,5323,5133,5308,2693,2615,1845,3463,-0.03%
4218202,4204,Vale do Itajaí,42012,Blumenau,Timbó,SC,11829,17927,23806,29358,33326,36817,18265,18552,34333,2484,2.29%
4218251,4202,Norte Catarinense,42006,Canoinhas,Timbó Grande,SC,,,4960,6501,6979,7165,3610,3555,4081,3084,0.98%
4218301,4202,Norte Catarinense,42006,Canoinhas,Três Barras,SC,6461,11338,15636,17124,17937,18131,9058,9073,15367,2764,0.57%
4218350,4206,Sul Catarinense,42019,Criciúma,Treviso,SC,,,,3144,3498,3527,1789,1738,1833,1694,1.16%
4218400,4206,Sul Catarinense,42018,Tubarão,Treze de Maio,SC,6326,6565,6201,6716,6599,6877,3451,3426,3401,3476,0.24%
4218509,4201,Oeste Catarinense,42004,Joaçaba,Treze Tílias,SC,3591,3553,4027,4840,5641,6342,3150,3192,4716,1626,2.74%
4218608,4204,Vale do Itajaí,42011,Rio do Sul,Trombudo Central,SC,7331,7098,8389,5795,6221,6554,3268,3286,4102,2452,1.24%
4218707,4206,Sul Catarinense,42018,Tubarão,Tubarão,SC,66876,75242,95062,88470,92569,97281,47147,50134,88137,9144,0.95%
4218756,4201,Oeste Catarinense,42001,São Miguel do Oeste,Tunápolis,SC,,,5546,4777,4650,4633,2369,2264,1418,3215,-0.31%
4218806,4206,Sul Catarinense,42020,Araranguá,Turvo,SC,11159,12205,12494,10887,11031,11854,5849,6005,7915,3939,0.85%
4218855,4201,Oeste Catarinense,42002,Chapecó,União do Oeste,SC,,,7234,3391,3058,2910,1475,1435,1107,1803,-1.52%
4218905,4203,Serrana,42010,Campos de Lages,Urubici,SC,12539,12257,11506,10252,10439,10702,5393,5309,7069,3633,0.43%
4218954,4203,Serrana,42010,Campos de Lages,Urupema,SC,,,2474,2527,2501,2482,1274,1208,1232,1250,-0.18%
4219002,4206,Sul Catarinense,42019,Criciúma,Urussanga,SC,15651,21419,29882,18727,18588,20222,9934,10288,11404,8818,0.77%
4219101,4201,Oeste Catarinense,42003,Xanxerê,Vargeão,SC,2317,2846,2784,3526,3560,3535,1786,1749,1824,1711,0.03%
4219150,4203,Serrana,42009,Curitibanos,Vargem,SC,,,,3225,3110,2808,1446,1362,896,1912,-1.38%
4219176,4201,Oeste Catarinense,42004,Joaçaba,Vargem Bonita,SC,,,,5158,4321,4795,2429,2366,2677,2118,-0.73%
4219200,4204,Vale do Itajaí,42014,Ituporanga,Vidal Ramos,SC,9271,8693,7587,6279,5981,6293,3260,3033,1792,4501,0.02%
4219309,4201,Oeste Catarinense,42004,Joaçaba,Videira,SC,21864,28152,35922,41589,44479,47204,23290,23914,42872,4332,1.27%
4219358,4204,Vale do Itajaí,42011,Rio do Sul,Vitor Meireles,SC,,,6203,5519,5563,5208,2772,2436,1445,3763,-0.58%
4219408,4204,Vale do Itajaí,42011,Rio do Sul,Witmarsum,SC,3694,3315,3649,3251,3431,3601,1828,1773,845,2756,1.03%
4219507,4201,Oeste Catarinense,42003,Xanxerê,Xanxerê,SC,24859,30004,37638,37429,40228,44102,21571,22531,39123,4979,1.65%
4219606,4201,Oeste Catarinense,42005,Concórdia,Xavantina,SC,5507,5379,4961,4404,4218,4142,2159,1983,1118,3024,-0.61%
4219705,4201,Oeste Catarinense,42003,Xanxerê,Xaxim,SC,20075,24504,21298,22857,24318,25697,12763,12934,20953,4744,1.18%
4219853,4203,Serrana,42009,Curitibanos,Zortéa,SC,,,,2633,2868,2991,1537,1454,2336,655,1.28%
2800100,2803,Leste Sergipano,28007,Propriá,Amparo de São Francisco,SE,1886,1704,1891,2182,2197,2275,1135,1140,1840,435,0.42%
2800209,2802,Agreste Sergipano,28003,Nossa Senhora das Dores,Aquidabã,SE,15910,16125,16275,18344,19185,20066,9808,10258,11460,8606,0.90%
2800308,2803,Leste Sergipano,28011,Aracaju,Aracaju,SE,183670,293119,402341,461534,520303,570937,265321,305616,570937,0,2.15%
2800407,2803,Leste Sergipano,28012,Boquim,Arauá,SE,6533,8924,10477,9762,11633,9699,4887,4812,4486,5213,-0.06%
2800506,2802,Agreste Sergipano,28004,Agreste de Itabaiana,Areia Branca,SE,3772,6332,10542,14824,16072,16882,8511,8371,8191,8691,1.31%
2800605,2803,Leste Sergipano,28011,Aracaju,Barra dos Coqueiros,SE,5568,7952,12727,17807,19218,25012,12221,12791,20895,4117,3.46%
2800670,2803,Leste Sergipano,28012,Boquim,Boquim,SE,14127,18320,23015,24188,24472,25528,12532,12996,15998,9530,0.54%
2800704,2803,Leste Sergipano,28007,Propriá,Brejo Grande,SE,7981,7247,6701,7102,7760,7745,3938,3807,4022,3723,0.87%
2801009,2802,Agreste Sergipano,28004,Agreste de Itabaiana,Campo do Brito,SE,11233,11903,13420,15175,16122,16766,8212,8554,8334,8432,1.00%
2801108,2803,Leste Sergipano,28007,Propriá,Canhoba,SE,4734,4087,3863,3965,3910,3947,2062,1885,1499,2448,-0.05%
2801207,2801,Sertão Sergipano,28001,Sergipana do Sertão do São Francisco,Canindé de São Francisco,SE,2837,6157,11473,17754,21806,24693,12293,12400,14067,10626,3.35%
2801306,2803,Leste Sergipano,28008,Cotinguiba,Capela,SE,20114,23008,25105,26518,27913,30769,15272,15497,19752,11017,1.50%
2801405,2801,Sertão Sergipano,28002,Carira,Carira,SE,12384,15577,15418,17770,18965,19990,9965,10025,11151,8839,1.18%
2801504,2803,Leste Sergipano,28010,Baixo Cotinguiba,Carmópolis,SE,4037,4463,6782,9352,11911,13500,6671,6829,10701,2799,3.74%
2801603,2803,Leste Sergipano,28007,Propriá,Cedro de São João,SE,5454,4921,5122,5378,5358,5633,2780,2853,5035,598,0.46%
2801702,2803,Leste Sergipano,28012,Boquim,Cristinápolis,SE,5778,7242,10932,14268,15867,16519,8295,8224,8336,8183,1.48%
2801900,2802,Agreste Sergipano,28003,Nossa Senhora das Dores,Cumbe,SE,3615,3401,3325,3646,3741,3813,1903,1910,2271,1542,0.45%
2802007,2803,Leste Sergipano,28008,Cotinguiba,Divina Pastora,SE,2391,2188,2645,3266,4198,4326,2189,2137,2099,2227,2.85%
2802106,2803,Leste Sergipano,28013,Estância,Estância,SE,28045,36825,53869,59002,61368,64464,31415,33049,54796,9668,0.89%
2802205,2801,Sertão Sergipano,28001,Sergipana do Sertão do São Francisco,Feira Nova,SE,4383,4294,4417,5068,5628,5325,2630,2695,3588,1737,0.50%
2802304,2801,Sertão Sergipano,28002,Carira,Frei Paulo,SE,8736,8830,10278,11973,12589,13854,6777,7077,8204,5650,1.47%
2802403,2801,Sertão Sergipano,28001,Sergipana do Sertão do São Francisco,Gararu,SE,10689,11284,10465,11363,11606,11458,5849,5609,2831,8627,0.08%
2802502,2803,Leste Sergipano,28010,Baixo Cotinguiba,General Maynard,SE,1870,1863,2148,2400,2773,2914,1417,1497,1843,1071,1.96%
2802601,2801,Sertão Sergipano,28001,Sergipana do Sertão do São Francisco,Gracho Cardoso,SE,5763,6032,5176,5519,5554,5648,2891,2757,2706,2942,0.23%
2802700,2803,Leste Sergipano,28007,Propriá,Ilha das Flores,SE,6632,7743,7125,8281,8598,8348,4168,4180,5435,2913,0.08%
2802809,2803,Leste Sergipano,28013,Estância,Indiaroba,SE,6709,7749,11607,13152,17089,15861,8049,7812,5585,10276,1.89%
2802908,2802,Agreste Sergipano,28004,Agreste de Itabaiana,Itabaiana,SE,41640,52601,64838,76813,83161,86981,42514,44467,67717,19264,1.25%
2803005,2803,Leste Sergipano,28012,Boquim,Itabaianinha,SE,21686,26475,30885,35454,37431,38886,19373,19513,19390,19496,0.93%
2803104,2801,Sertão Sergipano,28001,Sergipana do Sertão do São Francisco,Itabi,SE,5025,4732,4834,5174,4736,4972,2478,2494,2752,2220,-0.40%
2803203,2803,Leste Sergipano,28013,Estância,Itaporanga d'Ajuda,SE,13872,16603,20324,25482,28131,30428,15164,15264,11872,18556,1.79%
2803302,2803,Leste Sergipano,28009,Japaratuba,Japaratuba,SE,9243,10471,13004,14556,15450,16874,8386,8488,7916,8958,1.49%
2803401,2803,Leste Sergipano,28009,Japaratuba,Japoatã,SE,6978,7797,10549,13020,13539,12947,6481,6466,4309,8638,-0.06%
2803500,2802,Agreste Sergipano,28006,Agreste de Lagarto,Lagarto,SE,51131,58328,72144,83334,88980,94852,46498,48354,48889,45963,1.30%
2803609,2803,Leste Sergipano,28010,Baixo Cotinguiba,Laranjeiras,SE,10627,13275,18944,23560,23923,26903,13138,13765,21258,5645,1.34%
2803708,2802,Agreste Sergipano,28004,Agreste de Itabaiana,Macambira,SE,4674,4420,4968,5802,6295,6411,3168,3243,3069,3342,1.00%
2803807,2802,Agreste Sergipano,28003,Nossa Senhora das Dores,Malhada dos Bois,SE,2632,2439,2550,3208,3658,3461,1755,1706,1600,1861,0.76%
2803906,2802,Agreste Sergipano,28004,Agreste de Itabaiana,Malhador,SE,6259,8307,9982,11481,11728,12056,6085,5971,5626,6430,0.49%
2804003,2803,Leste Sergipano,28010,Baixo Cotinguiba,Maruim,SE,9233,11366,14683,15454,15150,16338,8015,8323,12045,4293,0.56%
2804102,2802,Agreste Sergipano,28004,Agreste de Itabaiana,Moita Bonita,SE,8136,8622,9232,10758,10910,11034,5478,5556,4618,6416,0.25%
2804201,2801,Sertão Sergipano,28001,Sergipana do Sertão do São Francisco,Monte Alegre de Sergipe,SE,6730,8599,9589,11587,13199,13621,6890,6731,8045,5576,1.63%
2804300,2802,Agreste Sergipano,28003,Nossa Senhora das Dores,Muribeca,SE,5459,6071,6682,7101,7225,7342,3683,3659,3288,4054,0.33%
2804409,2803,Leste Sergipano,28007,Propriá,Neópolis,SE,16311,17580,21411,18593,18909,18511,9238,9273,10519,7992,-0.04%
2804458,2801,Sertão Sergipano,28002,Carira,Nossa Senhora Aparecida,SE,8074,8753,8584,8279,8517,8510,4255,4255,3457,5053,0.28%
2804508,2801,Sertão Sergipano,28001,Sergipana do Sertão do São Francisco,Nossa Senhora da Glória,SE,13716,20432,23478,26910,29546,32514,16085,16429,21633,10881,1.91%
2804607,2802,Agreste Sergipano,28003,Nossa Senhora das Dores,Nossa Senhora das Dores,SE,16177,17493,19606,22195,23800,24579,12128,12451,16027,8552,1.03%
2804706,2803,Leste Sergipano,28007,Propriá,Nossa Senhora de Lourdes,SE,3971,4183,4668,6023,6280,6242,3153,3089,3290,2952,0.36%
2804805,2803,Leste Sergipano,28011,Aracaju,Nossa Senhora do Socorro,SE,9346,13710,67574,131679,148546,160829,78314,82515,155836,4993,2.02%
2804904,2803,Leste Sergipano,28009,Japaratuba,Pacatuba,SE,9469,9823,11500,11536,12377,13137,6687,6450,2688,10449,1.31%
2805000,2801,Sertão Sergipano,28002,Carira,Pedra Mole,SE,1311,1718,2144,2630,2774,2968,1497,1471,1192,1776,1.22%
2805109,2803,Leste Sergipano,28012,Boquim,Pedrinhas,SE,3955,5404,7306,7929,8389,8821,4346,4475,6464,2357,1.07%
2805208,2801,Sertão Sergipano,28002,Carira,Pinhão,SE,3368,3989,4430,5244,5590,5973,2925,3048,3319,2654,1.31%
2805307,2803,Leste Sergipano,28009,Japaratuba,Pirambu,SE,2897,3311,4838,7255,8227,8369,4212,4157,4906,3463,1.44%
2805406,2801,Sertão Sergipano,28001,Sergipana do Sertão do São Francisco,Poço Redondo,SE,9298,16741,20155,26022,28969,30877,15766,15111,8536,22341,1.73%
2805505,2802,Agreste Sergipano,28005,Tobias Barreto,Poço Verde,SE,11012,14356,17666,19973,21083,21968,10865,11103,12306,9662,0.96%
2805604,2801,Sertão Sergipano,28001,Sergipana do Sertão do São Francisco,Porto da Folha,SE,15924,22863,23476,25664,26520,27124,13876,13248,9929,17195,0.55%
2805703,2803,Leste Sergipano,28007,Propriá,Propriá,SE,21309,21309,25091,27385,27629,28457,13850,14607,24393,4064,0.38%
2805802,2802,Agreste Sergipano,28006,Agreste de Lagarto,Riachão do Dantas,SE,16640,17474,16992,19202,19019,19394,9732,9662,4872,14522,0.10%
2805901,2803,Leste Sergipano,28010,Baixo Cotinguiba,Riachuelo,SE,5939,5898,7551,8337,9087,9351,4550,4801,7851,1500,1.15%
2806008,2801,Sertão Sergipano,28002,Carira,Ribeirópolis,SE,10088,12205,14032,15439,15676,17163,8488,8675,11916,5247,1.06%
2806107,2803,Leste Sergipano,28010,Baixo Cotinguiba,Rosário do Catete,SE,3914,3915,5639,7102,8518,9222,4447,4775,6504,2718,2.65%
2806206,2803,Leste Sergipano,28012,Boquim,Salgado,SE,8463,12270,16717,18876,18563,19362,9658,9704,6691,12671,0.25%
2806305,2803,Leste Sergipano,28013,Estância,Santa Luzia do Itanhy,SE,6938,8026,9874,13948,13041,13914,7141,6773,2915,10999,-0.02%
2806404,2803,Leste Sergipano,28007,Propriá,Santana do São Francisco,SE,,,,6135,6596,7038,3540,3498,4523,2515,1.38%
2806503,2803,Leste Sergipano,28008,Cotinguiba,Santa Rosa de Lima,SE,3122,2975,3363,3595,3844,3752,1889,1863,2137,1615,0.43%
2806602,2803,Leste Sergipano,28010,Baixo Cotinguiba,Santo Amaro das Brotas,SE,5415,7947,10624,10670,11652,11389,5604,5785,8202,3187,0.65%
2806701,2803,Leste Sergipano,28011,Aracaju,São Cristóvão,SE,20409,24129,47558,64647,71931,78876,38404,40472,66682,12194,2.01%
2806800,2802,Agreste Sergipano,28004,Agreste de Itabaiana,São Domingos,SE,4930,6316,7752,9260,10128,10257,5081,5176,5141,5116,1.03%
2806909,2803,Leste Sergipano,28009,Japaratuba,São Francisco,SE,1983,2046,2222,2532,2874,3395,1708,1687,2379,1016,2.98%
2807006,2802,Agreste Sergipano,28003,Nossa Senhora das Dores,São Miguel do Aleixo,SE,3245,3095,3132,3447,3670,3702,1843,1859,1751,1951,0.72%
2807105,2802,Agreste Sergipano,28005,Tobias Barreto,Simão Dias,SE,27904,27031,32196,36813,37145,38724,18890,19834,20449,18275,0.51%
2807204,2803,Leste Sergipano,28008,Cotinguiba,Siriri,SE,5155,5406,6297,6914,7618,8006,3990,4016,3183,4823,1.48%
2807303,2803,Leste Sergipano,28007,Propriá,Telha,SE,1945,1763,2205,2638,2852,2957,1476,1481,1127,1830,1.15%
2807402,2802,Agreste Sergipano,28005,Tobias Barreto,Tobias Barreto,SE,24832,30781,37577,43172,47265,48039,23464,24575,32223,15816,1.07%
2807501,2803,Leste Sergipano,28012,Boquim,Tomar do Geru,SE,9701,10537,11278,12840,12877,12873,6540,6333,4814,8059,0.03%
2807600,2803,Leste Sergipano,28012,Boquim,Umbaúba,SE,5742,9504,14593,19214,20562,22660,11110,11550,13932,8728,1.66%
3500105,3508,Presidente Prudente,35035,Adamantina,Adamantina,SP,31798,32049,32091,33497,33289,33797,16375,17422,31948,1849,0.09%
3500204,3501,São José do Rio Preto,35004,São José do Rio Preto,Adolfo,SP,3969,3607,3272,3684,3609,3557,1787,1770,3200,357,-0.35%
3500303,3507,Campinas,35029,Pirassununga,Aguaí,SP,13171,17056,23363,28195,30181,32168,16224,15944,29021,3147,1.33%
3500402,3507,Campinas,35030,São João da Boa Vista,Águas da Prata,SP,5876,5717,6692,7131,7367,7580,3742,3838,6766,814,0.61%
3500501,3507,Campinas,35033,Amparo,Águas de Lindóia,SP,6732,9161,11966,16190,15867,17261,8453,8808,17108,153,0.64%
3500550,3504,Bauru,35022,Avaré,Águas de Santa Bárbara,SP,4723,4632,6049,5224,5360,5598,2777,2821,4256,1342,0.69%
3500600,3506,Piracicaba,35028,Piracicaba,Águas de São Pedro,SP,830,1091,1697,1883,2340,2703,1257,1446,2703,0,3.68%
3500709,3504,Bauru,35020,Bauru,Agudos,SP,18543,24478,31706,32484,34221,34532,17086,17446,32999,1533,0.61%
3500758,3511,Itapetininga,35042,Itapetininga,Alambari,SP,,,,3650,4070,4886,2457,2429,3672,1214,2.96%
3500808,3508,Presidente Prudente,35036,Presidente Prudente,Alfredo Marcondes,SP,6867,4309,3493,3697,3851,3891,1980,1911,3255,636,0.51%
3500907,3501,São José do Rio Preto,35004,São José do Rio Preto,Altair,SP,2527,2318,3239,3530,3272,3814,2051,1763,3022,792,0.78%
3501004,3502,Ribeirão Preto,35015,Batatais,Altinópolis,SP,10819,12743,13642,15481,15139,15609,7802,7807,13643,1966,0.08%
3501103,3503,Araçatuba,35018,Birigui,Alto Alegre,SP,7473,6080,4787,4261,4157,4105,2109,1996,3237,868,-0.37%
3501152,3512,Macro Metropolitana Paulista,35046,Sorocaba,Alumínio,SP,,,,15252,15678,16845,8502,8343,14130,2715,1.00%
3501202,3501,São José do Rio Preto,35003,Votuporanga,Álvares Florence,SP,8334,6588,5050,4316,3902,3901,2001,1900,2652,1249,-1.01%
3501301,3508,Presidente Prudente,35036,Presidente Prudente,Álvares Machado,SP,17305,14653,18865,22661,22859,23506,11633,11873,21180,2326,0.37%
3501400,3509,Marília,35038,Marília,Álvaro de Carvalho,SP,4200,3919,3133,4109,4610,4650,2959,1691,2952,1698,1.24%
3501509,3509,Marília,35038,Marília,Alvinlândia,SP,3020,3461,2541,2837,2787,3000,1482,1518,2693,307,0.56%
3501608,3507,Campinas,35032,Campinas,Americana,SP,66316,121998,153840,182593,199094,210701,103200,107501,209717,984,1.44%
3501707,3505,Araraquara,35024,Araraquara,Américo Brasiliense,SP,5368,11864,20067,28287,31005,34522,17362,17160,34261,261,2.01%
3501806,3501,São José do Rio Preto,35003,Votuporanga,Américo de Campos,SP,6148,6874,5590,5594,5379,5706,2862,2844,4788,918,0.20%
3501905,3507,Campinas,35033,Amparo,Amparo,SP,31908,41603,50797,60404,62692,65836,32444,33392,51818,14018,0.86%
3502002,3505,Araraquara,35025,São Carlos,Analândia,SP,2612,2312,3020,3582,4166,4289,2197,2092,3401,888,1.82%
3502101,3503,Araçatuba,35016,Andradina,Andradina,SP,51688,47664,52409,55161,54753,55317,27185,28132,51629,3688,0.03%
3502200,3511,Itapetininga,35042,Itapetininga,Angatuba,SP,15170,17052,21127,19297,21523,22211,11246,10965,15954,6257,1.42%
3502309,3504,Bauru,35023,Botucatu,Anhembi,SP,3517,3458,3537,4535,5271,5648,2908,2740,4263,1385,2.22%
3502408,3508,Presidente Prudente,35036,Presidente Prudente,Anhumas,SP,5609,3421,3242,3411,3695,3738,1863,1875,3059,679,0.92%
3502507,3513,Vale do Paraíba Paulista,35051,Guaratinguetá,Aparecida,SP,24669,29344,33247,34904,35903,35043,16918,18125,34534,509,0.04%
3502606,3501,São José do Rio Preto,35001,Jales,Aparecida d'Oeste,SP,7919,5148,5100,4935,4577,4444,2174,2270,3639,805,-1.04%
3502705,3511,Itapetininga,35044,Capão Bonito,Apiaí,SP,19635,26933,35185,27162,25463,25196,12579,12617,18226,6970,-0.75%
3502754,3512,Macro Metropolitana Paulista,35046,Sorocaba,Araçariguama,SP,,,,11154,12291,17085,8705,8380,11284,5801,4.36%
3502804,3503,Araçatuba,35017,Araçatuba,Araçatuba,SP,108512,129307,159557,169254,178839,181618,87337,94281,178118,3500,0.71%
3502903,3512,Macro Metropolitana Paulista,35046,Sorocaba,Araçoiaba da Serra,SP,6557,8539,14544,19816,24022,27323,13601,13722,18807,8516,3.26%
3503000,3502,Ribeirão Preto,35011,Ituverava,Aramina,SP,5042,3446,4064,4763,5019,5150,2587,2563,4811,339,0.78%
3503109,3504,Bauru,35022,Avaré,Arandu,SP,5239,4164,5620,6065,6013,6123,3088,3035,4614,1509,0.10%
3503158,3513,Vale do Paraíba Paulista,35052,Bananal,Arapeí,SP,,,,2618,2527,2492,1254,1238,1874,618,-0.49%
3503208,3505,Araraquara,35024,Araraquara,Araraquara,SP,100438,128122,166731,182471,195815,208725,100733,107992,202802,5923,1.35%
3503307,3506,Piracicaba,35027,Limeira,Araras,SP,53422,65010,87459,104196,108689,118898,58729,60169,112497,6401,1.33%
3503356,3509,Marília,35037,Tupã,Arco-Íris,SP,,,,2163,2003,1925,971,954,1097,828,-1.16%
3503406,3504,Bauru,35020,Bauru,Arealva,SP,6519,6788,6892,7244,7504,7842,3997,3845,6177,1665,0.80%
3503505,3513,Vale do Paraíba Paulista,35052,Bananal,Areias,SP,4107,3706,3284,3600,3571,3693,1829,1864,2475,1218,0.26%
3503604,3504,Bauru,35020,Bauru,Areiópolis,SP,5725,6765,9991,10296,10630,10581,5454,5127,9403,1178,0.27%
3503703,3501,São José do Rio Preto,35005,Catanduva,Ariranha,SP,5094,5538,5845,7477,8255,8547,4366,4181,8094,453,1.35%
3503802,3507,Campinas,35031,Moji Mirim,Artur Nogueira,SP,10171,15932,28053,33124,39457,44270,22123,22147,40026,4244,2.94%
3503901,3515,Metropolitana de São Paulo,35059,Guarulhos,Arujá,SP,9571,17487,37622,59185,72713,74818,36924,37894,71828,2990,2.37%
3503950,3501,São José do Rio Preto,35001,Jales,Aspásia,SP,,,,1861,1790,1809,907,902,1257,552,-0.28%
3504008,3510,Assis,35039,Assis,Assis,SP,57220,67357,85391,87251,92965,95156,46318,48838,91001,4155,0.87%
3504107,3512,Macro Metropolitana Paulista,35048,Bragança Paulista,Atibaia,SP,36838,57820,86336,111300,119166,126614,62217,64397,115266,11348,1.30%
3504206,3501,São José do Rio Preto,35006,Auriflama,Auriflama,SP,13266,12031,12765,13513,13760,14205,7104,7101,12950,1255,0.50%
3504305,3504,Bauru,35020,Bauru,Avaí,SP,5252,5367,4644,4596,4877,4959,2506,2453,3330,1629,0.76%
3504404,3503,Araçatuba,35018,Birigui,Avanhandava,SP,5974,6399,7973,8829,10875,11311,6250,5061,9563,1748,2.51%
3504503,3504,Bauru,35022,Avaré,Avaré,SP,37854,46921,61101,76472,80026,82935,41134,41801,79392,3543,0.81%
3504602,3501,São José do Rio Preto,35004,São José do Rio Preto,Bady Bassitt,SP,2669,2834,5717,11550,13039,14605,7250,7355,13661,944,2.37%
3504701,3504,Bauru,35020,Bauru,Balbinos,SP,1114,1186,1221,1313,3619,3932,3232,700,1191,2741,11.59%
3504800,3501,São José do Rio Preto,35004,São José do Rio Preto,Bálsamo,SP,5746,5720,6771,7340,7767,8160,3998,4162,7474,686,1.06%
3504909,3513,Vale do Paraíba Paulista,35052,Bananal,Bananal,SP,12889,10969,11368,9713,10233,10220,5052,5168,8157,2063,0.51%
3505005,3511,Itapetininga,35041,Itapeva,Barão de Antonina,SP,4345,3950,3028,2794,2751,3116,1591,1525,1913,1203,1.10%
3505104,3503,Araçatuba,35018,Birigui,Barbosa,SP,4871,5587,5379,5837,6454,6593,3323,3270,5575,1018,1.23%
3505203,3504,Bauru,35021,Jaú,Bariri,SP,17497,19894,24542,28224,30995,31603,15822,15781,29985,1618,1.14%
3505302,3504,Bauru,35021,Jaú,Barra Bonita,SP,17328,22594,30841,35487,35090,35256,17256,18000,34517,739,-0.07%
3505351,3511,Itapetininga,35044,Capão Bonito,Barra do Chapéu,SP,,,,4846,5077,5236,2766,2470,1544,3692,0.78%
3505401,3514,Litoral Sul Paulista,35055,Registro,Barra do Turvo,SP,3980,4882,7124,8108,7620,7729,4050,3679,3174,4555,-0.48%
3505500,3502,Ribeirão Preto,35009,Barretos,Barretos,SP,65574,72768,95414,103913,107988,112102,54169,57933,108687,3415,0.76%
3505609,3502,Ribeirão Preto,35014,Ribeirão Preto,Barrinha,SP,8430,12564,18853,24207,25642,28503,14327,14176,28187,316,1.65%
3505708,3515,Metropolitana de São Paulo,35057,Osasco,Barueri,SP,37808,75338,130799,208281,252748,240656,116977,123679,240656,0,1.46%
3505807,3509,Marília,35037,Tupã,Bastos,SP,9657,15343,19116,20588,20613,20461,10040,10421,17624,2837,-0.06%
3505906,3502,Ribeirão Preto,35015,Batatais,Batatais,SP,29262,37283,44106,51112,53525,56481,27749,28732,49954,6527,1.00%
3506003,3504,Bauru,35020,Bauru,Bauru,SP,131936,186659,261112,316064,347601,344039,166692,177347,338891,5148,0.85%
3506102,3502,Ribeirão Preto,35013,Jaboticabal,Bebedouro,SP,37816,46034,67763,74815,74865,75044,36531,38513,71512,3532,0.03%
3506201,3503,Araçatuba,35017,Araçatuba,Bento de Abreu,SP,2529,2037,2397,2394,2740,2674,1364,1310,2444,230,1.11%
3506300,3510,Assis,35040,Ourinhos,Bernardino de Campos,SP,10243,8994,10049,10720,10487,10777,5251,5526,9660,1117,0.05%
3506359,3515,Metropolitana de São Paulo,35063,Santos,Bertioga,SP,,,,30039,39091,47572,23769,23803,46818,754,4.70%
3506409,3503,Araçatuba,35018,Birigui,Bilac,SP,5976,5332,5460,6088,6905,7052,3493,3559,6485,567,1.48%
3506508,3503,Araçatuba,35018,Birigui,Birigui,SP,34976,50893,75125,94300,103394,108722,53086,55636,105481,3241,1.43%
3506607,3515,Metropolitana de São Paulo,35062,Mogi das Cruzes,Biritiba-Mirim,SP,9033,13374,17833,24653,27483,28573,14412,14161,24530,4043,1.49%
3506706,3505,Araraquara,35024,Araraquara,Boa Esperança do Sul,SP,6363,8352,11867,12573,13208,13658,6884,6774,12197,1461,0.83%
3506805,3504,Bauru,35021,Jaú,Bocaina,SP,6896,6774,7254,9442,10299,10862,5411,5451,10009,853,1.41%
3506904,3504,Bauru,35023,Botucatu,Bofete,SP,5327,4446,5666,7356,8565,9282,4731,4551,6121,3161,2.35%
3507001,3511,Itapetininga,35043,Tatuí,Boituva,SP,8976,12573,23140,34368,40783,48323,24319,24004,45457,2866,3.47%
3507100,3512,Macro Metropolitana Paulista,35048,Bragança Paulista,Bom Jesus dos Perdões,SP,3834,7096,9854,13313,16211,19703,9914,9789,17386,2317,4.00%
3507159,3511,Itapetininga,35041,Itapeva,Bom Sucesso de Itararé,SP,,,,3231,3658,3571,1815,1756,2430,1141,1.01%
3507209,3510,Assis,35039,Assis,Borá,SP,1270,866,751,795,804,805,422,383,627,178,0.13%
3507308,3504,Bauru,35021,Jaú,Boracéia,SP,2643,3561,3460,3739,4128,4268,2178,2090,3827,441,1.33%
3507407,3505,Araraquara,35024,Araraquara,Borborema,SP,9530,11635,12109,13193,13752,14532,7352,7180,13098,1434,0.97%
3507456,3504,Bauru,35020,Bauru,Borebi,SP,,,,1933,2172,2295,1144,1151,2002,293,1.73%
3507506,3504,Bauru,35023,Botucatu,Botucatu,SP,51954,64545,90761,108306,120800,127370,61789,65581,122718,4652,1.63%
3507605,3512,Macro Metropolitana Paulista,35048,Bragança Paulista,Bragança Paulista,SP,63676,84050,108980,125031,136286,146663,72034,74629,142174,4489,1.61%
3507704,3503,Araçatuba,35018,Birigui,Braúna,SP,5038,4551,4264,4383,4728,5021,2552,2469,4390,631,1.37%
3507753,3503,Araçatuba,35018,Birigui,Brejo Alegre,SP,,,,2308,2432,2573,1330,1243,2110,463,1.09%
3507803,3502,Ribeirão Preto,35014,Ribeirão Preto,Brodowski,SP,8328,11201,13788,17139,19018,21105,10466,10639,20596,509,2.10%
3507902,3506,Piracicaba,35026,Rio Claro,Brotas,SP,11962,11262,14402,18886,20996,21580,10711,10869,18599,2981,1.34%
3508009,3511,Itapetininga,35041,Itapeva,Buri,SP,8976,11622,14325,17629,17539,18566,9502,9064,14995,3571,0.52%
3508108,3503,Araçatuba,35018,Birigui,Buritama,SP,10019,11564,12766,13854,14735,15418,7732,7686,14526,892,1.08%
3508207,3502,Ribeirão Preto,35011,Ituverava,Buritizal,SP,5569,3868,3797,3674,3872,4055,2074,1981,3310,745,0.99%
3508306,3504,Bauru,35020,Bauru,Cabrália Paulista,SP,3259,3447,3862,4656,4340,4365,2220,2145,3777,588,-0.64%
3508405,3512,Macro Metropolitana Paulista,35046,Sorocaba,Cabreúva,SP,7679,11716,18814,33100,38898,41643,21114,20529,35295,6348,2.32%
3508504,3513,Vale do Paraíba Paulista,35050,São José dos Campos,Caçapava,SP,30712,51353,66058,76130,80458,84844,42040,42804,72619,12225,1.09%
3508603,3513,Vale do Paraíba Paulista,35051,Guaratinguetá,Cachoeira Paulista,SP,17336,20557,23212,27205,31674,30099,14748,15351,24580,5519,1.02%
3508702,3507,Campinas,35030,São João da Boa Vista,Caconde,SP,15248,16418,17283,18378,18552,18536,9285,9251,12633,5903,0.09%
3508801,3504,Bauru,35019,Lins,Cafelândia,SP,17592,17480,15257,15793,16073,16612,8176,8436,14423,2189,0.51%
3508900,3508,Presidente Prudente,35036,Presidente Prudente,Caiabu,SP,7012,3702,3854,4077,4011,4072,2091,1981,3315,757,-0.01%
3509007,3515,Metropolitana de São Paulo,35058,Franco da Rocha,Caieiras,SP,15563,25156,39069,71221,81163,86623,42354,44269,84476,2147,1.98%
3509106,3508,Presidente Prudente,35036,Presidente Prudente,Caiuá,SP,5271,2971,3341,4192,4953,5039,2652,2387,1930,3109,1.86%
3509205,3515,Metropolitana de São Paulo,35057,Osasco,Cajamar,SP,10355,21942,33736,50761,58403,64113,32005,32108,62822,1291,2.36%
3509254,3514,Litoral Sul Paulista,35055,Registro,Cajati,SP,,,,29227,28285,28371,14329,14042,20719,7652,-0.30%
3509304,3501,São José do Rio Preto,35005,Catanduva,Cajobi,SP,6741,8290,11154,9174,9519,9759,5014,4745,9124,635,0.62%
3509403,3502,Ribeirão Preto,35015,Batatais,Cajuru,SP,13725,16240,20246,20777,22695,23378,11700,11678,20802,2576,1.19%
3509452,3511,Itapetininga,35042,Itapetininga,Campina do Monte Alegre,SP,,,,5209,5320,5567,2853,2714,4710,857,0.67%
3509502,3507,Campinas,35032,Campinas,Campinas,SP,375864,664566,847595,969396,1039297,1080999,521209,559790,1062453,18546,1.10%
3509601,3512,Macro Metropolitana Paulista,35047,Jundiaí,Campo Limpo Paulista,SP,9156,21891,45387,63724,69810,74114,36423,37691,74114,0,1.52%
3509700,3513,Vale do Paraíba Paulista,35049,Campos do Jordão,Campos do Jordão,SP,18706,26105,37135,44252,44688,47824,23413,24411,47526,298,0.78%
3509809,3510,Assis,35039,Assis,Campos Novos Paulista,SP,4148,3792,4015,4181,4651,4539,2339,2200,3528,1011,0.82%
3509908,3514,Litoral Sul Paulista,35055,Registro,Cananéia,SP,6080,7734,10144,12298,12039,12226,6134,6092,10436,1790,-0.06%
3509957,3513,Vale do Paraíba Paulista,35051,Guaratinguetá,Canas,SP,,,,3614,4318,4387,2224,2163,4072,315,1.96%
3510005,3510,Assis,35039,Assis,Cândido Mota,SP,23583,19780,25450,29280,29572,29911,14674,15237,28122,1789,0.21%
3510104,3502,Ribeirão Preto,35013,Jaboticabal,Cândido Rodrigues,SP,2243,1991,2328,2613,2655,2668,1315,1353,2153,515,0.21%
3510153,3510,Assis,35040,Ourinhos,Canitar,SP,,,,3481,4265,4369,2216,2153,4138,231,2.30%
3510203,3511,Itapetininga,35044,Capão Bonito,Capão Bonito,SP,30326,45522,52612,46732,45275,46178,23020,23158,37824,8354,-0.12%
3510302,3512,Macro Metropolitana Paulista,35046,Sorocaba,Capela do Alto,SP,4872,7393,10771,14247,15950,17533,9037,8496,14523,3010,2.10%
3510401,3506,Piracicaba,35028,Piracicaba,Capivari,SP,18986,25175,34220,41468,43779,48573,24359,24214,45901,2672,1.59%
3510500,3513,Vale do Paraíba Paulista,35054,Caraguatatuba,Caraguatatuba,SP,15073,33802,52878,78921,88815,100899,49984,50915,97449,3450,2.49%
3510609,3515,Metropolitana de São Paulo,35057,Osasco,Carapicuíba,SP,54873,185822,283661,344596,379566,369908,179353,190555,369908,0,0.71%
3510708,3501,São José do Rio Preto,35003,Votuporanga,Cardoso,SP,17296,12013,12282,11605,11324,11798,5828,5970,10723,1075,0.17%
3510807,3507,Campinas,35030,São João da Boa Vista,Casa Branca,SP,18170,21744,25308,26800,27081,28312,14998,13314,23156,5156,0.55%
3510906,3502,Ribeirão Preto,35015,Batatais,Cássia dos Coqueiros,SP,2568,2516,2719,2871,2706,2627,1332,1295,1790,837,-0.88%
3511003,3503,Araçatuba,35016,Andradina,Castilho,SP,15329,12247,14608,14948,15410,18006,8975,9031,13592,4414,1.88%
3511102,3501,São José do Rio Preto,35005,Catanduva,Catanduva,SP,58251,72865,93317,105847,109362,112843,54777,58066,111937,906,0.64%
3511201,3501,São José do Rio Preto,35005,Catanduva,Catiguá,SP,5244,5682,6261,6555,6870,7127,3633,3494,6569,558,0.84%
3511300,3501,São José do Rio Preto,35004,São José do Rio Preto,Cedral,SP,6527,6203,5704,6700,7607,7968,3974,3994,6303,1665,1.75%
3511409,3504,Bauru,35022,Avaré,Cerqueira César,SP,9564,10726,12852,15144,16276,17532,8673,8859,15716,1816,1.48%
3511508,3511,Itapetininga,35043,Tatuí,Cerquilho,SP,6960,12341,20048,29508,34769,39649,19653,19996,37599,2050,3.00%
3511607,3511,Itapetininga,35043,Tatuí,Cesário Lange,SP,5755,7855,11153,12883,14005,15547,8059,7488,10495,5052,1.90%
3511706,3506,Piracicaba,35028,Piracicaba,Charqueada,SP,7924,8898,10735,13037,14356,15086,7684,7402,13689,1397,1.47%
3511904,3503,Araçatuba,35018,Birigui,Clementina,SP,5247,4298,4883,5404,6081,7064,3661,3403,6733,331,2.71%
3512001,3502,Ribeirão Preto,35009,Barretos,Colina,SP,11650,11607,15909,16664,16989,17373,8629,8744,16225,1148,0.42%
3512100,3502,Ribeirão Preto,35009,Barretos,Colômbia,SP,4224,3372,5282,5954,6073,5994,3066,2928,4332,1662,0.07%
3512209,3506,Piracicaba,35027,Limeira,Conchal,SP,7833,13034,19272,22676,23352,25242,12765,12477,23858,1384,1.08%
3512308,3504,Bauru,35023,Botucatu,Conchas,SP,10046,11038,11890,14904,15473,16302,8183,8119,13203,3099,0.90%
3512407,3506,Piracicaba,35027,Limeira,Cordeirópolis,SP,7970,9379,13338,17591,19309,21085,10599,10486,18936,2149,1.83%
3512506,3503,Araçatuba,35018,Birigui,Coroados,SP,6592,5648,6009,4417,4881,5238,2610,2628,4242,996,1.72%
3512605,3511,Itapetininga,35041,Itapeva,Coronel Macedo,SP,5782,6344,5750,5589,5277,5001,2565,2436,3865,1136,-1.11%
3512704,3506,Piracicaba,35026,Rio Claro,Corumbataí,SP,2842,2784,3156,3794,3935,3874,1974,1900,2093,1781,0.21%
3512803,3507,Campinas,35032,Campinas,Cosmópolis,SP,12110,23243,36684,44355,53561,58821,29411,29410,54629,4192,2.86%
3512902,3501,São José do Rio Preto,35003,Votuporanga,Cosmorama,SP,10231,8638,7830,7372,6951,7214,3652,3562,4945,2269,-0.22%
3513009,3515,Metropolitana de São Paulo,35060,Itapecerica da Serra,Cotia,SP,30924,62948,107453,148987,172823,201023,98372,102651,201023,0,3.04%
3513108,3502,Ribeirão Preto,35014,Ribeirão Preto,Cravinhos,SP,14230,16935,22561,28411,29377,31688,15887,15801,30891,797,1.10%
3513207,3502,Ribeirão Preto,35012,Franca,Cristais Paulista,SP,4974,4903,5649,6579,7005,7591,3877,3714,5531,2060,1.44%
3513306,3510,Assis,35039,Assis,Cruzália,SP,7478,4734,5251,2610,2368,2270,1106,1164,1502,768,-1.39%
3513405,3513,Vale do Paraíba Paulista,35051,Guaratinguetá,Cruzeiro,SP,45672,57993,68643,73492,76098,77070,37516,39554,75107,1963,0.48%
3513504,3515,Metropolitana de São Paulo,35063,Santos,Cubatão,SP,50906,78631,91136,108309,120271,118797,59246,59551,118797,0,0.93%
3513603,3513,Vale do Paraíba Paulista,35053,Paraibuna/Paraitinga,Cunha,SP,21952,20866,23462,23090,22951,21874,11171,10703,12171,9703,-0.54%
3513702,3505,Araraquara,35025,São Carlos,Descalvado,SP,15510,20333,25750,28921,29533,31053,15329,15724,27702,3351,0.71%
3513801,3515,Metropolitana de São Paulo,35061,São Paulo,Diadema,SP,78914,228663,305287,357064,386779,386039,186752,199287,386039,0,0.78%
3513850,3501,São José do Rio Preto,35001,Jales,Dirce Reis,SP,,,,1623,1582,1689,875,814,1279,410,0.40%
3513900,3507,Campinas,35030,São João da Boa Vista,Divinolândia,SP,12363,10266,11811,12016,11246,11209,5588,5621,7500,3709,-0.69%
3514007,3505,Araraquara,35024,Araraquara,Dobrada,SP,2773,4377,6920,7007,7664,7941,4116,3825,7764,177,1.26%
3514106,3504,Bauru,35021,Jaú,Dois Córregos,SP,13417,15482,18838,22522,24384,24768,12420,12348,23453,1315,0.96%
3514205,3501,São José do Rio Preto,35001,Jales,Dolcinópolis,SP,3265,2209,2094,2152,2181,2096,1091,1005,1949,147,-0.26%
3514304,3505,Araraquara,35025,São Carlos,Dourado,SP,5634,6558,7743,8606,8751,8607,4363,4244,7867,740,0.00%
3514403,3508,Presidente Prudente,35034,Dracena,Dracena,SP,35347,35973,39693,40500,42107,43263,21406,21857,39946,3317,0.66%
3514502,3504,Bauru,35020,Bauru,Duartina,SP,10840,12184,11897,12475,12381,12251,5970,6281,10997,1254,-0.18%
3514601,3502,Ribeirão Preto,35014,Ribeirão Preto,Dumont,SP,3054,3311,4980,6307,7557,8143,4096,4047,7854,289,2.59%
3514700,3509,Marília,35038,Marília,Echaporã,SP,7684,5685,6318,6827,6247,6318,3115,3203,5032,1286,-0.77%
3514809,3514,Litoral Sul Paulista,35055,Registro,Eldorado,SP,10845,11299,13120,14134,14038,14645,7479,7166,7209,7436,0.36%
3514908,3507,Campinas,35032,Campinas,Elias Fausto,SP,6151,8293,11632,13888,14521,15796,8169,7627,12577,3219,1.30%
3514924,3501,São José do Rio Preto,35005,Catanduva,Elisiário,SP,,,,2577,3024,3120,1650,1470,2858,262,1.93%
3514957,3501,São José do Rio Preto,35005,Catanduva,Embaúba,SP,,,,2478,2391,2423,1259,1164,2060,363,-0.22%
3515004,3515,Metropolitana de São Paulo,35060,Itapecerica da Serra,Embu,SP,18141,95800,155990,207663,237318,240007,116572,123435,240007,0,1.46%
3515103,3515,Metropolitana de São Paulo,35060,Itapecerica da Serra,Embu-Guaçu,SP,10280,21038,36277,56916,59083,62846,31178,31668,61180,1666,1.00%
3515129,3508,Presidente Prudente,35036,Presidente Prudente,Emilianópolis,SP,,,,2893,3021,3024,1519,1505,2497,527,0.44%
3515152,3507,Campinas,35031,Moji Mirim,Engenheiro Coelho,SP,,,,10033,12729,15719,8232,7487,11499,4220,4.59%
3515186,3507,Campinas,35030,São João da Boa Vista,Espírito Santo do Pinhal,SP,27299,33359,37178,40480,40684,41919,20513,21406,37254,4665,0.35%
3515194,3510,Assis,35040,Ourinhos,Espírito Santo do Turvo,SP,,,,3677,4103,4246,2146,2100,3632,614,1.45%
3515202,3501,São José do Rio Preto,35002,Fernandópolis,Estrela d'Oeste,SP,10873,9017,8493,8256,8590,8208,4133,4075,6831,1377,-0.06%
3515301,3508,Presidente Prudente,35036,Presidente Prudente,Estrela do Norte,SP,3322,3290,2777,2625,2454,2661,1369,1292,2102,559,0.14%
3515350,3508,Presidente Prudente,35036,Presidente Prudente,Euclides da Cunha Paulista,SP,,,,10214,9923,9585,4835,4750,6111,3474,-0.63%
3515400,3510,Assis,35040,Ourinhos,Fartura,SP,12477,12817,14333,15010,14601,15324,7428,7896,12242,3082,0.21%
3515509,3501,São José do Rio Preto,35002,Fernandópolis,Fernandópolis,SP,39050,46996,56144,61647,61392,64707,31517,33190,62725,1982,0.49%
3515608,3502,Ribeirão Preto,35013,Jaboticabal,Fernando Prestes,SP,4417,4423,5175,5434,5212,5534,2726,2808,4698,836,0.18%
3515657,3509,Marília,35038,Marília,Fernão,SP,,,,1432,1457,1563,794,769,850,713,0.88%
3515707,3515,Metropolitana de São Paulo,35062,Mogi das Cruzes,Ferraz de Vasconcelos,SP,25134,55046,96166,142377,168897,168290,82165,86125,160751,7539,1.69%
3515806,3508,Presidente Prudente,35035,Adamantina,Flora Rica,SP,4561,2740,2380,2177,2019,1752,880,872,1418,334,-2.15%
3515905,3501,São José do Rio Preto,35006,Auriflama,Floreal,SP,4683,3588,3547,3223,2907,3003,1496,1507,2439,564,-0.70%
3516002,3508,Presidente Prudente,35035,Adamantina,Flórida Paulista,SP,17741,15180,12510,11106,12660,12849,7056,5793,10138,2711,1.47%
3516101,3510,Assis,35039,Assis,Florínia,SP,5649,2744,3012,3127,2860,2829,1383,1446,2512,317,-1.00%
3516200,3502,Ribeirão Preto,35012,Franca,Franca,SP,93638,148990,233098,287737,319094,318785,155539,163246,313128,5657,1.03%
3516309,3515,Metropolitana de São Paulo,35058,Franco da Rocha,Francisco Morato,SP,11231,28537,83885,133738,146634,154538,76657,77881,154224,314,1.46%
3516408,3515,Metropolitana de São Paulo,35058,Franco da Rocha,Franco da Rocha,SP,36303,50794,85535,108122,121451,131603,67455,64148,121233,10370,1.98%
3516507,3503,Araçatuba,35018,Birigui,Gabriel Monteiro,SP,3344,3009,2472,2726,2638,2705,1373,1332,2254,451,-0.08%
3516606,3509,Marília,35038,Marília,Gália,SP,12628,11797,10497,7853,6812,7011,3506,3505,5225,1786,-1.13%
3516705,3509,Marília,35038,Marília,Garça,SP,37358,39926,41492,43162,42218,43124,20975,22149,39198,3926,-0.01%
3516804,3501,São José do Rio Preto,35006,Auriflama,Gastão Vidigal,SP,4423,3784,3834,3586,3863,4193,2298,1895,3756,437,1.58%
3516853,3505,Araraquara,35024,Araraquara,Gavião Peixoto,SP,,,,4126,4103,4420,2286,2134,3575,845,0.69%
3516903,3501,São José do Rio Preto,35006,Auriflama,General Salgado,SP,16591,11516,12911,10824,10626,10674,5355,5319,9089,1585,-0.14%
3517000,3504,Bauru,35019,Lins,Getulina,SP,12067,11054,10121,10370,10515,10777,5872,4905,8339,2438,0.39%
3517109,3503,Araçatuba,35018,Birigui,Glicério,SP,5153,4926,4234,4428,4398,4577,2296,2281,3366,1211,0.33%
3517208,3504,Bauru,35019,Lins,Guaiçara,SP,5174,5354,6366,9211,10357,10671,5368,5303,9698,973,1.48%
3517307,3504,Bauru,35019,Lins,Guaimbê,SP,5037,5164,5138,5207,4752,5425,2697,2728,4740,685,0.41%
3517406,3502,Ribeirão Preto,35010,São Joaquim da Barra,Guaíra,SP,26883,25673,31071,34610,36544,37412,18524,18888,36067,1345,0.78%
3517505,3501,São José do Rio Preto,35004,São José do Rio Preto,Guapiaçu,SP,5193,6758,10660,14086,16392,17885,9037,8848,15818,2067,2.42%
3517604,3511,Itapetininga,35044,Capão Bonito,Guapiara,SP,14224,16046,18281,19726,20056,17988,9150,8838,7230,10758,-0.92%
3517703,3502,Ribeirão Preto,35011,Ituverava,Guará,SP,12765,13327,16362,18916,18611,19864,9888,9976,19229,635,0.49%
3517802,3503,Araçatuba,35016,Andradina,Guaraçaí,SP,10239,8399,8294,8894,8505,8435,4191,4244,6655,1780,-0.53%
3517901,3501,São José do Rio Preto,35004,São José do Rio Preto,Guaraci,SP,7377,6467,7813,8846,9045,9976,5084,4892,8927,1049,1.21%
3518008,3501,São José do Rio Preto,35002,Fernandópolis,Guarani d'Oeste,SP,7966,8300,6779,2006,1963,1969,963,1006,1734,235,-0.19%
3518107,3504,Bauru,35020,Bauru,Guarantã,SP,5771,5716,5538,6323,6410,6400,3210,3190,5459,941,0.12%
3518206,3503,Araçatuba,35017,Araçatuba,Guararapes,SP,23324,22515,26689,28843,28662,30600,15092,15508,28326,2274,0.59%
3518305,3515,Metropolitana de São Paulo,35062,Mogi das Cruzes,Guararema,SP,12638,15105,17961,21904,24854,25861,13009,12852,22251,3610,1.67%
3518404,3513,Vale do Paraíba Paulista,35051,Guaratinguetá,Guaratinguetá,SP,68869,84864,102072,104219,107895,112091,53948,58143,106782,5309,0.73%
3518503,3511,Itapetininga,35042,Itapetininga,Guareí,SP,7509,6926,8470,10197,13202,14568,8929,5639,8413,6155,3.63%
3518602,3502,Ribeirão Preto,35013,Jaboticabal,Guariba,SP,11448,18887,28911,31085,32664,35491,17914,17577,34753,738,1.33%
3518701,3515,Metropolitana de São Paulo,35063,Santos,Guarujá,SP,94021,151120,210207,264812,296150,290607,141474,149133,290556,51,0.93%
3518800,3515,Metropolitana de São Paulo,35059,Guarulhos,Guarulhos,SP,236811,532724,787866,1072717,1236192,1222357,595403,626954,1222357,0,1.31%
3518859,3502,Ribeirão Preto,35014,Ribeirão Preto,Guatapará,SP,,,,6371,6217,6966,3579,3387,5116,1850,0.90%
3518909,3501,São José do Rio Preto,35006,Auriflama,Guzolândia,SP,7605,4306,5052,4295,4616,4754,2436,2318,4021,733,1.02%
3519006,3509,Marília,35037,Tupã,Herculândia,SP,7587,7098,7036,7992,8573,8696,4351,4345,7921,775,0.85%
3519055,3507,Campinas,35032,Campinas,Holambra,SP,,,,7211,9111,11292,5723,5569,8182,3110,4.59%
3519071,3507,Campinas,35032,Campinas,Hortolândia,SP,,,,152523,190781,192225,97241,94984,192225,0,2.34%
3519105,3504,Bauru,35020,Bauru,Iacanga,SP,7171,6624,7567,8282,9074,10010,5162,4848,8723,1287,1.91%
3519204,3509,Marília,35037,Tupã,Iacri,SP,8150,9199,7038,6783,6677,6419,3249,3170,5050,1369,-0.55%
3519253,3504,Bauru,35022,Avaré,Iaras,SP,,,,3054,4777,6377,4197,2180,2837,3540,7.64%
3519303,3505,Araraquara,35025,São Carlos,Ibaté,SP,7475,11448,18827,26462,28040,30724,15808,14916,29505,1219,1.50%
3519402,3501,São José do Rio Preto,35004,São José do Rio Preto,Ibirá,SP,7286,8260,8713,9447,10379,10868,5407,5461,10028,840,1.41%
3519501,3510,Assis,35039,Assis,Ibirarema,SP,5507,4841,5523,5701,6617,6725,3393,3332,6212,513,1.67%
3519600,3505,Araraquara,35024,Araraquara,Ibitinga,SP,23968,29141,38242,46620,49951,53166,26217,26949,51065,2101,1.32%
3519709,3512,Macro Metropolitana Paulista,35045,Piedade,Ibiúna,SP,24391,31826,49187,64384,64832,71228,36206,35022,24950,46278,1.02%
3519808,3501,São José do Rio Preto,35004,São José do Rio Preto,Icém,SP,5981,5187,6100,6772,6429,7462,3795,3667,6404,1058,0.97%
3519907,3510,Assis,35039,Assis,Iepê,SP,12586,9360,10013,7257,7487,7627,3780,3847,6775,852,0.50%
3520004,3504,Bauru,35021,Jaú,Igaraçu do Tietê,SP,8861,12730,20869,22614,23085,23370,11656,11714,23236,134,0.33%
3520103,3502,Ribeirão Preto,35011,Ituverava,Igarapava,SP,21202,20261,22324,25925,26862,27960,13844,14116,26370,1590,0.76%
3520202,3513,Vale do Paraíba Paulista,35050,São José dos Campos,Igaratá,SP,3686,4394,6292,8292,8537,8825,4524,4301,6991,1834,0.62%
3520301,3514,Litoral Sul Paulista,35055,Registro,Iguape,SP,19211,23363,27937,27427,28977,28844,14465,14379,24698,4146,0.51%
3520400,3513,Vale do Paraíba Paulista,35054,Caraguatatuba,Ilhabela,SP,5707,7800,13538,20836,23886,28176,14324,13852,27982,194,3.06%
3520426,3514,Litoral Sul Paulista,35055,Registro,Ilha Comprida,SP,,,,6704,8875,9027,4476,4551,9027,0,3.02%
3520442,3503,Araçatuba,35016,Andradina,Ilha Solteira,SP,,,,23996,24181,25071,12201,12870,23523,1548,0.44%
3520509,3507,Campinas,35032,Campinas,Indaiatuba,SP,30537,56243,100948,147050,173508,201848,100352,101496,199835,2013,3.22%
3520608,3508,Presidente Prudente,35036,Presidente Prudente,Indiana,SP,5156,4372,4622,4932,4682,4828,2422,2406,4126,702,-0.21%
3520707,3501,São José do Rio Preto,35002,Fernandópolis,Indiaporã,SP,5842,6547,4767,4058,3880,3906,1925,1981,3382,524,-0.38%
3520806,3508,Presidente Prudente,35035,Adamantina,Inúbia Paulista,SP,5238,4290,3355,3318,3595,3630,1821,1809,3177,453,0.90%
3520905,3510,Assis,35040,Ourinhos,Ipaussu,SP,12122,10227,11406,12553,12964,13746,6941,6805,12666,1080,0.91%
3521002,3512,Macro Metropolitana Paulista,35046,Sorocaba,Iperó,SP,6439,6606,10575,18384,24239,28301,15220,13081,17470,10831,4.41%
3521101,3506,Piracicaba,35026,Rio Claro,Ipeúna,SP,2097,1854,2698,4340,5164,6016,3109,2907,5178,838,3.32%
3521150,3501,São José do Rio Preto,35004,São José do Rio Preto,Ipiguá,SP,,,,3476,3925,4459,2265,2194,2690,1769,2.52%
3521200,3511,Itapetininga,35044,Capão Bonito,Iporanga,SP,3917,4724,4614,4562,4603,4302,2170,2132,2401,1901,-0.59%
3521309,3502,Ribeirão Preto,35010,São Joaquim da Barra,Ipuã,SP,9977,9137,10356,11870,14344,14146,7208,6938,13560,586,1.77%
3521408,3506,Piracicaba,35027,Limeira,Iracemápolis,SP,6907,8283,11752,15555,18026,20047,10059,9988,19632,415,2.57%
3521507,3501,São José do Rio Preto,35008,Novo Horizonte,Irapuã,SP,6081,7199,6092,6658,6710,7284,3808,3476,6489,795,0.90%
3521606,3508,Presidente Prudente,35035,Adamantina,Irapuru,SP,12058,9743,8257,7457,7556,7787,4531,3256,5505,2282,0.43%
3521705,3511,Itapetininga,35041,Itapeva,Itaberá,SP,14585,16399,17899,18911,17576,17861,9015,8846,12140,5721,-0.57%
3521804,3504,Bauru,35022,Avaré,Itaí,SP,13470,14553,17822,21039,22617,24015,12764,11251,18858,5157,1.33%
3521903,3501,São José do Rio Preto,35008,Novo Horizonte,Itajobi,SP,11579,14503,15014,14230,14182,14553,7350,7203,12143,2410,0.22%
3522000,3504,Bauru,35021,Jaú,Itaju,SP,3236,2495,2359,2638,2624,3263,1711,1552,2378,885,2.15%
3522109,3514,Litoral Sul Paulista,35056,Itanhaém,Itanhaém,SP,14515,27464,46074,71995,80778,87053,42189,44864,86238,815,1.92%
3522158,3511,Itapetininga,35044,Capão Bonito,Itaóca,SP,,,,3226,3087,3228,1687,1541,1760,1468,0.01%
3522208,3515,Metropolitana de São Paulo,35060,Itapecerica da Serra,Itapecerica da Serra,SP,25314,60473,93146,129685,148728,152380,76213,76167,151127,1253,1.63%
3522307,3511,Itapetininga,35042,Itapetininga,Itapetininga,SP,63606,84381,105132,125559,138450,144416,72202,72214,131051,13365,1.41%
3522406,3511,Itapetininga,35041,Itapeva,Itapeva,SP,49122,65546,81858,82866,85537,87765,43242,44523,73964,13801,0.58%
3522505,3515,Metropolitana de São Paulo,35057,Osasco,Itapevi,SP,27569,53442,107976,162433,193686,200874,98843,102031,200874,0,2.15%
3522604,3507,Campinas,35031,Moji Mirim,Itapira,SP,39036,47923,56586,63377,68187,68365,33862,34503,63405,4960,0.76%
3522653,3511,Itapetininga,35044,Capão Bonito,Itapirapuã Paulista,SP,,,,3577,3723,3884,2003,1881,1895,1989,0.83%
3522703,3505,Araraquara,35024,Araraquara,Itápolis,SP,20711,25981,33053,37750,38633,40064,19872,20192,36338,3726,0.60%
3522802,3511,Itapetininga,35041,Itapeva,Itaporanga,SP,14600,16456,14412,14354,14284,14546,7279,7267,11033,3513,0.13%
3522901,3504,Bauru,35021,Jaú,Itapuí,SP,6728,7613,9051,10371,11605,12181,6155,6026,11638,543,1.62%
3523008,3503,Araçatuba,35016,Andradina,Itapura,SP,4273,3179,3754,3838,3812,4360,2257,2103,3484,876,1.28%
3523107,3515,Metropolitana de São Paulo,35062,Mogi das Cruzes,Itaquaquecetuba,SP,29114,73068,164957,272942,334914,321854,158597,163257,321854,0,1.66%
3523206,3511,Itapetininga,35041,Itapeva,Itararé,SP,30507,37763,44167,46554,48732,47939,23524,24415,44275,3664,0.29%
3523305,3514,Litoral Sul Paulista,35056,Itanhaém,Itariri,SP,7315,9448,11608,13613,15115,15471,7794,7677,9879,5592,1.29%
3523404,3512,Macro Metropolitana Paulista,35048,Bragança Paulista,Itatiba,SP,28376,41630,61645,81197,91479,101450,50115,51335,85640,15810,2.25%
3523503,3504,Bauru,35022,Avaré,Itatinga,SP,9486,9218,13769,15446,17570,18052,9230,8822,16420,1632,1.57%
3523602,3506,Piracicaba,35026,Rio Claro,Itirapina,SP,6968,6929,9953,12836,13889,15528,9158,6370,14004,1524,1.92%
3523701,3502,Ribeirão Preto,35012,Franca,Itirapuã,SP,4684,4916,5043,5412,5614,5914,3013,2901,4929,985,0.89%
3523800,3507,Campinas,35030,São João da Boa Vista,Itobi,SP,5497,5762,6783,7466,7444,7545,3907,3638,6795,750,0.11%
3523909,3512,Macro Metropolitana Paulista,35046,Sorocaba,Itu,SP,49091,74203,107314,135366,147157,154200,76243,77957,144336,9864,1.31%
3524006,3512,Macro Metropolitana Paulista,35047,Jundiaí,Itupeva,SP,7095,10189,18142,26166,36766,44825,22773,22052,38941,5884,5.53%
3524105,3502,Ribeirão Preto,35011,Ituverava,Ituverava,SP,27380,27501,33003,36268,38539,38699,18875,19824,36431,2268,0.65%
3524204,3502,Ribeirão Preto,35010,São Joaquim da Barra,Jaborandi,SP,5792,5463,6336,6424,6462,6592,3338,3254,6166,426,0.26%
3524303,3502,Ribeirão Preto,35013,Jaboticabal,Jaboticabal,SP,38779,46981,59133,67408,69624,71667,34797,36870,69532,2135,0.61%
3524402,3513,Vale do Paraíba Paulista,35050,São José dos Campos,Jacareí,SP,61216,115738,163869,191291,207028,211308,103135,108173,208389,2919,1.00%
3524501,3501,São José do Rio Preto,35004,São José do Rio Preto,Jaci,SP,4000,3801,3237,4117,5008,5657,2892,2765,4871,786,3.23%
3524600,3514,Litoral Sul Paulista,35055,Registro,Jacupiranga,SP,16270,28558,38076,17041,16112,17196,8771,8425,9357,7839,0.09%
3524709,3507,Campinas,35032,Campinas,Jaguariúna,SP,10391,15213,24999,29597,36804,44331,22023,22308,43047,1284,4.12%
3524808,3501,São José do Rio Preto,35001,Jales,Jales,SP,38436,38601,45956,46186,47649,47012,22986,24026,44239,2773,0.18%
3524907,3513,Vale do Paraíba Paulista,35053,Paraibuna/Paraitinga,Jambeiro,SP,2857,2872,3285,3992,4968,5350,2768,2582,2561,2789,2.97%
3525003,3515,Metropolitana de São Paulo,35057,Osasco,Jandira,SP,12499,36043,62697,91807,103531,108436,53105,55331,108436,0,1.68%
3525102,3502,Ribeirão Preto,35014,Ribeirão Preto,Jardinópolis,SP,16992,19668,24123,30729,34611,37725,18975,18750,36201,1524,2.07%
3525201,3512,Macro Metropolitana Paulista,35048,Bragança Paulista,Jarinu,SP,5143,6238,10878,17041,20606,23827,11997,11830,18420,5407,3.41%
3525300,3504,Bauru,35021,Jaú,Jaú,SP,56301,74012,94116,112104,125469,131068,64222,66846,126971,4097,1.58%
3525409,3502,Ribeirão Preto,35012,Franca,Jeriquara,SP,1709,2564,3249,3280,3153,3168,1627,1541,2614,554,-0.35%
3525508,3512,Macro Metropolitana Paulista,35048,Bragança Paulista,Joanópolis,SP,7362,7754,8186,10409,10671,11771,5933,5838,11771,0,1.24%
3525607,3508,Presidente Prudente,35036,Presidente Prudente,João Ramalho,SP,2797,2850,3056,3842,4092,4138,2093,2045,3534,604,0.74%
3525706,3501,São José do Rio Preto,35004,São José do Rio Preto,José Bonifácio,SP,20738,22968,26488,28714,30639,32774,16365,16409,29695,3079,1.33%
3525805,3504,Bauru,35019,Lins,Júlio Mesquita,SP,4661,4590,3843,4166,4318,4430,2179,2251,4214,216,0.62%
3525854,3506,Piracicaba,35028,Piracicaba,Jumirim,SP,,,,2196,2205,2801,1445,1356,1629,1172,2.46%
3525904,3512,Macro Metropolitana Paulista,35047,Jundiaí,Jundiaí,SP,169076,258809,289269,323397,342983,370251,180102,190149,354301,15950,1.36%
3526001,3508,Presidente Prudente,35034,Dracena,Junqueirópolis,SP,22638,21373,17708,17005,18628,18726,9921,8805,15399,3327,0.97%
3526100,3514,Litoral Sul Paulista,35055,Registro,Juquiá,SP,12649,15161,16954,20516,19352,19269,9753,9516,12144,7125,-0.63%
3526209,3515,Metropolitana de São Paulo,35060,Itapecerica da Serra,Juquitiba,SP,7267,12497,19969,26459,27777,28732,14533,14199,22240,6492,0.83%
3526308,3513,Vale do Paraíba Paulista,35053,Paraibuna/Paraitinga,Lagoinha,SP,5590,4441,4635,4957,4798,4840,2479,2361,3137,1703,-0.24%
3526407,3511,Itapetininga,35043,Tatuí,Laranjal Paulista,SP,13107,15172,19144,22145,24454,25246,12461,12785,22602,2644,1.32%
3526506,3503,Araçatuba,35017,Araçatuba,Lavínia,SP,8372,6159,5437,5131,7984,8782,6188,2594,4287,4495,5.52%
3526605,3513,Vale do Paraíba Paulista,35051,Guaratinguetá,Lavrinhas,SP,3047,3674,4674,6008,6543,6586,3317,3269,6045,541,0.92%
3526704,3506,Piracicaba,35027,Limeira,Leme,SP,31229,46253,68215,80757,84406,91804,46054,45750,89902,1902,1.29%
3526803,3504,Bauru,35020,Bauru,Lençóis Paulista,SP,22423,35011,46246,55042,59366,61454,30498,30956,60077,1377,1.11%
3526902,3506,Piracicaba,35027,Limeira,Limeira,SP,90963,150561,207770,249046,272734,276010,135637,140373,267775,8235,1.03%
3527009,3507,Campinas,35033,Amparo,Lindóia,SP,2242,3213,4118,5331,5657,6708,3327,3381,6708,0,2.32%
3527108,3504,Bauru,35019,Lins,Lins,SP,45555,51038,58606,65952,69279,71493,34718,36775,70658,835,0.81%
3527207,3513,Vale do Paraíba Paulista,35051,Guaratinguetá,Lorena,SP,46463,57369,73146,77990,79317,82553,39869,42684,80182,2371,0.57%
3527256,3503,Araçatuba,35018,Birigui,Lourdes,SP,,,,2007,1974,2123,1104,1019,1744,379,0.56%
3527306,3512,Macro Metropolitana Paulista,35047,Jundiaí,Louveira,SP,6430,10322,16259,23903,29760,37153,18814,18339,35743,1410,4.51%
3527405,3508,Presidente Prudente,35035,Adamantina,Lucélia,SP,20472,18709,19286,18316,19212,19885,10560,9325,17222,2663,0.83%
3527504,3504,Bauru,35020,Bauru,Lucianópolis,SP,2213,2624,2354,2154,2299,2255,1123,1132,1789,466,0.46%
3527603,3502,Ribeirão Preto,35014,Ribeirão Preto,Luís Antônio,SP,3083,2926,5840,7160,10272,11286,5832,5454,10901,385,4.66%
3527702,3503,Araçatuba,35018,Birigui,Luiziânia,SP,4461,3865,4157,4274,4763,5030,2612,2418,4611,419,1.64%
3527801,3509,Marília,35038,Marília,Lupércio,SP,4588,3492,4082,4230,4238,4353,2121,2232,3865,488,0.29%
3527900,3510,Assis,35039,Assis,Lutécia,SP,4416,2997,2640,2897,2794,2703,1346,1357,2150,553,-0.69%
3528007,3504,Bauru,35021,Jaú,Macatuba,SP,7729,10859,13468,15752,16173,16246,8147,8099,15763,483,0.31%
3528106,3501,São José do Rio Preto,35007,Nhandeara,Macaubal,SP,6996,6387,7380,7385,7396,7663,3880,3783,6773,890,0.37%
3528205,3501,São José do Rio Preto,35002,Fernandópolis,Macedônia,SP,5475,4215,3956,3761,3411,3664,1837,1827,2777,887,-0.26%
3528304,3501,São José do Rio Preto,35006,Auriflama,Magda,SP,4217,3571,3679,3421,3154,3200,1651,1549,2655,545,-0.67%
3528403,3512,Macro Metropolitana Paulista,35046,Sorocaba,Mairinque,SP,18858,30828,43205,39975,41508,43225,21524,21701,34702,8523,0.78%
3528502,3515,Metropolitana de São Paulo,35058,Franco da Rocha,Mairiporã,SP,19584,27540,39937,60111,71754,80920,40937,39983,70659,10261,3.02%
3528601,3510,Assis,35040,Ourinhos,Manduri,SP,5083,5361,7277,8271,8651,8999,4523,4476,7785,1214,0.85%
3528700,3508,Presidente Prudente,35036,Presidente Prudente,Marabá Paulista,SP,7041,3863,3494,3699,5193,4812,3048,1764,2142,2670,2.67%
3528809,3510,Assis,35039,Assis,Maracaí,SP,11454,10054,12467,13004,13163,13344,6670,6674,12098,1246,0.26%
3528858,3501,São José do Rio Preto,35008,Novo Horizonte,Marapoama,SP,,,,2238,2556,2633,1345,1288,2203,430,1.64%
3528908,3508,Presidente Prudente,35035,Adamantina,Mariápolis,SP,7543,5326,4352,3854,3786,3916,2021,1895,3137,779,0.16%
3529005,3509,Marília,35038,Marília,Marília,SP,98176,121768,161149,197342,218113,216684,104694,111990,207737,8947,0.94%
3529104,3501,São José do Rio Preto,35001,Jales,Marinópolis,SP,2701,2072,2088,2195,2114,2113,1063,1050,1671,442,-0.38%
3529203,3508,Presidente Prudente,35036,Presidente Prudente,Martinópolis,SP,23072,19650,19673,22346,23983,24260,12618,11642,20379,3881,0.83%
3529302,3505,Araraquara,35024,Araraquara,Matão,SP,21953,38133,63613,71753,74407,76799,38038,38761,75386,1413,0.68%
3529401,3515,Metropolitana de São Paulo,35061,São Paulo,Mauá,SP,101700,205736,294998,363392,402643,417281,204180,213101,417281,0,1.39%
3529500,3501,São José do Rio Preto,35004,São José do Rio Preto,Mendonça,SP,4205,3999,3501,3759,3980,4640,2357,2283,3793,847,2.13%
3529609,3501,São José do Rio Preto,35002,Fernandópolis,Meridiano,SP,5795,3771,3784,4025,3857,3851,1890,1961,2676,1175,-0.44%
3529658,3501,São José do Rio Preto,35001,Jales,Mesópolis,SP,,,,1930,1768,1886,957,929,1468,418,-0.23%
3529708,3502,Ribeirão Preto,35010,São Joaquim da Barra,Miguelópolis,SP,18396,13537,17407,19019,19972,20442,10202,10240,19269,1173,0.72%
3529807,3504,Bauru,35021,Jaú,Mineiros do Tietê,SP,5096,6708,9467,11410,11760,12042,5993,6049,11504,538,0.54%
3529906,3514,Litoral Sul Paulista,35055,Registro,Miracatu,SP,14138,17359,18970,22383,22796,20595,10414,10181,10586,10009,-0.83%
3530003,3501,São José do Rio Preto,35002,Fernandópolis,Mira Estrela,SP,4084,2439,2667,2596,2576,2827,1406,1421,1881,946,0.86%
3530102,3503,Araçatuba,35016,Andradina,Mirandópolis,SP,23549,21522,24433,25936,25849,27475,15052,12423,24455,3020,0.58%
3530201,3508,Presidente Prudente,35036,Presidente Prudente,Mirante do Paranapanema,SP,21909,15459,15179,16213,17128,17064,8665,8399,10047,7017,0.51%
3530300,3501,São José do Rio Preto,35004,São José do Rio Preto,Mirassol,SP,20579,28309,39286,48327,51660,53809,26419,27390,52458,1351,1.08%
3530409,3501,São José do Rio Preto,35004,São José do Rio Preto,Mirassolândia,SP,2953,2701,3020,3741,4099,4295,2193,2102,3492,803,1.39%
3530508,3507,Campinas,35030,São João da Boa Vista,Mococa,SP,34819,47313,58374,65574,66086,66303,33067,33236,61159,5144,0.11%
3530607,3515,Metropolitana de São Paulo,35062,Mogi das Cruzes,Mogi das Cruzes,SP,138751,197935,273175,330241,362991,387241,188658,198583,357294,29947,1.60%
3530706,3507,Campinas,35031,Moji Mirim,Mogi Guaçu,SP,42710,73570,107454,124228,131870,137286,68115,69171,130336,6950,1.00%
3530805,3507,Campinas,35031,Moji Mirim,Moji Mirim,SP,36301,50633,64753,81467,84176,86244,42470,43774,80670,5574,0.57%
3530904,3506,Piracicaba,35028,Piracicaba,Mombuca,SP,3010,2659,2597,3107,3280,3266,1663,1603,2685,581,0.50%
3531001,3501,São José do Rio Preto,35007,Nhandeara,Monções,SP,2500,2413,2108,2055,2054,2134,1101,1033,1838,296,0.38%
3531100,3514,Litoral Sul Paulista,35056,Itanhaém,Mongaguá,SP,5213,9928,19026,35098,40423,46310,23109,23201,46108,202,2.81%
3531209,3507,Campinas,35033,Amparo,Monte Alegre do Sul,SP,4762,4850,5439,6321,6957,7148,3578,3570,4087,3061,1.24%
3531308,3502,Ribeirão Preto,35013,Jaboticabal,Monte Alto,SP,21520,31231,39742,43613,44085,46647,22980,23667,44548,2099,0.67%
3531407,3501,São José do Rio Preto,35007,Nhandeara,Monte Aprazível,SP,17005,16442,17504,18413,19745,21748,10815,10933,19805,1943,1.68%
3531506,3502,Ribeirão Preto,35013,Jaboticabal,Monte Azul Paulista,SP,10431,13021,17698,19553,19187,18931,9491,9440,17713,1218,-0.32%
3531605,3508,Presidente Prudente,35034,Dracena,Monte Castelo,SP,6376,6140,4718,4089,4014,4063,2011,2052,3211,852,-0.06%
3531704,3513,Vale do Paraíba Paulista,35049,Campos do Jordão,Monteiro Lobato,SP,3180,2687,3380,3615,3994,4123,2149,1974,1790,2333,1.32%
3531803,3507,Campinas,35032,Campinas,Monte Mor,SP,7960,14020,25559,37340,42824,48971,24496,24475,45996,2975,2.75%
3531902,3502,Ribeirão Preto,35010,São Joaquim da Barra,Morro Agudo,SP,16609,17444,21253,25428,25390,29127,14885,14242,27918,1209,1.37%
3532009,3512,Macro Metropolitana Paulista,35048,Bragança Paulista,Morungaba,SP,5032,6528,8210,9911,12007,11775,5897,5878,10057,1718,1.74%
3532058,3505,Araraquara,35024,Araraquara,Motuca,SP,,,,3871,4340,4290,2162,2128,3108,1182,1.03%
3532108,3503,Araçatuba,35016,Andradina,Murutinga do Sul,SP,5384,4580,3782,3971,4091,4186,2097,2089,2573,1613,0.53%
3532157,3510,Assis,35039,Assis,Nantes,SP,,,,2269,2483,2707,1357,1350,2431,276,1.78%
3532207,3508,Presidente Prudente,35036,Presidente Prudente,Narandiba,SP,4008,3533,3138,3743,3941,4289,2172,2117,3105,1184,1.37%
3532306,3513,Vale do Paraíba Paulista,35053,Paraibuna/Paraitinga,Natividade da Serra,SP,9957,6888,6458,6952,7275,6681,3487,3194,2788,3893,-0.40%
3532405,3512,Macro Metropolitana Paulista,35048,Bragança Paulista,Nazaré Paulista,SP,10009,8419,11671,14410,14613,16413,8453,7960,13910,2503,1.31%
3532504,3501,São José do Rio Preto,35007,Nhandeara,Neves Paulista,SP,8199,7804,8313,8907,8825,8777,4365,4412,7921,856,-0.15%
3532603,3501,São José do Rio Preto,35007,Nhandeara,Nhandeara,SP,10996,10223,10343,10194,10334,10725,5281,5444,8688,2037,0.51%
3532702,3501,São José do Rio Preto,35007,Nhandeara,Nipoã,SP,3046,2737,2796,3267,3762,4274,2262,2012,3797,477,2.72%
3532801,3501,São José do Rio Preto,35004,São José do Rio Preto,Nova Aliança,SP,4577,4287,4194,4768,4905,5891,2922,2969,4881,1010,2.14%
3532827,3511,Itapetininga,35041,Itapeva,Nova Campina,SP,,,,7295,8474,8515,4345,4170,5762,2753,1.56%
3532843,3501,São José do Rio Preto,35001,Jales,Nova Canaã Paulista,SP,,,,2483,2205,2114,1076,1038,880,1234,-1.60%
3532868,3501,São José do Rio Preto,35006,Auriflama,Nova Castilho,SP,,,,991,1057,1127,557,570,746,381,1.29%
3532900,3505,Araraquara,35024,Araraquara,Nova Europa,SP,3822,4508,5381,7307,9047,9301,4648,4653,8629,672,2.44%
3533007,3501,São José do Rio Preto,35004,São José do Rio Preto,Nova Granada,SP,12032,11440,14895,17020,17739,19178,9660,9518,17773,1405,1.20%
3533106,3508,Presidente Prudente,35034,Dracena,Nova Guataporanga,SP,2375,2708,2133,2087,2101,2178,1104,1074,1893,285,0.43%
3533205,3503,Araçatuba,35016,Andradina,Nova Independência,SP,2042,1867,1994,2063,2480,3072,1526,1546,2448,624,4.06%
3533254,3501,São José do Rio Preto,35005,Catanduva,Novais,SP,,,,3225,3661,4595,2479,2116,4184,411,3.60%
3533304,3501,São José do Rio Preto,35006,Auriflama,Nova Luzitânia,SP,2678,1970,2646,2749,3403,3441,1820,1621,3087,354,2.27%
3533403,3507,Campinas,35032,Campinas,Nova Odessa,SP,8336,21891,34063,42071,45625,51278,25365,25913,50440,838,2.00%
3533502,3501,São José do Rio Preto,35008,Novo Horizonte,Novo Horizonte,SP,23098,26816,30446,32432,34264,36612,18270,18342,34067,2545,1.22%
3533601,3502,Ribeirão Preto,35010,São Joaquim da Barra,Nuporanga,SP,5676,5062,5789,6309,6629,6817,3410,3407,6185,632,0.78%
3533700,3509,Marília,35038,Marília,Ocauçu,SP,5955,4828,4311,4164,4180,4163,2137,2026,3324,839,-0.00%
3533809,3510,Assis,35040,Ourinhos,Óleo,SP,4406,2996,2801,2994,2714,2673,1344,1329,1763,910,-1.13%
3533908,3501,São José do Rio Preto,35004,São José do Rio Preto,Olímpia,SP,29079,31787,42907,46013,48020,49792,24562,25230,47092,2700,0.79%
3534005,3501,São José do Rio Preto,35004,São José do Rio Preto,Onda Verde,SP,2180,2015,2829,3413,3736,3884,1993,1891,3043,841,1.30%
3534104,3509,Marília,35038,Marília,Oriente,SP,8781,6472,6803,5884,6079,6097,2985,3112,5695,402,0.36%
3534203,3501,São José do Rio Preto,35004,São José do Rio Preto,Orindiúva,SP,2443,2118,3046,4161,4916,5678,2900,2778,5226,452,3.16%
3534302,3502,Ribeirão Preto,35010,São Joaquim da Barra,Orlândia,SP,18275,25330,31319,36004,36149,39781,19499,20282,38756,1025,1.00%
3534401,3515,Metropolitana de São Paulo,35057,Osasco,Osasco,SP,283073,474544,568225,652593,701012,666469,320268,346201,666469,0,0.21%
3534500,3509,Marília,35038,Marília,Oscar Bressane,SP,4197,3077,2532,2552,2476,2539,1218,1321,2101,438,-0.05%
3534609,3508,Presidente Prudente,35035,Adamantina,Osvaldo Cruz,SP,23377,26113,28918,29648,30150,30917,15554,15363,27782,3135,0.42%
3534708,3510,Assis,35040,Ourinhos,Ourinhos,SP,49221,59738,76923,93868,98868,103026,49972,53054,100368,2658,0.94%
3534757,3501,São José do Rio Preto,35002,Fernandópolis,Ouroeste,SP,,,,6290,7035,8406,4191,4215,7547,859,2.94%
3534807,3508,Presidente Prudente,35034,Dracena,Ouro Verde,SP,7706,5854,7093,7148,7668,7794,3864,3930,7170,624,0.87%
3534906,3508,Presidente Prudente,35035,Adamantina,Pacaembu,SP,17211,15719,12365,12518,13072,12934,7450,5484,9745,3189,0.33%
3535002,3501,São José do Rio Preto,35004,São José do Rio Preto,Palestina,SP,12129,9018,9011,9100,10428,11052,5596,5456,9189,1863,1.96%
3535101,3501,São José do Rio Preto,35005,Catanduva,Palmares Paulista,SP,3105,4266,7321,8437,10508,10938,5863,5075,10623,315,2.63%
3535200,3501,São José do Rio Preto,35001,Jales,Palmeira d'Oeste,SP,15345,12673,10950,10322,9634,9584,4805,4779,7268,2316,-0.74%
3535309,3510,Assis,35039,Assis,Palmital,SP,20066,17129,18683,20701,21298,21257,10393,10864,19498,1759,0.27%
3535408,3508,Presidente Prudente,35034,Dracena,Panorama,SP,6568,8073,12343,13649,13944,14603,7319,7284,14168,435,0.68%
3535507,3510,Assis,35039,Assis,Paraguaçu Paulista,SP,21892,23596,33840,39618,42117,42281,21264,21017,38319,3962,0.65%
3535606,3513,Vale do Paraíba Paulista,35053,Paraibuna/Paraitinga,Paraibuna,SP,13845,14126,14891,17009,16456,17384,8823,8561,5240,12144,0.22%
3535705,3501,São José do Rio Preto,35005,Catanduva,Paraíso,SP,3422,3617,4733,5429,5559,5907,3019,2888,5194,713,0.85%
3535804,3504,Bauru,35022,Avaré,Paranapanema,SP,9984,11064,12796,15510,16667,17810,9061,8749,14481,3329,1.39%
3535903,3501,São José do Rio Preto,35001,Jales,Paranapuã,SP,9190,5789,5777,3632,3614,3815,1950,1865,3394,421,0.49%
3536000,3508,Presidente Prudente,35035,Adamantina,Parapuã,SP,11198,12273,11418,11104,11029,10844,5535,5309,8896,1948,-0.24%
3536109,3504,Bauru,35023,Botucatu,Pardinho,SP,3098,2746,3444,4732,5030,5582,2844,2738,4389,1193,1.67%
3536208,3514,Litoral Sul Paulista,35055,Registro,Pariquera-Açu,SP,7806,11319,13164,17649,18079,18453,9143,9310,12661,5792,0.45%
3536257,3501,São José do Rio Preto,35003,Votuporanga,Parisi,SP,,,,1948,2038,2032,1044,988,1643,389,0.42%
3536307,3502,Ribeirão Preto,35012,Franca,Patrocínio Paulista,SP,8635,9016,9715,11416,12183,13002,6596,6406,10501,2501,1.31%
3536406,3508,Presidente Prudente,35034,Dracena,Paulicéia,SP,3385,2378,4157,5302,5506,6342,3292,3050,5271,1071,1.81%
3536505,3507,Campinas,35032,Campinas,Paulínia,SP,10708,20753,36706,51326,73014,82150,40677,41473,82074,76,4.82%
3536570,3504,Bauru,35020,Bauru,Paulistânia,SP,,,,1779,1824,1778,919,859,1211,567,-0.01%
3536604,3501,São José do Rio Preto,35004,São José do Rio Preto,Paulo de Faria,SP,9463,6638,8319,8472,8942,8589,4299,4290,7750,839,0.14%
3536703,3504,Bauru,35021,Jaú,Pederneiras,SP,18399,26107,32021,36614,40270,41530,20879,20651,38613,2917,1.27%
3536802,3507,Campinas,35033,Amparo,Pedra Bela,SP,5230,4686,5142,5609,5835,5780,3030,2750,1440,4340,0.30%
3536901,3501,São José do Rio Preto,35002,Fernandópolis,Pedranópolis,SP,4495,3554,3105,2734,2734,2561,1309,1252,1593,968,-0.65%
3537008,3502,Ribeirão Preto,35012,Franca,Pedregulho,SP,14780,12919,13729,14994,15156,15699,7982,7717,11585,4114,0.46%
3537107,3507,Campinas,35032,Campinas,Pedreira,SP,15053,21381,27972,35219,38152,41549,20592,20957,41197,352,1.67%
3537156,3510,Assis,35039,Assis,Pedrinhas Paulista,SP,,,,2861,2834,2936,1460,1476,2479,457,0.26%
3537206,3514,Litoral Sul Paulista,35056,Itanhaém,Pedro de Toledo,SP,6095,6060,7836,9187,9692,10213,5162,5051,7042,3171,1.06%
3537305,3503,Araçatuba,35018,Birigui,Penápolis,SP,34263,40332,48285,54635,56681,58529,28579,29950,55901,2628,0.69%
3537404,3503,Araçatuba,35016,Andradina,Pereira Barreto,SP,52413,46366,49932,25028,24220,24959,12270,12689,23235,1724,-0.03%
3537503,3511,Itapetininga,35043,Tatuí,Pereiras,SP,4834,3763,4447,6226,7347,7468,3793,3675,4981,2487,1.84%
3537602,3514,Litoral Sul Paulista,35056,Itanhaém,Peruíbe,SP,6966,18411,32773,51451,54457,59793,29153,30640,59125,668,1.51%
3537701,3503,Araçatuba,35018,Birigui,Piacatu,SP,5352,4741,4539,4625,5093,5287,2662,2625,4663,624,1.35%
3537800,3512,Macro Metropolitana Paulista,35045,Piedade,Piedade,SP,27640,35897,43581,50131,48430,52214,26602,25612,23782,28432,0.41%
3537909,3512,Macro Metropolitana Paulista,35045,Piedade,Pilar do Sul,SP,10265,13857,19488,23948,26457,26411,13415,12996,20590,5821,0.98%
3538006,3513,Vale do Paraíba Paulista,35050,São José dos Campos,Pindamonhangaba,SP,48222,69568,102063,126026,135682,147034,72310,74724,141737,5297,1.55%
3538105,3501,São José do Rio Preto,35005,Catanduva,Pindorama,SP,9045,10188,12374,13109,14345,15043,7695,7348,14239,804,1.39%
3538204,3507,Campinas,35033,Amparo,Pinhalzinho,SP,4912,6432,8433,10986,11817,13104,6592,6512,6455,6649,1.78%
3538303,3508,Presidente Prudente,35036,Presidente Prudente,Piquerobi,SP,5351,3545,3268,3478,3599,3541,1755,1786,2673,868,0.18%
3538501,3513,Vale do Paraíba Paulista,35051,Guaratinguetá,Piquete,SP,14316,14364,14749,15200,14475,14107,6817,7290,13212,895,-0.74%
3538600,3512,Macro Metropolitana Paulista,35048,Bragança Paulista,Piracaia,SP,12883,13792,18999,23347,22335,25139,12532,12607,25139,0,0.74%
3538709,3506,Piracicaba,35028,Piracicaba,Piracicaba,SP,152505,214307,283833,329158,358108,364872,178538,186334,355136,9736,1.04%
3538808,3510,Assis,35040,Ourinhos,Piraju,SP,20336,21384,26076,27897,28228,28489,13833,14656,25617,2872,0.21%
3538907,3504,Bauru,35020,Bauru,Pirajuí,SP,20344,19423,18829,20095,21035,22724,12584,10140,18511,4213,1.24%
3539004,3502,Ribeirão Preto,35013,Jaboticabal,Pirangi,SP,6210,7587,9867,10038,10315,10623,5393,5230,9528,1095,0.57%
3539103,3515,Metropolitana de São Paulo,35057,Osasco,Pirapora do Bom Jesus,SP,3694,4814,7956,12395,14370,15727,7809,7918,15727,0,2.41%
3539202,3508,Presidente Prudente,35036,Presidente Prudente,Pirapozinho,SP,15922,17918,20992,22104,23709,24718,12087,12631,23477,1241,1.12%
3539301,3507,Campinas,35029,Pirassununga,Pirassununga,SP,37577,44970,56746,64864,67787,70138,34311,35827,64264,5874,0.78%
3539400,3504,Bauru,35020,Bauru,Piratininga,SP,10232,10056,9656,10584,11287,12072,5983,6089,10347,1725,1.32%
3539509,3502,Ribeirão Preto,35013,Jaboticabal,Pitangueiras,SP,15813,18602,29490,31156,33329,35314,18008,17306,33955,1359,1.26%
3539608,3501,São José do Rio Preto,35004,São José do Rio Preto,Planalto,SP,7250,6041,5458,3670,4014,4472,2320,2152,3775,697,2.00%
3539707,3510,Assis,35039,Assis,Platina,SP,2966,2279,2829,2867,3167,3192,1660,1532,2513,679,1.08%
3539806,3515,Metropolitana de São Paulo,35062,Mogi das Cruzes,Poá,SP,32373,52787,76302,95801,104904,106033,51330,54703,104355,1678,1.02%
3539905,3501,São José do Rio Preto,35007,Nhandeara,Poloni,SP,5105,4775,4526,4774,4878,5395,2671,2724,4802,593,1.23%
3540002,3509,Marília,35038,Marília,Pompéia,SP,17877,16261,17236,18171,19091,19963,9792,10171,18573,1390,0.94%
3540101,3504,Bauru,35020,Bauru,Pongaí,SP,3283,3540,3581,3693,3473,3479,1793,1686,2923,556,-0.60%
3540200,3502,Ribeirão Preto,35014,Ribeirão Preto,Pontal,SP,13728,16751,22805,29681,35560,40245,21175,19070,39493,752,3.09%
3540259,3501,São José do Rio Preto,35001,Jales,Pontalinda,SP,,,,3539,3906,4074,2160,1914,3381,693,1.42%
3540309,3501,São José do Rio Preto,35003,Votuporanga,Pontes Gestal,SP,3447,2859,2965,2539,2487,2523,1258,1265,2128,395,-0.06%
3540408,3501,São José do Rio Preto,35001,Jales,Populina,SP,8066,4714,4673,4450,4201,4223,2139,2084,3412,811,-0.52%
3540507,3511,Itapetininga,35043,Tatuí,Porangaba,SP,7577,6406,6841,6652,8069,8333,4295,4038,4028,4305,2.28%
3540606,3512,Macro Metropolitana Paulista,35046,Sorocaba,Porto Feliz,SP,22152,27127,36936,45514,46054,48914,24545,24369,41111,7803,0.72%
3540705,3507,Campinas,35029,Pirassununga,Porto Ferreira,SP,19216,27991,38492,47437,48760,51407,25506,25901,50485,922,0.81%
3540754,3513,Vale do Paraíba Paulista,35051,Guaratinguetá,Potim,SP,,,,13605,18143,19413,10986,8427,14710,4703,3.62%
3540804,3501,São José do Rio Preto,35004,São José do Rio Preto,Potirendaba,SP,9880,10705,11201,13656,14327,15453,7857,7596,13886,1567,1.24%
3540853,3508,Presidente Prudente,35035,Adamantina,Pracinha,SP,,,,1431,2667,2863,2085,778,1369,1494,7.18%
3540903,3502,Ribeirão Preto,35014,Ribeirão Preto,Pradópolis,SP,5796,7827,9870,12912,15148,17404,8901,8503,16127,1277,3.03%
3541000,3515,Metropolitana de São Paulo,35063,Santos,Praia Grande,SP,19694,66004,123492,193582,233806,260769,125280,135489,260769,0,3.02%
3541059,3504,Bauru,35023,Botucatu,Pratânia,SP,,,,3950,4309,4599,2379,2220,3485,1114,1.53%
3541109,3504,Bauru,35020,Bauru,Presidente Alves,SP,5117,4866,4504,4317,4346,4123,2038,2085,3431,692,-0.46%
3541208,3508,Presidente Prudente,35036,Presidente Prudente,Presidente Bernardes,SP,25590,15784,16311,14662,14788,13544,6673,6871,10473,3071,-0.79%
3541307,3508,Presidente Prudente,35036,Presidente Prudente,Presidente Epitácio,SP,26428,29608,34851,39298,39403,41324,20219,21105,38551,2773,0.50%
3541406,3508,Presidente Prudente,35036,Presidente Prudente,Presidente Prudente,SP,105707,136849,165484,189186,202789,207625,99913,107712,203370,4255,0.93%
3541505,3508,Presidente Prudente,35036,Presidente Prudente,Presidente Venceslau,SP,25976,30160,36120,37347,37155,37915,18918,18997,36275,1640,0.15%
3541604,3504,Bauru,35019,Lins,Promissão,SP,20544,20222,27981,31105,34786,35688,17760,17928,30084,5604,1.38%
3541653,3511,Itapetininga,35043,Tatuí,Quadra,SP,,,,2651,2679,3236,1707,1529,828,2408,2.01%
3541703,3510,Assis,35039,Assis,Quatá,SP,11581,8744,11358,11655,11971,12828,6412,6416,12040,788,0.96%
3541802,3509,Marília,35037,Tupã,Queiroz,SP,3372,2299,1936,2171,2603,2808,1424,1384,2385,423,2.61%
3541901,3513,Vale do Paraíba Paulista,35051,Guaratinguetá,Queluz,SP,5919,7002,7710,9112,10323,11325,5767,5558,9282,2043,2.20%
3542008,3509,Marília,35037,Tupã,Quintana,SP,6488,4905,5188,5443,5654,6008,2971,3037,5498,510,0.99%
3542107,3506,Piracicaba,35028,Piracicaba,Rafard,SP,5118,5940,8588,8360,8151,8624,4267,4357,7603,1021,0.31%
3542206,3508,Presidente Prudente,35036,Presidente Prudente,Rancharia,SP,22041,23341,26913,28772,28303,28773,14130,14643,25801,2972,0.00%
3542305,3513,Vale do Paraíba Paulista,35053,Paraibuna/Paraitinga,Redenção da Serra,SP,5135,4001,4008,4047,4081,3879,2016,1863,2214,1665,-0.42%
3542404,3508,Presidente Prudente,35036,Presidente Prudente,Regente Feijó,SP,10366,11083,14963,16998,17070,18496,9196,9300,17048,1448,0.85%
3542503,3504,Bauru,35020,Bauru,Reginópolis,SP,4472,4619,4774,4742,6993,7325,4683,2642,4362,2963,4.44%
3542602,3514,Litoral Sul Paulista,35055,Registro,Registro,SP,24281,39109,48953,53752,53369,54279,26667,27612,48187,6092,0.10%
3542701,3502,Ribeirão Preto,35012,Franca,Restinga,SP,5456,3541,4407,5584,6350,6587,3296,3291,5179,1408,1.67%
3542800,3511,Itapetininga,35044,Capão Bonito,Ribeira,SP,7174,7463,7336,3507,3444,3358,1742,1616,1236,2122,-0.43%
3542909,3505,Araraquara,35025,São Carlos,Ribeirão Bonito,SP,6856,8360,10329,11246,11383,12129,6100,6029,11214,915,0.76%
3543006,3511,Itapetininga,35044,Capão Bonito,Ribeirão Branco,SP,10113,13903,19278,21231,18879,18272,9398,8874,9296,8976,-1.49%
3543105,3502,Ribeirão Preto,35012,Franca,Ribeirão Corrente,SP,2193,2741,3229,3881,4014,4273,2218,2055,3397,876,0.97%
3543204,3510,Assis,35040,Ourinhos,Ribeirão do Sul,SP,3619,3129,3606,4497,4497,4464,2244,2220,3309,1155,-0.07%
3543238,3508,Presidente Prudente,35036,Presidente Prudente,Ribeirão dos Índios,SP,,,,2222,2231,2187,1088,1099,1850,337,-0.16%
3543253,3511,Itapetininga,35044,Capão Bonito,Ribeirão Grande,SP,,,,7390,6928,7419,3793,3626,2342,5077,0.04%
3543303,3515,Metropolitana de São Paulo,35061,São Paulo,Ribeirão Pires,SP,29048,56530,85085,104508,107046,113043,55275,57768,113043,0,0.79%
3543402,3502,Ribeirão Preto,35014,Ribeirão Preto,Ribeirão Preto,SP,212879,318544,436682,504923,547417,605114,290286,314828,603401,1713,1.83%
3543501,3511,Itapetininga,35041,Itapeva,Riversul,SP,9143,11335,9399,7192,6545,6165,3046,3119,4494,1671,-1.53%
3543600,3502,Ribeirão Preto,35012,Franca,Rifaina,SP,6180,3367,2897,3325,3587,3436,1725,1711,3009,427,0.33%
3543709,3505,Araraquara,35024,Araraquara,Rincão,SP,6538,7301,10356,10330,10425,10414,5244,5170,8460,1954,0.08%
3543808,3508,Presidente Prudente,35035,Adamantina,Rinópolis,SP,14420,15161,11169,10255,9393,9935,5051,4884,8636,1299,-0.32%
3543907,3506,Piracicaba,35026,Rio Claro,Rio Claro,SP,78040,110202,138243,168218,185421,186299,90708,95591,181766,4533,1.03%
3544004,3506,Piracicaba,35028,Piracicaba,Rio das Pedras,SP,8917,13472,19104,23494,26344,29508,14922,14586,28569,939,2.31%
3544103,3515,Metropolitana de São Paulo,35061,São Paulo,Rio Grande da Serra,SP,8397,20091,29901,37091,39270,44084,21877,22207,44084,0,1.74%
3544202,3501,São José do Rio Preto,35003,Votuporanga,Riolândia,SP,9640,6836,7760,8560,9713,10574,6021,4553,8365,2209,2.14%
3544251,3508,Presidente Prudente,35036,Presidente Prudente,Rosana,SP,,,,24229,19943,19691,9780,9911,15858,3833,-2.05%
3544301,3513,Vale do Paraíba Paulista,35051,Guaratinguetá,Roseira,SP,3492,4856,6217,8577,9016,9606,4846,4760,9123,483,1.14%
3544400,3503,Araçatuba,35017,Araçatuba,Rubiácea,SP,3376,2201,2639,2337,2501,2729,1392,1337,1563,1166,1.56%
3544509,3501,São José do Rio Preto,35001,Jales,Rubinéia,SP,4849,2413,2236,2615,2546,2862,1415,1447,2355,507,0.91%
3544608,3504,Bauru,35019,Lins,Sabino,SP,5044,4829,4571,4951,5150,5226,2629,2597,4584,642,0.54%
3544707,3508,Presidente Prudente,35035,Adamantina,Sagres,SP,4083,3016,2653,2439,2307,2395,1191,1204,1819,576,-0.18%
3544806,3501,São José do Rio Preto,35008,Novo Horizonte,Sales,SP,4053,4791,3758,4563,5025,5450,2786,2664,4903,547,1.79%
3544905,3502,Ribeirão Preto,35010,São Joaquim da Barra,Sales Oliveira,SP,7108,6417,7632,9325,8187,10568,5241,5327,9569,999,1.26%
3545001,3515,Metropolitana de São Paulo,35062,Mogi das Cruzes,Salesópolis,SP,9557,10657,11359,14357,15157,15639,7908,7731,9956,5683,0.86%
3545100,3508,Presidente Prudente,35035,Adamantina,Salmourão,SP,4954,4778,4462,4401,4551,4818,2477,2341,4321,497,0.91%
3545159,3506,Piracicaba,35028,Piracicaba,Saltinho,SP,,,,5799,6586,7059,3519,3540,5891,1168,1.99%
3545209,3512,Macro Metropolitana Paulista,35046,Sorocaba,Salto,SP,21772,42379,72333,93159,102405,105569,52146,53423,104827,742,1.26%
3545308,3512,Macro Metropolitana Paulista,35046,Sorocaba,Salto de Pirapora,SP,9001,14688,25344,35072,37324,40141,19959,20182,31463,8678,1.36%
3545407,3510,Assis,35040,Ourinhos,Salto Grande,SP,7123,7011,7678,8444,8592,8787,4354,4433,7934,853,0.40%
3545506,3508,Presidente Prudente,35036,Presidente Prudente,Sandovalina,SP,3090,2735,2403,3089,3217,3699,1884,1815,2581,1118,1.82%
3545605,3501,São José do Rio Preto,35005,Catanduva,Santa Adélia,SP,8857,10280,12615,13449,13861,14333,7164,7169,13560,773,0.64%
3545704,3501,São José do Rio Preto,35001,Jales,Santa Albertina,SP,9734,6181,5870,5586,5034,5723,2905,2818,4891,832,0.24%
3545803,3507,Campinas,35032,Campinas,Santa Bárbara d'Oeste,SP,31018,76628,145266,170078,184318,180148,89311,90837,178728,1420,0.58%
3546009,3513,Vale do Paraíba Paulista,35050,São José dos Campos,Santa Branca,SP,6831,8501,10306,13010,13282,13770,6878,6892,12145,1625,0.57%
3546108,3501,São José do Rio Preto,35001,Jales,Santa Clara d'Oeste,SP,3913,2653,2497,2123,2081,2084,1073,1011,1571,513,-0.19%
3546207,3506,Piracicaba,35027,Limeira,Santa Cruz da Conceição,SP,2184,2687,2937,3531,3872,3998,1979,2019,2708,1290,1.25%
3546256,3502,Ribeirão Preto,35015,Batatais,Santa Cruz da Esperança,SP,,,,1796,1707,1953,966,987,1323,630,0.84%
3546306,3507,Campinas,35029,Pirassununga,Santa Cruz das Palmeiras,SP,13000,16085,21819,25556,30458,29974,15245,14729,29042,932,1.61%
3546405,3510,Assis,35040,Ourinhos,Santa Cruz do Rio Pardo,SP,34412,33616,39544,40919,41655,43929,21513,22416,40161,3768,0.71%
3546504,3502,Ribeirão Preto,35013,Jaboticabal,Santa Ernestina,SP,2903,3498,5613,5741,5510,5568,2852,2716,5145,423,-0.31%
3546603,3501,São José do Rio Preto,35001,Jales,Santa Fé do Sul,SP,16939,20370,23110,26512,27693,29235,14073,15162,28084,1151,0.98%
3546702,3506,Piracicaba,35027,Limeira,Santa Gertrudes,SP,6010,7987,10485,15906,19044,21644,10957,10687,21414,230,3.13%
3546801,3515,Metropolitana de São Paulo,35059,Guarulhos,Santa Isabel,SP,17161,29013,37975,43740,44817,50464,25260,25204,39596,10868,1.44%
3546900,3505,Araraquara,35024,Araraquara,Santa Lúcia,SP,4347,5038,6284,7853,7862,8246,4129,4117,7752,494,0.49%
3547007,3506,Piracicaba,35028,Piracicaba,Santa Maria da Serra,SP,2144,2852,4303,4673,5417,5418,2750,2668,4777,641,1.49%
3547106,3508,Presidente Prudente,35034,Dracena,Santa Mercedes,SP,4903,4114,2982,2803,2589,2831,1423,1408,2458,373,0.10%
3547205,3501,São José do Rio Preto,35001,Jales,Santana da Ponte Pensa,SP,3906,2794,2365,1894,1654,1641,841,800,1097,544,-1.42%
3547304,3515,Metropolitana de São Paulo,35057,Osasco,Santana de Parnaíba,SP,5390,10098,37762,74828,100236,108875,53652,55223,108875,0,3.82%
3547403,3501,São José do Rio Preto,35001,Jales,Santa Rita d'Oeste,SP,6561,4238,3487,2695,2493,2543,1264,1279,1773,770,-0.58%
3547502,3502,Ribeirão Preto,35014,Ribeirão Preto,Santa Rita do Passa Quatro,SP,19064,20876,24124,26138,26456,26420,12785,13635,23643,2777,0.11%
3547601,3502,Ribeirão Preto,35014,Ribeirão Preto,Santa Rosa de Viterbo,SP,11840,14431,19195,21435,22699,23871,11780,12091,22756,1115,1.08%
3547650,3501,São José do Rio Preto,35001,Jales,Santa Salete,SP,,,,1379,1390,1447,743,704,819,628,0.48%
3547700,3508,Presidente Prudente,35036,Presidente Prudente,Santo Anastácio,SP,25332,21652,22079,20749,20550,20498,9994,10504,19100,1398,-0.12%
3547809,3515,Metropolitana de São Paulo,35061,São Paulo,Santo André,SP,418826,553077,616991,649331,667891,673914,323208,350706,673914,0,0.37%
3547908,3502,Ribeirão Preto,35015,Batatais,Santo Antônio da Alegria,SP,4462,5291,5155,5764,6020,6304,3260,3044,4669,1635,0.90%
3548005,3507,Campinas,35031,Moji Mirim,Santo Antônio de Posse,SP,7799,10877,14327,18124,19824,20635,10398,10237,18813,1822,1.31%
3548054,3503,Araçatuba,35017,Araçatuba,Santo Antônio do Aracanguá,SP,,,,6929,7034,7627,3881,3746,5977,1650,0.96%
3548104,3507,Campinas,35030,São João da Boa Vista,Santo Antônio do Jardim,SP,4833,5535,5687,6154,5743,5943,3045,2898,3532,2411,-0.35%
3548203,3513,Vale do Paraíba Paulista,35049,Campos do Jordão,Santo Antônio do Pinhal,SP,5479,5359,5355,6328,6560,6516,3285,3231,3868,2648,0.29%
3548302,3508,Presidente Prudente,35036,Presidente Prudente,Santo Expedito,SP,4148,2263,2222,2526,2759,2806,1407,1399,2484,322,1.06%
3548401,3503,Araçatuba,35018,Birigui,Santópolis do Aguapeí,SP,3596,3462,3845,3816,4008,4281,2170,2111,4134,147,1.16%
3548500,3515,Metropolitana de São Paulo,35063,Santos,Santos,SP,345630,416677,428923,417983,418288,419757,192056,227701,419443,314,0.04%
3548609,3513,Vale do Paraíba Paulista,35049,Campos do Jordão,São Bento do Sapucaí,SP,9365,9316,8695,10355,10515,10462,5268,5194,5032,5430,0.10%
3548708,3515,Metropolitana de São Paulo,35061,São Paulo,São Bernardo do Campo,SP,201662,425611,566893,703177,781390,765203,369489,395714,752414,12789,0.85%
3548807,3515,Metropolitana de São Paulo,35061,São Paulo,São Caetano do Sul,SP,150130,163086,149519,140159,144857,149571,69024,80547,149571,0,0.65%
3548906,3505,Araraquara,35025,São Carlos,São Carlos,SP,85425,119535,158221,192998,212956,221936,108875,113061,213070,8866,1.41%
3549003,3501,São José do Rio Preto,35001,Jales,São Francisco,SP,6595,4613,4445,2863,2812,2793,1400,1393,2167,626,-0.25%
3549102,3507,Campinas,35030,São João da Boa Vista,São João da Boa Vista,SP,44471,55938,69148,77387,79935,83661,40558,43103,80324,3337,0.78%
3549201,3501,São José do Rio Preto,35002,Fernandópolis,São João das Duas Pontes,SP,4026,2963,2791,2660,2571,2566,1290,1276,1961,605,-0.36%
3549250,3501,São José do Rio Preto,35006,Auriflama,São João de Iracema,SP,,,,1671,1725,1780,898,882,1452,328,0.63%
3549300,3508,Presidente Prudente,35034,Dracena,São João do Pau d'Alho,SP,3733,3600,2814,2180,2132,2103,1057,1046,1705,398,-0.36%
3549409,3502,Ribeirão Preto,35010,São Joaquim da Barra,São Joaquim da Barra,SP,24359,29305,35964,41587,43703,46524,22801,23723,45690,834,1.13%
3549508,3502,Ribeirão Preto,35012,Franca,São José da Bela Vista,SP,6781,6648,7119,8075,8173,8407,4312,4095,7486,921,0.40%
3549607,3513,Vale do Paraíba Paulista,35052,Bananal,São José do Barreiro,SP,5438,4034,3933,4143,4278,4097,2061,2036,2872,1225,-0.11%
3549706,3507,Campinas,35030,São João da Boa Vista,São José do Rio Pardo,SP,31662,36164,44579,50077,51023,51910,25550,26360,45974,5936,0.36%
3549805,3501,São José do Rio Preto,35004,São José do Rio Preto,São José do Rio Preto,SP,122134,188599,283761,358523,402770,408435,196114,212321,383558,24877,1.31%
3549904,3513,Vale do Paraíba Paulista,35050,São José dos Campos,São José dos Campos,SP,148332,287513,442370,539313,594948,627544,307394,320150,615610,11934,1.53%
3549953,3515,Metropolitana de São Paulo,35060,Itapecerica da Serra,São Lourenço da Serra,SP,,,,12199,16121,13985,7100,6885,12725,1260,1.38%
3550001,3513,Vale do Paraíba Paulista,35053,Paraibuna/Paraitinga,São Luís do Paraitinga,SP,11655,9750,9922,10429,10496,10404,5321,5083,6185,4219,-0.02%
3550100,3504,Bauru,35023,Botucatu,São Manuel,SP,27402,27549,35438,36545,37797,38390,18792,19598,37461,929,0.49%
3550209,3512,Macro Metropolitana Paulista,35045,Piedade,São Miguel Arcanjo,SP,13864,17145,25382,30798,30384,31452,15996,15456,21504,9948,0.21%
3550308,3515,Metropolitana de São Paulo,35061,São Paulo,São Paulo,SP,5924612,8493217,9646185,10434252,10886518,11244369,5323385,5920984,11125243,119126,0.75%
3550407,3506,Piracicaba,35028,Piracicaba,São Pedro,SP,10141,13175,20176,27897,29733,31688,15439,16249,26635,5053,1.28%
3550506,3510,Assis,35040,Ourinhos,São Pedro do Turvo,SP,9455,7574,7038,6888,7094,7208,3676,3532,5158,2050,0.46%
3550605,3512,Macro Metropolitana Paulista,35046,Sorocaba,São Roque,SP,37049,49548,63900,66637,65693,78873,38793,40080,71536,7337,1.70%
3550704,3513,Vale do Paraíba Paulista,35054,Caraguatatuba,São Sebastião,SP,12016,18997,33890,58038,67348,73833,36827,37006,73000,833,2.44%
3550803,3507,Campinas,35030,São João da Boa Vista,São Sebastião da Grama,SP,11772,11323,11810,12454,12509,12100,6166,5934,7970,4130,-0.29%
3550902,3502,Ribeirão Preto,35014,Ribeirão Preto,São Simão,SP,12728,10676,11987,13675,13781,14350,7062,7288,12930,1420,0.48%
3551009,3515,Metropolitana de São Paulo,35063,Santos,São Vicente,SP,116485,193008,268618,303551,323599,332424,159571,172853,331792,632,0.91%
3551108,3512,Macro Metropolitana Paulista,35046,Sorocaba,Sarapuí,SP,5013,5179,6477,7805,8158,9027,4594,4433,6646,2381,1.47%
3551207,3510,Assis,35040,Ourinhos,Sarutaiá,SP,3047,2974,3023,3739,3680,3622,1819,1803,2957,665,-0.32%
3551306,3501,São José do Rio Preto,35007,Nhandeara,Sebastianópolis do Sul,SP,3002,2379,2516,2546,2871,3031,1525,1506,2347,684,1.76%
3551405,3502,Ribeirão Preto,35014,Ribeirão Preto,Serra Azul,SP,4735,4820,6172,7446,9107,11259,6872,4387,8021,3238,4.22%
3551504,3502,Ribeirão Preto,35014,Ribeirão Preto,Serrana,SP,8995,14379,23219,32603,36596,38891,19492,19399,38479,412,1.78%
3551603,3507,Campinas,35033,Amparo,Serra Negra,SP,13650,17310,21704,23851,24671,26362,12860,13502,22865,3497,1.01%
3551702,3502,Ribeirão Preto,35014,Ribeirão Preto,Sertãozinho,SP,31066,51543,78776,94664,103558,110094,54714,55380,108792,1302,1.52%
3551801,3514,Litoral Sul Paulista,35055,Registro,Sete Barras,SP,9223,11274,12527,13714,12975,13006,6682,6324,7035,5971,-0.53%
3551900,3501,São José do Rio Preto,35005,Catanduva,Severínia,SP,6787,7879,10280,13605,14713,15504,8046,7458,14777,727,1.32%
3552007,3513,Vale do Paraíba Paulista,35052,Bananal,Silveiras,SP,5442,3916,4914,5378,5562,5792,2936,2856,2879,2913,0.74%
3552106,3507,Campinas,35033,Amparo,Socorro,SP,20688,23657,30763,32704,33080,36695,18211,18484,24947,11748,1.16%
3552205,3512,Macro Metropolitana Paulista,35046,Sorocaba,Sorocaba,SP,175677,269888,379006,493468,559157,586311,286798,299513,580340,5971,1.74%
3552304,3503,Araçatuba,35016,Andradina,Sud Mennucci,SP,8766,5361,7205,7365,7714,7440,3745,3695,6394,1046,0.10%
3552403,3507,Campinas,35032,Campinas,Sumaré,SP,23074,101851,226870,196723,228696,241437,119984,121453,238599,2838,2.07%
3552502,3515,Metropolitana de São Paulo,35062,Mogi das Cruzes,Suzano,SP,55460,101056,158839,228690,268777,262568,128797,133771,253328,9240,1.39%
3552551,3503,Araçatuba,35016,Andradina,Suzanápolis,SP,,,,2790,3421,3383,1748,1635,2258,1125,1.95%
3552601,3501,São José do Rio Preto,35005,Catanduva,Tabapuã,SP,11230,12313,13051,10493,11255,11366,5744,5622,10522,844,0.80%
3552700,3505,Araraquara,35024,Araraquara,Tabatinga,SP,6875,7999,10793,12990,13965,14686,7565,7121,12578,2108,1.23%
3552809,3515,Metropolitana de São Paulo,35060,Itapecerica da Serra,Taboão da Serra,SP,40945,97656,160084,197644,219200,244719,116920,127799,244719,0,2.16%
3552908,3508,Presidente Prudente,35036,Presidente Prudente,Taciba,SP,7101,4524,4750,5221,5402,5714,2862,2852,4852,862,0.91%
3553005,3510,Assis,35040,Ourinhos,Taguaí,SP,5618,5744,6428,7468,9616,10825,5382,5443,7754,3071,3.78%
3553104,3502,Ribeirão Preto,35013,Jaboticabal,Taiaçu,SP,2935,3508,5015,5619,5804,5894,2972,2922,5339,555,0.48%
3553203,3502,Ribeirão Preto,35013,Jaboticabal,Taiúva,SP,4065,4425,5218,5506,5366,5447,2696,2751,4967,480,-0.11%
3553302,3507,Campinas,35030,São João da Boa Vista,Tambaú,SP,12201,15447,19857,22258,21913,22410,11179,11231,19912,2498,0.07%
3553401,3501,São José do Rio Preto,35004,São José do Rio Preto,Tanabi,SP,20437,20294,21513,22587,23400,24055,12042,12013,21735,2320,0.63%
3553500,3512,Macro Metropolitana Paulista,35045,Piedade,Tapiraí,SP,5265,5093,5734,8570,7953,8015,4037,3978,5728,2287,-0.67%
3553609,3507,Campinas,35030,São João da Boa Vista,Tapiratiba,SP,9283,9867,11799,12942,12246,12743,6336,6407,10497,2246,-0.15%
3553658,3502,Ribeirão Preto,35013,Jaboticabal,Taquaral,SP,,,,2722,2827,2726,1373,1353,2613,113,0.01%
3553708,3502,Ribeirão Preto,35013,Jaboticabal,Taquaritinga,SP,27518,35929,46922,52065,53232,53985,26659,27326,51165,2820,0.36%
3553807,3511,Itapetininga,35041,Itapeva,Taquarituba,SP,13964,16174,18537,21982,22170,22294,11091,11203,19582,2712,0.14%
3553856,3511,Itapetininga,35041,Itapeva,Taquarivaí,SP,,,,4473,5098,5149,2577,2572,2809,2340,1.42%
3553906,3508,Presidente Prudente,35036,Presidente Prudente,Tarabai,SP,3599,3565,4714,5786,6108,6605,3294,3311,6106,499,1.33%
3553955,3510,Assis,35039,Assis,Tarumã,SP,,,,10743,12298,12883,6583,6300,12124,759,1.83%
3554003,3511,Itapetininga,35043,Tatuí,Tatuí,SP,39760,55467,76816,93430,101838,107975,53358,54617,102456,5519,1.46%
3554102,3513,Vale do Paraíba Paulista,35050,São José dos Campos,Taubaté,SP,110585,169259,206965,244165,265514,278724,136785,141939,272712,6012,1.33%
3554201,3510,Assis,35040,Ourinhos,Tejupá,SP,5093,4861,4732,5336,5015,4809,2467,2342,3120,1689,-1.03%
3554300,3508,Presidente Prudente,35036,Presidente Prudente,Teodoro Sampaio,SP,26114,26329,49236,20003,20325,21389,10667,10722,17368,4021,0.67%
3554409,3502,Ribeirão Preto,35013,Jaboticabal,Terra Roxa,SP,5818,5767,6635,7752,8155,8505,4306,4199,8107,398,0.93%
3554508,3506,Piracicaba,35028,Piracicaba,Tietê,SP,17283,20042,26446,31710,34018,36827,18259,18568,33470,3357,1.51%
3554607,3510,Assis,35040,Ourinhos,Timburi,SP,4281,3338,2850,2731,2535,2646,1364,1282,1924,722,-0.32%
3554656,3511,Itapetininga,35043,Tatuí,Torre de Pedra,SP,,,,2144,2784,2257,1192,1065,1472,785,0.51%
3554706,3506,Piracicaba,35026,Rio Claro,Torrinha,SP,6501,6558,7503,8837,8918,9330,4707,4623,7939,1391,0.54%
3554755,3505,Araraquara,35024,Araraquara,Trabiju,SP,,,,1380,1441,1544,770,774,1418,126,1.13%
3554805,3513,Vale do Paraíba Paulista,35050,São José dos Campos,Tremembé,SP,11689,18098,27572,34823,38321,40985,21670,19315,36929,4056,1.64%
3554904,3501,São José do Rio Preto,35001,Jales,Três Fronteiras,SP,12039,8713,7859,5159,5031,5428,2716,2712,4599,829,0.51%
3554953,3512,Macro Metropolitana Paulista,35048,Bragança Paulista,Tuiuti,SP,,,,4956,5749,5935,3025,2910,2973,2962,1.82%
3555000,3509,Marília,35037,Tupã,Tupã,SP,52537,56587,61302,63333,62256,63492,30740,32752,60946,2546,0.03%
3555109,3508,Presidente Prudente,35034,Dracena,Tupi Paulista,SP,15720,16348,14045,13286,13712,14262,7574,6688,11203,3059,0.71%
3555208,3503,Araçatuba,35018,Birigui,Turiúba,SP,4993,4004,3752,1895,1947,1927,997,930,1577,350,0.17%
3555307,3501,São José do Rio Preto,35002,Fernandópolis,Turmalina,SP,3713,3015,2750,2366,2024,1978,982,996,1407,571,-1.78%
3555356,3501,São José do Rio Preto,35004,São José do Rio Preto,Ubarana,SP,,,,4220,4552,5286,2710,2576,4841,445,2.28%
3555406,3513,Vale do Paraíba Paulista,35054,Caraguatatuba,Ubatuba,SP,15203,27139,47398,66861,75008,78870,39223,39647,76958,1912,1.67%
3555505,3504,Bauru,35020,Bauru,Ubirajara,SP,4883,4225,4191,4156,4269,4429,2286,2143,3229,1200,0.64%
3555604,3501,São José do Rio Preto,35004,São José do Rio Preto,Uchoa,SP,7403,7811,8335,9035,9348,9475,4709,4766,8798,677,0.48%
3555703,3501,São José do Rio Preto,35007,Nhandeara,União Paulista,SP,1725,1239,1320,1354,1436,1599,829,770,1224,375,1.68%
3555802,3501,São José do Rio Preto,35001,Jales,Urânia,SP,16829,13493,12090,8825,8727,8836,4395,4441,7436,1400,0.01%
3555901,3504,Bauru,35020,Bauru,Uru,SP,1474,1591,1349,1404,1362,1251,641,610,1081,170,-1.15%
3556008,3501,São José do Rio Preto,35008,Novo Horizonte,Urupês,SP,10417,11991,11011,11833,11917,12720,6323,6397,11320,1400,0.73%
3556107,3501,São José do Rio Preto,35003,Votuporanga,Valentim Gentil,SP,5744,5395,5905,8605,9408,11031,5542,5489,10074,957,2.51%
3556206,3507,Campinas,35032,Campinas,Valinhos,SP,30775,48928,67886,82973,97814,106968,52757,54211,101820,5148,2.57%
3556305,3503,Araçatuba,35017,Araçatuba,Valparaíso,SP,14608,13297,16550,18574,20827,22617,12434,10183,21512,1105,1.99%
3556354,3512,Macro Metropolitana Paulista,35048,Bragança Paulista,Vargem,SP,,,,6975,6883,8801,4519,4282,4421,4380,2.35%
3556404,3507,Campinas,35030,São João da Boa Vista,Vargem Grande do Sul,SP,13369,20363,30952,36302,37357,39266,19484,19782,37274,1992,0.79%
3556453,3515,Metropolitana de São Paulo,35060,Itapecerica da Serra,Vargem Grande Paulista,SP,,,15870,32683,40200,42946,21310,21636,42946,0,2.77%
3556503,3512,Macro Metropolitana Paulista,35047,Jundiaí,Várzea Paulista,SP,9894,33818,68921,92800,100411,107146,53459,53687,107146,0,1.45%
3556602,3509,Marília,35038,Marília,Vera Cruz,SP,11699,11433,11042,11085,10020,10769,5298,5471,9363,1406,-0.29%
3556701,3507,Campinas,35032,Campinas,Vinhedo,SP,12338,21647,33612,47215,57435,63685,31520,32165,61688,1997,3.04%
3556800,3502,Ribeirão Preto,35013,Jaboticabal,Viradouro,SP,8743,10214,13091,15962,17043,17307,8720,8587,16801,506,0.81%
3556909,3502,Ribeirão Preto,35013,Jaboticabal,Vista Alegre do Alto,SP,2375,2736,3614,4754,6100,6889,3545,3344,6355,534,3.78%
3556958,3501,São José do Rio Preto,35001,Jales,Vitória Brasil,SP,,,,1675,1624,1737,891,846,1435,302,0.36%
3557006,3512,Macro Metropolitana Paulista,35046,Sorocaba,Votorantim,SP,26932,53158,80728,95925,99901,108872,54047,54825,104699,4173,1.27%
3557105,3501,São José do Rio Preto,35003,Votuporanga,Votuporanga,SP,39443,52279,66166,75641,77622,84728,41336,43392,82355,2373,1.14%
3557154,3501,São José do Rio Preto,35004,São José do Rio Preto,Zacarias,SP,,,,1947,2229,2334,1174,1160,1836,498,1.83%
3557204,3510,Assis,35040,Ourinhos,Chavantes,SP,14091,12968,14160,12194,12226,12114,6028,6086,11139,975,-0.07%
3557303,3507,Campinas,35031,Moji Mirim,Estiva Gerbi,SP,,,,8856,9185,10044,5074,4970,8011,2033,1.27%
1700251,1701,Ocidental do Tocantins,17003,Miracema do Tocantins,Abreulândia,TO,,,,2189,2245,2387,1258,1129,1476,911,0.87%
1700301,1701,Ocidental do Tocantins,17001,Bico do Papagaio,Aguiarnópolis,TO,,,,3145,3995,5158,2617,2541,4138,1020,5.07%
1700350,1701,Ocidental do Tocantins,17005,Gurupi,Aliança do Tocantins,TO,,,6883,6177,5701,5663,2899,2764,4756,907,-0.87%
1700400,1702,Oriental do Tocantins,17008,Dianópolis,Almas,TO,5912,7860,7652,8474,7488,7595,3973,3622,6016,1579,-1.09%
1700707,1701,Ocidental do Tocantins,17005,Gurupi,Alvorada,TO,4239,7486,9868,8508,7976,8380,4256,4124,7771,609,-0.15%
1701002,1701,Ocidental do Tocantins,17001,Bico do Papagaio,Ananás,TO,7983,8196,11851,10512,9358,9873,4985,4888,8151,1722,-0.63%
1701051,1701,Ocidental do Tocantins,17001,Bico do Papagaio,Angico,TO,,,,2889,3169,3169,1669,1500,1937,1232,0.93%
1701101,1702,Oriental do Tocantins,17006,Porto Nacional,Aparecida do Rio Negro,TO,,,3266,3517,4018,4213,2168,2045,3313,900,1.82%
1701309,1701,Ocidental do Tocantins,17002,Araguaína,Aragominas,TO,,,,6180,5469,5882,3138,2744,2230,3652,-0.49%
1701903,1701,Ocidental do Tocantins,17003,Miracema do Tocantins,Araguacema,TO,10421,14974,6394,5414,5423,6317,3331,2986,2925,3392,1.55%
1702000,1701,Ocidental do Tocantins,17004,Rio Formoso,Araguaçu,TO,10416,13734,12712,9346,8989,8786,4513,4273,5882,2904,-0.62%
1702109,1701,Ocidental do Tocantins,17002,Araguaína,Araguaína,TO,37780,72063,103315,113143,115759,150520,73605,76915,142963,7557,2.90%
1702158,1701,Ocidental do Tocantins,17002,Araguaína,Araguanã,TO,,,,4193,5000,5030,2586,2444,3386,1644,1.84%
1702208,1701,Ocidental do Tocantins,17001,Bico do Papagaio,Araguatins,TO,12542,18220,27861,26010,25973,31324,15966,15358,20136,11188,1.88%
1702307,1701,Ocidental do Tocantins,17002,Araguaína,Arapoema,TO,7295,15848,13964,7025,6839,6742,3447,3295,5455,1287,-0.41%
1702406,1702,Oriental do Tocantins,17008,Dianópolis,Arraias,TO,11476,15749,12884,10984,10626,10643,5394,5249,7369,3274,-0.31%
1702554,1701,Ocidental do Tocantins,17001,Bico do Papagaio,Augustinópolis,TO,,,10313,12964,14800,15965,8013,7952,13185,2780,2.10%
1702703,1702,Oriental do Tocantins,17008,Dianópolis,Aurora do Tocantins,TO,3501,4560,4663,3101,3385,3446,1774,1672,2482,964,1.06%
1702901,1701,Ocidental do Tocantins,17001,Bico do Papagaio,Axixá do Tocantins,TO,7595,8133,9981,8827,8917,9275,4600,4675,7621,1654,0.50%
1703008,1701,Ocidental do Tocantins,17002,Araguaína,Babaçulândia,TO,14661,15928,9073,10329,10372,10446,5568,4878,4931,5515,0.11%
1703057,1701,Ocidental do Tocantins,17002,Araguaína,Bandeirantes do Tocantins,TO,,,,2608,2711,3124,1696,1428,1685,1439,1.82%
1703073,1702,Oriental do Tocantins,17007,Jalapão,Barra do Ouro,TO,,,,3579,3581,4123,2195,1928,2186,1937,1.43%
1703107,1701,Ocidental do Tocantins,17003,Miracema do Tocantins,Barrolândia,TO,,,6525,5082,5155,5346,2758,2588,4474,872,0.51%
1703206,1701,Ocidental do Tocantins,17003,Miracema do Tocantins,Bernardo Sayão,TO,,,4315,4551,4518,4467,2332,2135,2190,2277,-0.19%
1703305,1702,Oriental do Tocantins,17006,Porto Nacional,Bom Jesus do Tocantins,TO,,,,2323,2710,3768,1990,1778,2826,942,4.96%
1703602,1701,Ocidental do Tocantins,17003,Miracema do Tocantins,Brasilândia do Tocantins,TO,,,,1923,2119,2066,1058,1008,1438,628,0.72%
1703701,1701,Ocidental do Tocantins,17005,Gurupi,Brejinho de Nazaré,TO,6179,10825,6828,4877,5295,5188,2600,2588,4195,993,0.62%
1703800,1701,Ocidental do Tocantins,17001,Bico do Papagaio,Buriti do Tocantins,TO,,,8038,7842,8164,9770,4939,4831,7454,2316,2.22%
1703826,1701,Ocidental do Tocantins,17001,Bico do Papagaio,Cachoeirinha,TO,,,,2023,2171,2148,1137,1011,1731,417,0.60%
1703842,1702,Oriental do Tocantins,17007,Jalapão,Campos Lindos,TO,,,,5638,7615,8139,4264,3875,4819,3320,3.74%
1703867,1701,Ocidental do Tocantins,17005,Gurupi,Cariri do Tocantins,TO,,,,2990,3562,3754,2105,1649,2091,1663,2.30%
1703883,1701,Ocidental do Tocantins,17002,Araguaína,Carmolândia,TO,,,,2008,2313,2305,1202,1103,1813,492,1.39%
1703891,1701,Ocidental do Tocantins,17001,Bico do Papagaio,Carrasco Bonito,TO,,,,3218,3314,3690,1920,1770,1969,1721,1.38%
1703909,1701,Ocidental do Tocantins,17003,Miracema do Tocantins,Caseara,TO,,,2775,3660,4667,4601,2384,2217,2737,1864,2.31%
1704105,1702,Oriental do Tocantins,17007,Jalapão,Centenário,TO,,,,2163,2386,2565,1375,1190,1504,1061,1.72%
1704600,1701,Ocidental do Tocantins,17004,Rio Formoso,Chapada de Areia,TO,,,,1270,1239,1335,716,619,749,586,0.50%
1705102,1702,Oriental do Tocantins,17008,Dianópolis,Chapada da Natividade,TO,,,,3274,3680,3280,1793,1487,1656,1624,0.02%
1705508,1701,Ocidental do Tocantins,17002,Araguaína,Colinas do Tocantins,TO,8444,18174,21018,25301,29298,30879,15310,15569,29649,1230,2.01%
1705557,1702,Oriental do Tocantins,17008,Dianópolis,Combinado,TO,,,4870,4524,4878,4669,2374,2295,4000,669,0.32%
1705607,1702,Oriental do Tocantins,17008,Dianópolis,Conceição do Tocantins,TO,2811,4123,5930,4377,4402,4182,2132,2050,2911,1271,-0.45%
1706001,1701,Ocidental do Tocantins,17003,Miracema do Tocantins,Couto Magalhães,TO,2434,5153,6814,4335,4887,5009,2638,2371,1884,3125,1.46%
1706100,1701,Ocidental do Tocantins,17004,Rio Formoso,Cristalândia,TO,10694,11762,10973,7318,6520,7218,3700,3518,5924,1294,-0.14%
1706258,1701,Ocidental do Tocantins,17005,Gurupi,Crixás do Tocantins,TO,,,,1384,1264,1566,822,744,874,692,1.24%
1706506,1701,Ocidental do Tocantins,17001,Bico do Papagaio,Darcinópolis,TO,,,,4273,5130,5273,2775,2498,3489,1784,2.13%
1707009,1702,Oriental do Tocantins,17008,Dianópolis,Dianópolis,TO,9252,10795,14022,15428,18584,19110,9676,9434,16447,2663,2.16%
1707108,1701,Ocidental do Tocantins,17003,Miracema do Tocantins,Divinópolis do Tocantins,TO,,,6394,5776,6359,6363,3280,3083,4466,1897,0.97%
1707207,1701,Ocidental do Tocantins,17003,Miracema do Tocantins,Dois Irmãos do Tocantins,TO,5407,8088,7949,7269,7060,7161,3958,3203,2777,4384,-0.15%
1707306,1701,Ocidental do Tocantins,17004,Rio Formoso,Dueré,TO,4722,4777,4573,4565,4489,4589,2440,2149,3055,1534,0.05%
1707405,1701,Ocidental do Tocantins,17001,Bico do Papagaio,Esperantina,TO,,,,7623,8134,9476,4910,4566,4614,4862,2.20%
1707553,1701,Ocidental do Tocantins,17004,Rio Formoso,Fátima,TO,,,4752,3848,3984,3805,1909,1896,3135,670,-0.11%
1707652,1701,Ocidental do Tocantins,17005,Gurupi,Figueirópolis,TO,,,7365,5562,4820,5340,2705,2635,4054,1286,-0.41%
1707702,1701,Ocidental do Tocantins,17002,Araguaína,Filadélfia,TO,14884,18974,11029,8218,7787,8502,4470,4032,5538,2964,0.34%
1708205,1701,Ocidental do Tocantins,17004,Rio Formoso,Formoso do Araguaia,TO,7856,11529,17087,18817,18225,18428,9608,8820,13333,5095,-0.21%
1708254,1701,Ocidental do Tocantins,17003,Miracema do Tocantins,Fortaleza do Tabocão,TO,,,,2242,2101,2423,1236,1187,1968,455,0.78%
1708304,1701,Ocidental do Tocantins,17003,Miracema do Tocantins,Goianorte,TO,,,5151,4839,5221,4960,2651,2309,2764,2196,0.25%
1709005,1702,Oriental do Tocantins,17007,Jalapão,Goiatins,TO,14676,14980,18164,11036,11639,12064,6287,5777,4949,7115,0.89%
1709302,1701,Ocidental do Tocantins,17003,Miracema do Tocantins,Guaraí,TO,11078,17801,20822,20018,21669,23212,11693,11519,21132,2080,1.49%
1709500,1701,Ocidental do Tocantins,17005,Gurupi,Gurupi,TO,24660,38653,56752,65034,71413,76765,38113,38652,75014,1751,1.67%
1709807,1702,Oriental do Tocantins,17006,Porto Nacional,Ipueiras,TO,,,,1166,1698,1639,864,775,958,681,3.46%
1710508,1702,Oriental do Tocantins,17007,Jalapão,Itacajá,TO,12168,13940,13933,6815,6386,7104,3731,3373,4273,2831,0.42%
1710706,1701,Ocidental do Tocantins,17001,Bico do Papagaio,Itaguatins,TO,11097,14123,11080,6386,6074,6029,3106,2923,3396,2633,-0.57%
1710904,1702,Oriental do Tocantins,17007,Jalapão,Itapiratins,TO,,,,3277,3421,3534,1917,1617,1916,1618,0.76%
1711100,1701,Ocidental do Tocantins,17003,Miracema do Tocantins,Itaporã do Tocantins,TO,2302,4361,3652,2522,2989,2439,1278,1161,1562,877,-0.33%
1711506,1701,Ocidental do Tocantins,17005,Gurupi,Jaú do Tocantins,TO,,,,3121,3789,3507,1815,1692,1310,2197,1.17%
1711803,1701,Ocidental do Tocantins,17003,Miracema do Tocantins,Juarina,TO,,,,2333,2141,2231,1175,1056,1033,1198,-0.45%
1711902,1701,Ocidental do Tocantins,17004,Rio Formoso,Lagoa da Confusão,TO,,,,6168,8220,10215,5526,4689,6337,3878,5.17%
1711951,1702,Oriental do Tocantins,17007,Jalapão,Lagoa do Tocantins,TO,,,,2530,3179,3525,1830,1695,2538,987,3.37%
1712009,1702,Oriental do Tocantins,17006,Porto Nacional,Lajeado,TO,,,,2344,2159,2773,1464,1309,2166,607,1.69%
1712157,1702,Oriental do Tocantins,17008,Dianópolis,Lavandeira,TO,,,,1209,1590,1605,838,767,1023,582,2.87%
1712405,1702,Oriental do Tocantins,17007,Jalapão,Lizarda,TO,8400,9511,4166,3787,3634,3731,2011,1720,2583,1148,-0.15%
1712454,1701,Ocidental do Tocantins,17001,Bico do Papagaio,Luzinópolis,TO,,,,2021,2784,2622,1350,1272,1675,947,2.64%
1712504,1701,Ocidental do Tocantins,17003,Miracema do Tocantins,Marianópolis do Tocantins,TO,,,2333,3332,4473,4352,2318,2034,2383,1969,2.71%
1712702,1702,Oriental do Tocantins,17007,Jalapão,Mateiros,TO,,,,1646,1737,2219,1185,1034,1411,808,3.03%
1712801,1701,Ocidental do Tocantins,17001,Bico do Papagaio,Maurilândia do Tocantins,TO,,,,2854,3185,3158,1695,1463,2020,1138,1.02%
1713205,1701,Ocidental do Tocantins,17003,Miracema do Tocantins,Miracema do Tocantins,TO,20285,25308,20815,24444,19683,20692,10344,10348,17945,2747,-1.65%
1713304,1701,Ocidental do Tocantins,17003,Miracema do Tocantins,Miranorte,TO,5041,11214,10908,11802,11858,12626,6422,6204,11039,1587,0.68%
1713601,1702,Oriental do Tocantins,17006,Porto Nacional,Monte do Carmo,TO,4158,5829,6542,5193,6387,6717,3602,3115,2881,3836,2.61%
1713700,1701,Ocidental do Tocantins,17003,Miracema do Tocantins,Monte Santo do Tocantins,TO,,,,1869,1858,2085,1120,965,450,1635,1.10%
1713809,1701,Ocidental do Tocantins,17001,Bico do Papagaio,Palmeiras do Tocantins,TO,,,,4622,4542,5746,2998,2748,3227,2519,2.20%
1713957,1701,Ocidental do Tocantins,17002,Araguaína,Muricilândia,TO,,,,2680,2850,3152,1657,1495,1800,1352,1.64%
1714203,1702,Oriental do Tocantins,17008,Dianópolis,Natividade,TO,11330,15852,10330,8867,9090,9000,4596,4404,7195,1805,0.15%
1714302,1701,Ocidental do Tocantins,17001,Bico do Papagaio,Nazaré,TO,8217,8521,9020,5150,4528,4386,2262,2124,1991,2395,-1.59%
1714880,1701,Ocidental do Tocantins,17002,Araguaína,Nova Olinda,TO,,,7669,9385,10518,10686,5577,5109,7465,3221,1.31%
1715002,1701,Ocidental do Tocantins,17004,Rio Formoso,Nova Rosalândia,TO,,,3078,3190,3772,3770,1965,1805,2468,1302,1.68%
1715101,1702,Oriental do Tocantins,17007,Jalapão,Novo Acordo,TO,5571,6110,3857,3057,3754,3762,1921,1841,3083,679,2.10%
1715150,1702,Oriental do Tocantins,17008,Dianópolis,Novo Alegre,TO,,,,2274,1801,2286,1180,1106,1699,587,0.05%
1715259,1702,Oriental do Tocantins,17008,Dianópolis,Novo Jardim,TO,,,,2151,2419,2457,1277,1180,1776,681,1.34%
1715507,1701,Ocidental do Tocantins,17004,Rio Formoso,Oliveira de Fátima,TO,,,,958,1081,1035,550,485,815,220,0.78%
1715705,1701,Ocidental do Tocantins,17002,Araguaína,Palmeirante,TO,,,,3610,4689,4954,2659,2295,1926,3028,3.22%
1715754,1701,Ocidental do Tocantins,17005,Gurupi,Palmeirópolis,TO,,,11915,7068,8120,7342,3707,3635,5984,1358,0.38%
1716109,1701,Ocidental do Tocantins,17004,Rio Formoso,Paraíso do Tocantins,TO,9310,20702,28825,36130,40290,44432,22122,22310,42485,1947,2.09%
1716208,1702,Oriental do Tocantins,17008,Dianópolis,Paranã,TO,13357,18099,10966,10416,10491,10335,5446,4889,4720,5615,-0.08%
1716307,1701,Ocidental do Tocantins,17002,Araguaína,Pau D'Arco,TO,,,,4335,4767,4588,2459,2129,2900,1688,0.57%
1716505,1702,Oriental do Tocantins,17006,Porto Nacional,Pedro Afonso,TO,10455,10021,13432,9028,10294,11542,5966,5576,10019,1523,2.49%
1716604,1701,Ocidental do Tocantins,17005,Gurupi,Peixe,TO,14496,22142,12871,8763,8750,10389,5429,4960,5236,5153,1.72%
1716653,1701,Ocidental do Tocantins,17003,Miracema do Tocantins,Pequizeiro,TO,,,3289,4591,4799,5052,2666,2386,2390,2662,0.96%
1716703,1701,Ocidental do Tocantins,17003,Miracema do Tocantins,Colméia,TO,6246,17362,8732,9352,8759,8607,4365,4242,6370,2237,-0.83%
1717008,1702,Oriental do Tocantins,17008,Dianópolis,Pindorama do Tocantins,TO,2972,3946,4949,4685,4397,4506,2385,2121,2947,1559,-0.39%
1717206,1701,Ocidental do Tocantins,17002,Araguaína,Piraquê,TO,,,,2360,3014,2920,1626,1294,1122,1798,2.15%
1717503,1701,Ocidental do Tocantins,17004,Rio Formoso,Pium,TO,6679,7098,8867,5540,6403,6696,3528,3168,3785,2911,1.91%
1717800,1702,Oriental do Tocantins,17008,Dianópolis,Ponte Alta do Bom Jesus,TO,5154,5663,6537,4574,4529,4548,2406,2142,2505,2043,-0.06%
1717909,1702,Oriental do Tocantins,17007,Jalapão,Ponte Alta do Tocantins,TO,7325,7987,7486,6172,6569,7180,3879,3301,4527,2653,1.52%
1718006,1702,Oriental do Tocantins,17008,Dianópolis,Porto Alegre do Tocantins,TO,,,2103,2393,2830,2795,1430,1365,1918,877,1.56%
1718204,1702,Oriental do Tocantins,17006,Porto Nacional,Porto Nacional,TO,31517,39327,43224,44991,45289,49143,24521,24622,42439,6704,0.89%
1718303,1701,Ocidental do Tocantins,17001,Bico do Papagaio,Praia Norte,TO,,,6068,6781,7060,7661,3898,3763,4470,3191,1.23%
1718402,1701,Ocidental do Tocantins,17003,Miracema do Tocantins,Presidente Kennedy,TO,4764,11306,6498,3759,3680,3685,1884,1801,3229,456,-0.20%
1718451,1701,Ocidental do Tocantins,17004,Rio Formoso,Pugmil,TO,,,,1989,2165,2366,1254,1112,2001,365,1.75%
1718501,1702,Oriental do Tocantins,17007,Jalapão,Recursolândia,TO,,,,3138,3665,3768,2008,1760,1990,1778,1.85%
1718550,1701,Ocidental do Tocantins,17001,Bico do Papagaio,Riachinho,TO,,,,3670,3691,4183,2166,2017,1810,2373,1.32%
1718659,1702,Oriental do Tocantins,17008,Dianópolis,Rio da Conceição,TO,,,,1189,1454,1714,887,827,1574,140,3.72%
1718709,1701,Ocidental do Tocantins,17003,Miracema do Tocantins,Rio dos Bois,TO,,,,2269,2092,2570,1361,1209,1029,1541,1.25%
1718758,1702,Oriental do Tocantins,17007,Jalapão,Rio Sono,TO,,,6994,6089,6167,6259,3387,2872,2404,3855,0.28%
1718808,1701,Ocidental do Tocantins,17001,Bico do Papagaio,Sampaio,TO,,,4379,2801,3672,3868,1972,1896,3517,351,3.28%
1718840,1701,Ocidental do Tocantins,17004,Rio Formoso,Sandolândia,TO,,,,3332,3443,3326,1741,1585,1764,1562,-0.02%
1718865,1701,Ocidental do Tocantins,17002,Araguaína,Santa Fé do Araguaia,TO,,,,5507,5610,6599,3417,3182,4374,2225,1.83%
1718881,1702,Oriental do Tocantins,17006,Porto Nacional,Santa Maria do Tocantins,TO,,,,2226,2673,2894,1518,1376,1725,1169,2.66%
1718899,1701,Ocidental do Tocantins,17005,Gurupi,Santa Rita do Tocantins,TO,,,,1852,2260,2128,1109,1019,918,1210,1.40%
1718907,1702,Oriental do Tocantins,17008,Dianópolis,Santa Rosa do Tocantins,TO,,,3822,4316,4417,4568,2412,2156,2947,1621,0.57%
1719004,1702,Oriental do Tocantins,17007,Jalapão,Santa Tereza do Tocantins,TO,,,3118,2114,2297,2523,1339,1184,1616,907,1.78%
1720002,1701,Ocidental do Tocantins,17001,Bico do Papagaio,Santa Terezinha do Tocantins,TO,,,,2455,2291,2471,1267,1204,1591,880,0.06%
1720101,1701,Ocidental do Tocantins,17001,Bico do Papagaio,São Bento do Tocantins,TO,,,,3738,4447,4615,2406,2209,2716,1899,2.13%
1720150,1702,Oriental do Tocantins,17007,Jalapão,São Félix do Tocantins,TO,,,,1269,1409,1445,773,672,931,514,1.31%
1720200,1701,Ocidental do Tocantins,17001,Bico do Papagaio,São Miguel do Tocantins,TO,,,,8486,10221,10490,5295,5195,2547,7943,2.14%
1720259,1701,Ocidental do Tocantins,17005,Gurupi,São Salvador do Tocantins,TO,,,,2740,3012,2910,1486,1424,1588,1322,0.60%
1720309,1701,Ocidental do Tocantins,17001,Bico do Papagaio,São Sebastião do Tocantins,TO,9454,17955,4294,3669,4244,4283,2199,2084,3283,1000,1.56%
1720499,1702,Oriental do Tocantins,17008,Dianópolis,São Valério,TO,,,3650,5054,4885,4384,2267,2117,2724,1660,-1.41%
1720655,1702,Oriental do Tocantins,17006,Porto Nacional,Silvanópolis,TO,,,5878,4725,5098,5071,2656,2415,4064,1007,0.71%
1720804,1701,Ocidental do Tocantins,17001,Bico do Papagaio,Sítio Novo do Tocantins,TO,7133,7017,7870,9488,9302,9148,4631,4517,4875,4273,-0.36%
1720853,1701,Ocidental do Tocantins,17005,Gurupi,Sucupira,TO,,,,1476,1667,1739,893,846,1106,633,1.65%
1720903,1702,Oriental do Tocantins,17008,Dianópolis,Taguatinga,TO,8178,10063,11399,13169,14110,15053,7885,7168,10629,4424,1.35%
1720937,1702,Oriental do Tocantins,17008,Dianópolis,Taipas do Tocantins,TO,,,,1713,1916,1945,1017,928,1557,388,1.28%
1720978,1701,Ocidental do Tocantins,17005,Gurupi,Talismã,TO,,,,2306,2555,2562,1352,1210,1363,1199,1.06%
1721000,1702,Oriental do Tocantins,17006,Porto Nacional,Palmas,TO,,,24334,137355,178386,228297,112814,115483,221727,6570,5.21%
1721109,1702,Oriental do Tocantins,17006,Porto Nacional,Tocantínia,TO,6500,7554,6363,5788,6663,6598,3399,3199,2955,3643,1.32%
1721208,1701,Ocidental do Tocantins,17001,Bico do Papagaio,Tocantinópolis,TO,23659,27976,30775,22777,21334,22608,11195,11413,18313,4295,-0.07%
1721257,1701,Ocidental do Tocantins,17003,Miracema do Tocantins,Tupirama,TO,,,,1179,1405,1574,843,731,930,644,2.93%
1721307,1701,Ocidental do Tocantins,17003,Miracema do Tocantins,Tupiratins,TO,,,,1365,2007,2097,1089,1008,1066,1031,4.39%
1722081,1701,Ocidental do Tocantins,17002,Araguaína,Wanderlândia,TO,,,9260,10273,9317,10978,5645,5333,5862,5116,0.67%
1722107,1701,Ocidental do Tocantins,17002,Araguaína,Xambioá,TO,8453,11677,11756,12137,10856,11484,5907,5577,9738,1746,-0.55%